date,he,nevp,pace,pacw,pge,sce,sdge,vea,iso,npsolar,spsolar,zpsolar,solar,npwind,spwind,wind
2018-01-01,1,3399,4673,2189,9598,9862,1921,63,21444,0,0,0,0,63,80,143
2018-01-01,2,3314,4610,2157,9178,9530,1833,63,20604,0,0,0,0,56,81,137
2018-01-01,3,3264,4586,2147,8932,9200,1770,65,19967,0,0,0,0,53,85,138
2018-01-01,4,3258,4603,2181,8829,9015,1725,67,19636,0,0,0,0,56,81,137
2018-01-01,5,3277,4702,2256,8877,8987,1732,70,19666,0,0,0,0,49,55,104
2018-01-01,6,3318,4856,2396,9097,9038,1775,75,19985,0,0,0,0,44,43,87
2018-01-01,7,3351,5037,2588,9390,9128,1851,82,20451,0,15,0,15,42,42,84
2018-01-01,8,3286,5098,2742,9585,9000,1851,85,20521,50,886,113,1049,32,41,73
2018-01-01,9,3252,5145,2814,9637,9033,1840,76,20586,317,2923,513,3753,31,48,79
2018-01-01,10,3239,5125,2816,9675,8966,1788,68,20497,507,4080,844,5431,33,51,84
2018-01-01,11,3205,5067,2798,9648,8927,1756,61,20392,534,4427,967,5928,32,54,86
2018-01-01,12,3196,5005,2736,9563,8856,1736,57,20212,529,4509,1016,6054,35,60,95
2018-01-01,13,3184,4948,2654,9462,8880,1761,52,20155,517,4498,1012,6027,38,54,92
2018-01-01,14,3177,4910,2571,9413,8988,1795,49,20245,509,4268,953,5730,38,44,82
2018-01-01,15,3173,4910,2493,9494,9206,1874,47,20621,433,3619,793,4845,38,37,75
2018-01-01,16,3209,5026,2494,9716,9401,1985,48,21150,242,1878,438,2558,36,37,73
2018-01-01,17,3469,5398,2651,10181,9969,2198,54,22402,32,234,62,328,33,32,65
2018-01-01,18,3810,5510,2865,11649,11404,2596,63,25712,0,0,0,0,34,28,62
2018-01-01,19,3849,5483,2897,11997,11710,2621,63,26391,0,0,0,0,40,31,71
2018-01-01,20,3816,5436,2841,11823,11585,2579,63,26050,0,0,0,0,42,31,73
2018-01-01,21,3766,5283,2761,11551,11307,2483,64,25405,0,0,0,0,39,26,65
2018-01-01,22,3679,5047,2618,11089,10958,2304,63,24414,0,0,0,0,41,28,69
2018-01-01,23,3601,4813,2455,10399,10349,2125,61,22934,0,0,0,0,39,28,67
2018-01-01,24,3448,4649,2300,9691,9706,1961,60,21418,0,0,0,0,37,26,63
2018-01-02,1,3215,4636,2266,9326,9755,1913,63,21057,0,0,0,0,31,33,64
2018-01-02,2,3153,4624,2237,9037,9454,1841,65,20397,0,0,0,0,32,33,65
2018-01-02,3,3144,4656,2236,8891,9267,1806,67,20030,0,0,0,0,32,36,68
2018-01-02,4,3172,4752,2277,8916,9218,1798,69,20001,0,0,0,0,34,44,78
2018-01-02,5,3262,4990,2403,9214,9515,1855,74,20658,0,0,0,0,35,48,83
2018-01-02,6,3449,5400,2684,9947,10265,2023,82,22317,0,0,0,0,36,59,95
2018-01-02,7,3693,5751,3072,11406,11375,2280,90,25151,0,11,0,11,39,71,110
2018-01-02,8,3695,5717,3290,12118,11927,2372,93,26510,36,681,75,792,41,79,120
2018-01-02,9,3621,5582,3221,11808,11776,2330,84,25998,218,2401,403,3022,44,87,131
2018-01-02,10,3550,5459,3131,11393,11606,2249,76,25324,361,3523,697,4581,42,101,143
2018-01-02,11,3495,5320,3038,11076,11515,2189,68,24848,386,3895,807,5088,35,127,162
2018-01-02,12,3455,5195,2929,10820,11478,2153,64,24514,390,3913,837,5140,35,132,167
2018-01-02,13,3430,5120,2848,10746,11556,2170,60,24533,369,3890,816,5075,32,131,163
2018-01-02,14,3422,5061,2784,10783,11745,2208,58,24794,354,3720,779,4853,31,121,152
2018-01-02,15,3431,5043,2719,10846,11892,2281,56,25076,297,3192,658,4147,33,109,142
2018-01-02,16,3465,5136,2715,11130,11942,2372,57,25501,184,1664,362,2210,37,99,136
2018-01-02,17,3625,5447,2808,11507,12230,2550,61,26347,27,206,51,284,32,95,127
2018-01-02,18,3938,5632,3012,12322,13282,2872,69,28544,0,0,0,0,28,91,119
2018-01-02,19,4003,5613,3042,12837,13478,2887,69,29271,0,0,0,0,28,95,123
2018-01-02,20,3959,5570,2986,12653,13202,2824,68,28746,0,0,0,0,31,94,125
2018-01-02,21,3871,5364,2896,12267,12751,2722,68,27808,0,0,0,0,36,95,131
2018-01-02,22,3721,5053,2726,11677,12060,2543,67,26347,0,0,0,0,40,101,141
2018-01-02,23,3547,4785,2520,10784,11171,2299,64,24318,0,0,0,0,40,98,138
2018-01-02,24,3371,4657,2362,9993,10366,2080,62,22501,0,0,0,0,42,92,134
2018-01-03,1,3323,4723,2316,9578,9674,1912,62,21225,0,0,0,0,39,139,178
2018-01-03,2,3258,4713,2282,9242,9321,1831,63,20456,0,0,0,0,38,137,175
2018-01-03,3,3234,4740,2278,9068,9122,1793,65,20048,0,0,0,0,41,129,170
2018-01-03,4,3251,4831,2319,9075,9071,1795,67,20009,0,0,0,0,36,121,157
2018-01-03,5,3332,5062,2447,9332,9333,1856,73,20593,0,0,0,0,35,125,160
2018-01-03,6,3516,5457,2717,10035,10047,2031,81,22194,0,0,0,0,40,129,169
2018-01-03,7,3756,5810,3102,11240,11147,2289,89,24765,0,12,0,12,46,127,173
2018-01-03,8,3757,5785,3315,11937,11611,2352,92,25992,36,633,72,741,44,120,164
2018-01-03,9,3696,5660,3251,11656,11520,2297,83,25556,215,2136,373,2724,39,118,157
2018-01-03,10,3634,5539,3164,11393,11430,2218,75,25117,344,3040,629,4013,42,129,171
2018-01-03,11,3593,5397,3078,11076,11400,2162,68,24707,354,3321,731,4406,34,124,158
2018-01-03,12,3547,5274,2962,10820,11392,2130,64,24406,351,3291,759,4401,38,111,149
2018-01-03,13,3515,5204,2882,10746,11393,2161,61,24361,311,3168,733,4212,48,98,146
2018-01-03,14,3500,5155,2814,10783,11535,2240,59,24617,314,3021,717,4052,37,80,117
2018-01-03,15,3514,5143,2767,10846,11698,2299,57,24900,260,2680,622,3562,39,72,111
2018-01-03,16,3567,5234,2773,11130,11716,2400,58,25303,163,1398,349,1910,43,72,115
2018-01-03,17,3746,5537,2852,11602,12012,2563,61,26238,25,199,54,278,44,57,101
2018-01-03,18,4061,5714,3057,12429,12992,2801,69,28291,0,0,0,0,58,52,110
2018-01-03,19,4129,5678,3071,13072,13090,2839,69,29069,0,0,0,0,93,52,145
2018-01-03,20,4087,5628,3011,12895,12832,2781,68,28576,0,0,0,0,70,50,120
2018-01-03,21,3998,5436,2923,12521,12422,2672,68,27683,0,0,0,0,87,47,134
2018-01-03,22,3837,5133,2755,11910,11751,2493,66,26219,0,0,0,0,146,52,198
2018-01-03,23,3648,4860,2552,11031,10986,2269,63,24350,0,0,0,0,97,51,148
2018-01-03,24,3470,4718,2380,10327,10209,2068,61,22666,0,0,0,0,84,63,147
2018-01-04,1,3427,4794,2340,9478,9563,1909,59,21009,0,0,0,0,77,106,183
2018-01-04,2,3355,4766,2295,9137,9212,1830,59,20238,0,0,0,0,69,117,186
2018-01-04,3,3322,4779,2288,8916,9017,1785,61,19779,0,0,0,0,65,133,198
2018-01-04,4,3332,4869,2323,8914,8970,1779,64,19727,0,0,0,0,73,161,234
2018-01-04,5,3407,5094,2445,9170,9183,1830,70,20253,0,0,0,0,73,162,235
2018-01-04,6,3578,5484,2701,9842,9856,1978,76,21752,0,0,0,0,74,153,227
2018-01-04,7,3819,5840,3069,11085,10972,2212,83,24352,0,16,0,16,80,137,217
2018-01-04,8,3819,5833,3279,11828,11587,2268,84,25767,43,846,73,962,80,113,193
2018-01-04,9,3768,5733,3234,11814,11557,2216,78,25665,287,2912,415,3614,76,95,171
2018-01-04,10,3710,5655,3169,11645,11518,2138,71,25373,476,4137,717,5330,73,87,160
2018-01-04,11,3664,5557,3100,11493,11477,2097,65,25132,535,4498,864,5897,71,101,172
2018-01-04,12,3618,5464,3003,11263,11458,2070,61,24852,544,4633,935,6112,76,139,215
2018-01-04,13,3580,5416,2934,11113,11514,2126,58,24811,556,4626,950,6132,82,195,277
2018-01-04,14,3564,5386,2871,11120,11584,2201,56,24961,560,4532,913,6005,76,200,276
2018-01-04,15,3573,5378,2817,11103,11699,2269,54,25125,496,4045,780,5321,74,224,298
2018-01-04,16,3624,5473,2836,11246,11798,2366,54,25465,296,2263,447,3006,75,251,326
2018-01-04,17,3799,5752,2931,11642,12149,2541,57,26389,39,379,81,499,76,242,318
2018-01-04,18,4109,5902,3094,12487,13052,2850,64,28454,1,0,0,1,80,228,308
2018-01-04,19,4171,5833,3088,13012,13125,2849,65,29051,0,0,0,0,94,226,320
2018-01-04,20,4127,5763,3013,12786,12852,2786,63,28487,0,0,0,0,93,188,281
2018-01-04,21,4040,5573,2925,12358,12420,2679,62,27518,0,0,0,0,96,177,273
2018-01-04,22,3889,5277,2763,11678,11769,2508,60,26015,0,0,0,0,100,180,280
2018-01-04,23,3708,5001,2563,10801,10956,2267,57,24081,0,0,0,0,98,192,290
2018-01-04,24,3526,4838,2385,10027,10199,2052,56,22334,0,0,0,0,129,214,343
2018-01-05,1,3401,4773,2248,9202,9612,1917,58,20789,0,0,0,0,152,631,783
2018-01-05,2,3323,4741,2193,8832,9312,1845,59,20048,0,0,0,0,158,641,799
2018-01-05,3,3292,4758,2179,8609,9135,1804,61,19609,0,0,0,0,148,671,819
2018-01-05,4,3294,4825,2204,8527,9091,1795,64,19477,0,0,0,0,146,689,835
2018-01-05,5,3363,5035,2305,8745,9344,1846,69,20004,0,0,0,0,150,642,792
2018-01-05,6,3526,5396,2536,9352,10010,1982,77,21421,0,0,0,0,150,569,719
2018-01-05,7,3752,5741,2872,10476,10844,2209,87,23616,0,16,0,16,148,458,606
2018-01-05,8,3757,5756,3082,11272,11404,2289,86,25051,38,823,83,944,144,316,460
2018-01-05,9,3730,5681,3070,11342,11346,2279,79,25046,248,2849,437,3534,142,222,364
2018-01-05,10,3683,5606,3026,11269,11291,2236,72,24868,415,4027,757,5199,141,162,303
2018-01-05,11,3638,5505,2967,11161,11227,2199,66,24653,456,4360,870,5686,130,157,287
2018-01-05,12,3593,5408,2886,11020,11189,2169,62,24440,433,4407,886,5726,120,160,280
2018-01-05,13,3561,5350,2821,10919,11219,2192,58,24388,442,4391,890,5723,114,185,299
2018-01-05,14,3546,5315,2770,10909,11317,2246,56,24528,452,4197,840,5489,106,182,288
2018-01-05,15,3552,5303,2716,10881,11398,2299,54,24632,378,3551,695,4624,101,178,279
2018-01-05,16,3597,5364,2709,11033,11519,2391,54,24997,216,1903,392,2511,111,178,289
2018-01-05,17,3749,5621,2802,11468,11873,2550,57,25948,29,274,74,377,106,193,299
2018-01-05,18,4046,5754,2931,12395,12561,2813,65,27834,1,0,1,2,105,201,306
2018-01-05,19,4099,5660,2917,12336,12682,2805,65,27888,0,0,0,0,110,206,316
2018-01-05,20,4050,5556,2828,12066,12383,2724,64,27237,0,0,0,0,123,187,310
2018-01-05,21,3966,5397,2733,11695,11920,2626,63,26304,0,0,0,0,157,173,330
2018-01-05,22,3852,5184,2608,11227,11467,2474,63,25231,0,0,0,0,206,157,363
2018-01-05,23,3722,4951,2452,10576,10819,2266,60,23721,0,0,0,0,225,164,389
2018-01-05,24,3551,4783,2299,9849,10104,2068,59,22080,0,0,0,0,239,178,417
2018-01-06,1,3376,4660,2159,9185,9653,1897,57,20792,0,0,0,0,311,475,786
2018-01-06,2,3291,4617,2104,8858,9251,1809,56,19974,0,0,0,0,278,511,789
2018-01-06,3,3249,4601,2084,8704,8983,1751,57,19495,0,0,0,0,231,568,799
2018-01-06,4,3234,4630,2100,8683,8841,1740,61,19325,0,0,0,0,203,630,833
2018-01-06,5,3254,4717,2158,8872,8903,1757,62,19594,0,0,0,0,181,689,870
2018-01-06,6,3318,4865,2274,9282,9180,1812,66,20340,0,0,0,0,157,719,876
2018-01-06,7,3408,5058,2441,9838,9552,1932,72,21394,0,11,0,11,144,738,882
2018-01-06,8,3389,5179,2631,10259,9638,1985,74,21956,20,558,35,613,125,728,853
2018-01-06,9,3420,5229,2760,10521,9778,2062,71,22432,156,2009,200,2365,91,703,794
2018-01-06,10,3452,5218,2797,10549,9822,2051,66,22488,280,2960,399,3639,77,736,813
2018-01-06,11,3437,5158,2767,10569,9859,2013,61,22502,342,3239,519,4100,45,976,1021
2018-01-06,12,3395,5083,2688,10618,9976,1924,57,22575,365,3147,553,4065,33,1199,1232
2018-01-06,13,3366,5009,2591,10725,10065,1929,54,22773,351,3070,527,3948,29,1457,1486
2018-01-06,14,3370,4976,2505,10804,10215,1975,52,23046,347,2972,471,3790,20,1603,1623
2018-01-06,15,3413,4982,2442,10901,10290,2010,50,23251,322,2588,412,3322,18,1695,1713
2018-01-06,16,3457,5077,2448,10921,10477,2045,51,23494,214,1340,246,1800,20,1753,1773
2018-01-06,17,3619,5390,2548,11200,10910,2186,55,24351,36,192,47,275,18,1786,1804
2018-01-06,18,3934,5539,2710,11842,11600,2516,62,26020,0,0,0,0,17,1730,1747
2018-01-06,19,3953,5489,2706,11923,11655,2574,63,26215,0,0,0,0,19,1640,1659
2018-01-06,20,3890,5414,2652,11722,11496,2501,62,25781,0,0,0,0,18,1604,1622
2018-01-06,21,3809,5291,2587,11445,11154,2422,60,25081,0,0,0,0,18,1561,1579
2018-01-06,22,3707,5093,2478,11051,10790,2298,58,24197,0,0,0,0,24,1512,1536
2018-01-06,23,3584,4865,2339,10470,10283,2127,55,22935,0,0,0,0,26,1457,1483
2018-01-06,24,3447,4695,2220,9816,9738,1951,54,21559,0,0,0,0,28,1379,1407
2018-01-07,1,3330,4571,2144,9290,9353,1834,51,20528,0,0,0,0,32,1619,1651
2018-01-07,2,3247,4516,2102,8874,8977,1755,52,19658,0,0,0,0,33,1227,1260
2018-01-07,3,3214,4504,2094,8670,8745,1711,53,19179,0,0,0,0,37,885,922
2018-01-07,4,3201,4522,2106,8604,8585,1681,55,18925,0,0,0,0,46,656,702
2018-01-07,5,3229,4595,2164,8676,8608,1687,59,19030,0,0,0,0,41,434,475
2018-01-07,6,3293,4699,2268,8902,8786,1732,64,19484,0,0,0,0,37,281,318
2018-01-07,7,3362,4877,2416,9336,9058,1848,71,20313,0,13,0,13,34,184,218
2018-01-07,8,3345,4981,2610,9655,9046,1871,76,20648,39,724,76,839,37,130,167
2018-01-07,9,3392,4965,2743,9833,9058,1860,72,20823,270,2688,400,3358,38,84,122
2018-01-07,10,3429,4948,2794,9805,9126,1817,66,20814,454,3877,703,5034,38,83,121
2018-01-07,11,3424,4877,2762,9680,9116,1776,62,20634,492,4216,832,5540,33,88,121
2018-01-07,12,3404,4869,2682,9534,9126,1747,59,20466,487,4279,888,5654,30,96,126
2018-01-07,13,3380,4800,2608,9468,9168,1753,56,20445,465,4263,913,5641,35,93,128
2018-01-07,14,3369,4805,2537,9506,9255,1805,54,20620,458,4160,857,5475,38,80,118
2018-01-07,15,3378,4839,2468,9685,9456,1884,52,21077,392,3564,734,4690,41,74,115
2018-01-07,16,3414,4998,2477,10014,9639,2016,52,21721,234,1960,433,2627,46,65,111
2018-01-07,17,3598,5316,2589,10500,10151,2230,57,22938,33,270,71,374,44,55,99
2018-01-07,18,3928,5480,2765,11669,11485,2526,64,25744,0,0,0,0,46,49,95
2018-01-07,19,3992,5447,2773,12106,11799,2584,64,26553,0,0,0,0,46,47,93
2018-01-07,20,3949,5386,2736,11985,11639,2496,62,26182,0,0,0,0,42,43,85
2018-01-07,21,3880,5244,2660,11635,11324,2375,61,25395,0,0,0,0,43,38,81
2018-01-07,22,3747,5011,2516,11146,10929,2239,59,24373,0,0,0,0,43,39,82
2018-01-07,23,3595,4770,2347,10373,10411,2052,58,22894,0,0,0,0,49,44,93
2018-01-07,24,3429,4636,2201,9696,9808,1893,56,21453,0,0,0,0,58,45,103
2018-01-08,1,3344,4564,2088,9039,9773,1868,56,20736,0,0,0,0,83,65,148
2018-01-08,2,3280,4542,2055,8715,9386,1801,56,19958,0,0,0,0,81,66,147
2018-01-08,3,3255,4565,2057,8534,9225,1761,58,19578,0,0,0,0,82,74,156
2018-01-08,4,3267,4668,2101,8551,9145,1768,60,19524,0,0,0,0,86,77,163
2018-01-08,5,3351,4910,2229,8815,9395,1819,64,20093,0,0,0,0,79,102,181
2018-01-08,6,3524,5303,2486,9520,10099,1997,71,21687,0,0,0,0,75,114,189
2018-01-08,7,3764,5689,2862,10779,11163,2227,79,24248,0,6,0,6,84,141,225
2018-01-08,8,3803,5712,3085,11842,11645,2334,83,25904,9,302,19,330,109,142,251
2018-01-08,9,3779,5658,3057,12041,11880,2313,77,26311,77,1126,120,1323,120,157,277
2018-01-08,10,3745,5609,3004,12124,12025,2301,72,26522,138,1813,287,2238,163,177,340
2018-01-08,11,3705,5530,2948,12080,12069,2283,68,26500,179,2102,356,2637,192,167,359
2018-01-08,12,3659,5455,2861,11955,11913,2262,64,26194,185,2065,373,2623,231,167,398
2018-01-08,13,3635,5413,2799,11828,11855,2279,61,26023,178,2087,371,2636,301,176,477
2018-01-08,14,3621,5374,2738,11741,11825,2312,58,25936,173,2059,333,2565,378,189,567
2018-01-08,15,3639,5355,2675,11588,11737,2367,57,25749,142,1840,280,2262,460,213,673
2018-01-08,16,3708,5451,2680,11502,11907,2476,57,25942,92,1033,151,1276,540,218,758
2018-01-08,17,3912,5740,2783,11853,12266,2634,61,26814,14,170,27,211,577,217,794
2018-01-08,18,4221,5880,2958,12894,12913,2925,70,28802,0,0,0,0,609,237,846
2018-01-08,19,4260,5806,2971,13305,13257,2938,71,29571,0,0,0,0,632,249,881
2018-01-08,20,4212,5704,2904,12987,12997,2843,68,28895,0,0,0,0,621,249,870
2018-01-08,21,4118,5501,2803,12504,12697,2706,66,27973,0,0,0,0,624,261,885
2018-01-08,22,3957,5183,2629,11749,11957,2519,64,26289,0,0,0,0,644,274,918
2018-01-08,23,3752,4878,2432,10772,11141,2273,60,24246,0,0,0,0,579,308,887
2018-01-08,24,3564,4695,2259,9995,10374,2061,58,22488,0,0,0,0,520,326,846
2018-01-09,1,3451,4559,2131,9275,9686,1906,56,20923,0,0,0,0,374,350,724
2018-01-09,2,3378,4515,2080,8882,9376,1826,57,20141,0,0,0,0,321,401,722
2018-01-09,3,3347,4514,2066,8663,9159,1780,58,19660,0,0,0,0,294,461,755
2018-01-09,4,3352,4593,2085,8618,9090,1769,60,19537,0,0,0,0,274,526,800
2018-01-09,5,3423,4809,2185,8819,9314,1823,63,20019,0,0,0,0,249,526,775
2018-01-09,6,3589,5195,2432,9464,9961,1961,70,21456,0,0,0,0,234,539,773
2018-01-09,7,3816,5550,2793,10797,11159,2243,76,24275,0,7,0,7,252,569,821
2018-01-09,8,3843,5571,3004,11834,11736,2391,79,26040,17,394,23,434,226,434,660
2018-01-09,9,3814,5521,2975,11965,12093,2439,78,26575,126,1366,167,1659,233,441,674
2018-01-09,10,3774,5463,2929,11931,12237,2465,74,26707,209,2043,340,2592,192,516,708
2018-01-09,11,3732,5390,2861,11825,12283,2482,70,26660,249,2305,426,2980,156,672,828
2018-01-09,12,3685,5326,2807,11689,12257,2479,67,26492,305,2496,564,3365,134,905,1039
2018-01-09,13,3651,5297,2757,11606,12145,2488,64,26303,310,2415,576,3301,135,1056,1191
2018-01-09,14,3636,5277,2713,11552,12010,2469,62,26093,314,2415,545,3274,146,1130,1276
2018-01-09,15,3656,5276,2665,11437,11924,2440,61,25862,305,2274,522,3101,147,1145,1292
2018-01-09,16,3729,5362,2669,11412,11907,2467,61,25847,185,1256,283,1724,165,1190,1355
2018-01-09,17,3925,5627,2765,11749,12266,2590,65,26670,29,230,50,309,183,1312,1495
2018-01-09,18,4233,5755,2936,12722,12964,2866,76,28628,0,0,0,0,227,1500,1727
2018-01-09,19,4290,5685,2954,13082,13163,2875,76,29196,0,0,0,0,303,1689,1992
2018-01-09,20,4243,5589,2898,12905,12984,2801,75,28765,0,0,0,0,317,1924,2241
2018-01-09,21,4142,5390,2796,12442,12585,2686,73,27786,0,0,0,0,370,2123,2493
2018-01-09,22,3971,5087,2637,11765,11953,2489,71,26278,0,0,0,0,437,2265,2702
2018-01-09,23,3771,4791,2439,10880,11179,2233,67,24359,0,0,0,0,486,2395,2881
2018-01-09,24,3580,4614,2275,10064,10383,2016,65,22528,0,0,0,0,493,2464,2957
2018-01-10,1,3452,4563,2169,9242,9768,1920,60,20990,0,0,0,0,602,2511,3113
2018-01-10,2,3378,4516,2125,8853,9392,1846,61,20152,0,0,0,0,491,2548,3039
2018-01-10,3,3352,4519,2110,8657,9200,1801,62,19720,0,0,0,0,402,2546,2948
2018-01-10,4,3362,4596,2140,8625,9168,1789,65,19647,0,0,0,0,322,2548,2870
2018-01-10,5,3437,4812,2247,8857,9448,1843,69,20217,0,0,0,0,278,2562,2840
2018-01-10,6,3607,5187,2507,9515,10162,1991,77,21745,0,0,0,0,237,2542,2779
2018-01-10,7,3842,5542,2884,10754,11269,2246,84,24353,0,14,0,14,207,2543,2750
2018-01-10,8,3832,5589,3114,11692,11675,2359,88,25814,44,704,63,811,196,2506,2702
2018-01-10,9,3768,5558,3068,11742,11729,2338,81,25890,254,2758,359,3371,193,2488,2681
2018-01-10,10,3703,5541,3009,11628,11657,2294,75,25654,419,4001,636,5056,184,2496,2680
2018-01-10,11,3651,5509,2948,11469,11581,2266,69,25385,439,4401,775,5615,159,2547,2706
2018-01-10,12,3600,5473,2865,11387,11479,2234,64,25164,406,4531,827,5764,133,2568,2701
2018-01-10,13,3567,5470,2802,11324,11399,2228,61,25012,386,4585,837,5808,121,2622,2743
2018-01-10,14,3557,5461,2738,11288,11367,2250,58,24963,399,4474,812,5685,101,2613,2714
2018-01-10,15,3576,5489,2683,11248,11387,2298,57,24990,378,3945,713,5036,92,2612,2704
2018-01-10,16,3645,5592,2684,11310,11455,2376,57,25198,255,2269,390,2914,94,2587,2681
2018-01-10,17,3849,5852,2786,11708,11949,2537,60,26254,39,385,68,492,78,2529,2607
2018-01-10,18,4174,5947,2963,12674,13065,2806,67,28612,0,0,0,0,74,2411,2485
2018-01-10,19,4236,5867,2977,12998,13198,2860,68,29124,0,0,0,0,83,2196,2279
2018-01-10,20,4196,5756,2919,12839,13021,2783,68,28711,0,0,0,0,85,1856,1941
2018-01-10,21,4100,5547,2824,12434,12701,2666,67,27868,0,0,0,0,95,1438,1533
2018-01-10,22,3936,5241,2657,11805,12063,2496,65,26429,0,0,0,0,132,991,1123
2018-01-10,23,3741,4949,2459,10907,11223,2263,62,24455,0,0,0,0,109,713,822
2018-01-10,24,3559,4782,2285,10070,10380,2056,61,22567,0,0,0,0,83,540,623
2018-01-11,1,3423,4667,2143,9252,9766,1852,62,20932,0,0,0,0,69,612,681
2018-01-11,2,3351,4626,2094,8895,9405,1781,62,20143,0,0,0,0,64,509,573
2018-01-11,3,3322,4635,2083,8712,9220,1743,64,19739,0,0,0,0,64,440,504
2018-01-11,4,3331,4721,2108,8706,9187,1734,66,19694,0,0,0,0,69,408,477
2018-01-11,5,3413,4933,2204,8955,9473,1791,71,20291,0,0,0,0,73,389,462
2018-01-11,6,3580,5315,2450,9634,10171,1963,79,21847,0,0,0,0,80,363,443
2018-01-11,7,3814,5668,2799,10836,11331,2255,88,24510,0,36,0,36,92,343,435
2018-01-11,8,3813,5692,2989,11951,11694,2345,90,26080,53,913,119,1085,107,267,374
2018-01-11,9,3766,5629,2949,11887,11654,2286,83,25911,261,3109,517,3887,118,222,340
2018-01-11,10,3712,5575,2901,11691,11526,2201,76,25495,407,4419,843,5669,128,195,323
2018-01-11,11,3667,5498,2841,11434,11375,2130,71,25010,452,4821,963,6236,120,184,304
2018-01-11,12,3618,5416,2774,11185,11262,2089,66,24602,479,4856,1008,6343,112,187,299
2018-01-11,13,3589,5381,2718,10955,11215,2081,63,24314,498,4895,1034,6427,109,180,289
2018-01-11,14,3582,5359,2663,10948,11285,2122,61,24416,510,4759,1014,6283,105,189,294
2018-01-11,15,3602,5355,2620,10989,11438,2155,59,24641,470,4259,892,5621,105,193,298
2018-01-11,16,3657,5454,2605,11137,11569,2246,59,25011,286,2393,536,3215,105,206,311
2018-01-11,17,3836,5716,2694,11611,11937,2393,62,26003,36,407,77,520,106,215,321
2018-01-11,18,4141,5833,2856,12657,12913,2698,70,28338,0,0,0,0,111,251,362
2018-01-11,19,4190,5757,2858,12961,13024,2768,70,28823,0,0,0,0,121,289,410
2018-01-11,20,4144,5674,2792,12774,12815,2702,69,28360,0,0,0,0,138,329,467
2018-01-11,21,4055,5481,2702,12366,12437,2585,69,27457,0,0,0,0,152,371,523
2018-01-11,22,3902,5186,2551,11732,11861,2402,67,26062,0,0,0,0,167,412,579
2018-01-11,23,3718,4902,2368,10853,11121,2169,64,24207,0,0,0,0,163,513,676
2018-01-11,24,3539,4720,2206,10028,10323,1971,62,22384,0,0,0,0,155,639,794
2018-01-12,1,3439,4572,2089,9346,9578,1910,62,20896,0,0,0,0,182,990,1172
2018-01-12,2,3368,4524,2035,8951,9208,1840,63,20062,0,0,0,0,167,1092,1259
2018-01-12,3,3342,4521,2015,8749,9000,1800,64,19613,0,0,0,0,159,1199,1358
2018-01-12,4,3346,4592,2034,8713,8907,1790,66,19476,0,0,0,0,154,1281,1435
2018-01-12,5,3420,4792,2125,8962,9162,1846,71,20041,0,0,0,0,124,1193,1317
2018-01-12,6,3582,5142,2353,9606,9797,1990,78,21471,0,0,0,0,95,1066,1161
2018-01-12,7,3808,5492,2689,10822,10741,2224,87,23874,0,30,0,30,76,885,961
2018-01-12,8,3811,5545,2904,11814,11038,2296,89,25237,45,847,87,979,65,706,771
2018-01-12,9,3772,5511,2894,11691,11011,2283,82,25067,264,2940,439,3643,62,510,572
2018-01-12,10,3728,5468,2859,11460,10932,2222,74,24688,433,4225,740,5398,66,393,459
2018-01-12,11,3682,5403,2811,11136,10802,2185,67,24190,481,4592,886,5959,65,407,472
2018-01-12,12,3630,5328,2737,10889,10750,2153,62,23854,484,4698,947,6129,70,423,493
2018-01-12,13,3585,5297,2672,10674,10751,2147,58,23630,494,4655,974,6123,77,454,531
2018-01-12,14,3562,5278,2610,10623,10871,2196,56,23746,503,4504,935,5942,86,479,565
2018-01-12,15,3560,5274,2551,10642,10928,2254,54,23878,465,3867,817,5149,98,492,590
2018-01-12,16,3606,5337,2547,10874,11004,2351,54,24283,307,2192,509,3008,108,504,612
2018-01-12,17,3770,5568,2632,11451,11380,2465,57,25353,46,357,87,490,114,358,472
2018-01-12,18,4070,5652,2783,12433,12349,2734,65,27581,0,0,1,1,117,271,388
2018-01-12,19,4116,5585,2785,12585,12385,2753,65,27788,0,0,0,0,136,216,352
2018-01-12,20,4072,5479,2717,12355,12083,2681,64,27183,0,0,0,0,142,179,321
2018-01-12,21,3994,5310,2623,12000,11689,2587,64,26340,0,0,0,0,162,154,316
2018-01-12,22,3880,5102,2492,11512,11388,2441,64,25405,0,0,0,0,168,164,332
2018-01-12,23,3748,4868,2341,10846,10760,2247,62,23915,0,0,0,0,162,174,336
2018-01-12,24,3587,4696,2195,10166,10107,2056,61,22390,0,0,0,0,158,194,352
2018-01-13,1,3471,4563,2090,9400,9535,1920,63,20918,0,0,0,0,114,220,334
2018-01-13,2,3385,4505,2035,9016,9179,1837,64,20096,0,0,0,0,112,227,339
2018-01-13,3,3347,4495,2016,8768,8925,1787,65,19545,0,0,0,0,119,230,349
2018-01-13,4,3329,4528,2031,8661,8764,1761,68,19254,0,0,0,0,117,229,346
2018-01-13,5,3358,4622,2089,8715,8758,1778,71,19322,0,0,0,0,118,226,344
2018-01-13,6,3434,4776,2204,8962,9044,1829,76,19911,0,0,0,0,121,227,348
2018-01-13,7,3523,4978,2374,9451,9355,1927,83,20816,0,34,0,34,121,233,354
2018-01-13,8,3499,5100,2554,9878,9383,1967,86,21314,43,946,94,1083,116,236,352
2018-01-13,9,3530,5156,2669,10034,9618,1990,79,21721,273,3171,517,3961,108,254,362
2018-01-13,10,3556,5166,2701,9973,9691,1969,73,21706,449,4506,856,5811,102,294,396
2018-01-13,11,3534,5136,2667,9777,9804,1951,66,21598,494,4813,994,6301,91,334,425
2018-01-13,12,3488,5080,2581,9566,9794,1937,60,21357,507,4779,1064,6350,79,349,428
2018-01-13,13,3445,5021,2477,9364,9773,1969,57,21163,521,4688,1074,6283,70,350,420
2018-01-13,14,3421,4993,2387,9281,9798,2017,55,21151,520,4505,1034,6059,65,326,391
2018-01-13,15,3425,5003,2320,9359,9849,2104,54,21366,458,3841,873,5172,67,297,364
2018-01-13,16,3471,5113,2304,9614,9958,2227,54,21853,288,2169,536,2993,72,263,335
2018-01-13,17,3650,5406,2409,10177,10414,2377,58,23026,50,375,111,536,60,228,288
2018-01-13,18,3969,5544,2577,11319,11445,2673,66,25503,1,0,0,1,55,206,261
2018-01-13,19,4007,5496,2586,11704,11610,2692,66,26072,0,0,0,0,50,188,238
2018-01-13,20,3954,5421,2541,11536,11374,2612,65,25587,0,0,0,0,50,178,228
2018-01-13,21,3883,5292,2475,11299,11037,2504,67,24907,0,0,0,0,46,181,227
2018-01-13,22,3780,5096,2374,10951,10613,2370,65,23999,0,0,0,0,43,178,221
2018-01-13,23,3659,4868,2245,10371,10086,2179,64,22700,0,0,0,0,38,163,201
2018-01-13,24,3519,4699,2124,9738,9515,2007,62,21322,0,0,0,0,34,154,188
2018-01-14,1,3366,4509,2005,9091,9042,1819,62,20014,0,0,0,0,39,153,192
2018-01-14,2,3286,4463,1960,8730,8675,1743,63,19211,0,0,0,0,40,154,194
2018-01-14,3,3251,4450,1946,8526,8442,1698,65,18731,0,0,0,0,43,145,188
2018-01-14,4,3241,4479,1962,8444,8326,1669,68,18507,0,0,0,0,41,129,170
2018-01-14,5,3275,4547,2016,8478,8299,1674,72,18523,0,0,0,0,38,128,166
2018-01-14,6,3341,4658,2114,8678,8460,1710,77,18925,0,0,0,0,36,124,160
2018-01-14,7,3411,4833,2264,9047,8738,1793,84,19662,0,34,0,34,34,122,156
2018-01-14,8,3379,4938,2446,9283,8690,1811,87,19871,39,842,80,961,37,112,149
2018-01-14,9,3409,4939,2564,9395,8812,1832,81,20120,240,2711,444,3395,45,107,152
2018-01-14,10,3433,4916,2611,9364,8859,1837,74,20134,402,3891,774,5067,49,114,163
2018-01-14,11,3421,4853,2577,9239,8918,1832,67,20056,469,4269,951,5689,49,115,164
2018-01-14,12,3396,4844,2502,9039,8968,1825,63,19895,500,4353,1054,5907,46,104,150
2018-01-14,13,3374,4784,2428,8945,9096,1825,59,19925,573,4297,1099,5969,46,88,134
2018-01-14,14,3361,4790,2353,8981,9178,1884,57,20100,594,4190,1079,5863,43,76,119
2018-01-14,15,3377,4818,2284,9124,9312,1963,55,20454,563,3628,964,5155,41,68,109
2018-01-14,16,3421,4967,2298,9545,9583,2047,55,21230,363,2125,614,3102,39,67,106
2018-01-14,17,3603,5274,2405,10061,10030,2219,59,22369,55,373,118,546,36,60,96
2018-01-14,18,3920,5420,2604,11253,11185,2541,67,25046,0,0,0,0,34,55,89
2018-01-14,19,3964,5394,2611,11660,11389,2578,67,25694,0,0,0,0,37,58,95
2018-01-14,20,3920,5334,2581,11523,11208,2506,65,25302,0,0,0,0,40,51,91
2018-01-14,21,3850,5186,2508,11211,10908,2398,67,24584,0,0,0,0,44,43,87
2018-01-14,22,3716,4952,2371,10701,10437,2242,65,23445,0,0,0,0,52,45,97
2018-01-14,23,3578,4714,2198,10031,9882,2050,63,22026,0,0,0,0,60,58,118
2018-01-14,24,3412,4588,2056,9342,9315,1882,61,20600,0,0,0,0,71,92,163
2018-01-15,1,3307,4562,1979,8961,9070,1773,60,19863,0,0,0,0,54,61,115
2018-01-15,2,3233,4548,1952,8632,8791,1714,61,19198,0,0,0,0,72,73,145
2018-01-15,3,3206,4574,1946,8478,8632,1661,63,18833,0,0,0,0,84,94,178
2018-01-15,4,3217,4662,1972,8477,8607,1652,65,18801,0,0,0,0,67,132,199
2018-01-15,5,3285,4851,2076,8665,8892,1710,69,19336,0,0,0,0,61,148,209
2018-01-15,6,3419,5151,2314,9234,9522,1844,76,20677,0,0,0,0,53,148,201
2018-01-15,7,3588,5431,2592,10188,10352,2044,83,22667,0,32,0,32,57,156,213
2018-01-15,8,3618,5527,2785,10829,10630,2094,86,23639,52,861,113,1026,56,138,194
2018-01-15,9,3643,5541,2836,11152,10903,2109,80,24244,279,2871,510,3660,55,125,180
2018-01-15,10,3641,5536,2860,11203,10909,2074,74,24261,440,4095,781,5316,53,105,158
2018-01-15,11,3606,5470,2837,11119,10977,2006,68,24170,453,4429,936,5818,51,100,151
2018-01-15,12,3536,5376,2740,10928,10996,1936,63,23924,423,4518,974,5915,51,114,165
2018-01-15,13,3501,5337,2653,10758,11073,1926,59,23816,410,4304,981,5695,58,148,206
2018-01-15,14,3483,5276,2571,10682,11120,1948,56,23805,411,4187,938,5536,60,190,250
2018-01-15,15,3485,5290,2511,10656,11172,1996,54,23877,364,3655,815,4834,71,268,339
2018-01-15,16,3528,5351,2536,10686,11159,2093,54,23992,238,2237,519,2994,92,376,468
2018-01-15,17,3683,5617,2612,11028,11437,2234,57,24757,38,396,99,533,89,362,451
2018-01-15,18,4016,5792,2789,12159,12532,2538,66,27295,0,0,0,0,97,360,457
2018-01-15,19,4095,5731,2814,12647,12852,2654,67,28220,0,0,0,0,105,439,544
2018-01-15,20,4048,5641,2758,12418,12591,2582,66,27657,0,0,0,0,104,438,542
2018-01-15,21,3958,5442,2686,11939,12190,2464,66,26659,0,0,0,0,105,436,541
2018-01-15,22,3800,5147,2508,11219,11610,2282,64,25175,0,0,0,0,96,438,534
2018-01-15,23,3618,4869,2314,10353,10740,2063,63,23219,0,0,0,0,128,424,552
2018-01-15,24,3440,4721,2161,9556,9929,1890,61,21436,0,0,0,0,179,433,612
2018-01-16,1,3326,4632,2024,9382,9506,1867,56,20811,0,0,0,0,151,409,560
2018-01-16,2,3253,4605,1971,9046,9163,1797,57,20062,0,0,0,0,146,469,615
2018-01-16,3,3222,4619,1957,8871,9009,1754,58,19692,0,0,0,0,140,596,736
2018-01-16,4,3232,4707,1976,8822,8970,1745,60,19597,0,0,0,0,132,725,857
2018-01-16,5,3305,4939,2077,9075,9239,1797,64,20175,0,0,0,0,104,820,924
2018-01-16,6,3473,5337,2330,9735,9952,1953,72,21712,0,0,0,0,88,934,1022
2018-01-16,7,3709,5682,2696,10958,10995,2216,80,24249,0,26,0,26,80,986,1066
2018-01-16,8,3728,5691,2905,11959,11418,2315,83,25775,33,613,73,719,62,895,957
2018-01-16,9,3692,5607,2867,11916,11327,2288,76,25607,199,1987,406,2592,63,918,981
2018-01-16,10,3656,5536,2821,11793,11257,2228,70,25348,361,2968,718,4047,65,916,981
2018-01-16,11,3622,5454,2758,11614,11195,2181,65,25055,395,3579,898,4872,58,960,1018
2018-01-16,12,3585,5369,2687,11362,11155,2148,62,24727,419,3837,960,5216,43,1012,1055
2018-01-16,13,3556,5329,2635,11274,11225,2151,59,24709,421,3929,964,5314,31,1102,1133
2018-01-16,14,3545,5292,2581,11355,11350,2183,57,24945,427,3822,913,5162,24,1135,1159
2018-01-16,15,3562,5278,2525,11255,11481,2236,56,25028,370,3439,779,4588,22,1160,1182
2018-01-16,16,3611,5378,2517,11318,11590,2306,56,25270,225,1960,450,2635,29,1161,1190
2018-01-16,17,3782,5642,2611,11590,11856,2437,59,25941,42,368,95,505,28,1195,1223
2018-01-16,18,4073,5787,2779,12512,12811,2716,66,28106,0,0,0,0,37,1170,1207
2018-01-16,19,4123,5735,2801,12904,13050,2769,66,28790,0,0,0,0,37,1144,1181
2018-01-16,20,4075,5653,2758,12676,12841,2704,65,28286,0,0,0,0,36,1026,1062
2018-01-16,21,3987,5445,2666,12223,12384,2586,63,27257,0,0,0,0,33,885,918
2018-01-16,22,3827,5144,2509,11530,11709,2405,61,25705,0,0,0,0,34,711,745
2018-01-16,23,3644,4862,2316,10632,10847,2172,58,23710,0,0,0,0,36,548,584
2018-01-16,24,3459,4701,2150,9834,10067,1978,56,21935,0,0,0,0,45,442,487
2018-01-17,1,3307,4602,2054,9518,9590,1832,57,20997,0,0,0,0,46,248,294
2018-01-17,2,3240,4570,2002,9172,9231,1767,58,20228,0,0,0,0,51,213,264
2018-01-17,3,3213,4583,1987,9027,9059,1730,60,19876,0,0,0,0,60,161,221
2018-01-17,4,3223,4668,2009,9024,8964,1722,63,19773,0,0,0,0,67,133,200
2018-01-17,5,3303,4895,2107,9232,9257,1781,68,20338,0,0,0,0,64,105,169
2018-01-17,6,3474,5279,2356,9843,9927,1949,76,21795,0,0,0,0,62,91,153
2018-01-17,7,3715,5634,2716,10963,11099,2235,84,24381,0,38,0,38,72,94,166
2018-01-17,8,3717,5627,2923,11716,11605,2325,87,25733,38,956,89,1083,70,98,168
2018-01-17,9,3662,5548,2880,11664,11594,2254,79,25591,174,3118,435,3727,70,99,169
2018-01-17,10,3610,5473,2831,11612,11509,2168,72,25361,295,4410,733,5438,69,112,181
2018-01-17,11,3564,5385,2773,11484,11511,2117,67,25179,371,4779,912,6062,67,112,179
2018-01-17,12,3513,5297,2696,11278,11560,2112,63,25013,414,4797,967,6178,67,105,172
2018-01-17,13,3480,5254,2638,11171,11624,2135,60,24990,459,4707,1001,6167,70,97,167
2018-01-17,14,3467,5218,2583,11207,11813,2169,58,25247,484,4621,988,6093,74,85,159
2018-01-17,15,3478,5205,2532,11232,11917,2220,57,25426,443,4183,889,5515,78,78,156
2018-01-17,16,3529,5302,2524,11311,12008,2346,57,25722,287,2482,571,3340,82,72,154
2018-01-17,17,3693,5558,2612,11753,12367,2489,60,26669,50,489,123,662,84,64,148
2018-01-17,18,3992,5703,2780,12769,13042,2779,67,28657,0,4,1,5,88,65,153
2018-01-17,19,4051,5648,2782,13070,13185,2808,68,29131,0,0,0,0,97,69,166
2018-01-17,20,4011,5573,2717,12859,12871,2726,66,28522,0,0,0,0,107,74,181
2018-01-17,21,3929,5389,2628,12475,12355,2602,66,27498,0,0,0,0,123,66,189
2018-01-17,22,3773,5094,2481,11779,11763,2424,64,26030,0,0,0,0,137,70,207
2018-01-17,23,3594,4813,2293,10938,10977,2199,61,24175,0,0,0,0,150,67,217
2018-01-17,24,3415,4642,2131,10165,10177,1990,59,22391,0,0,0,0,170,63,233
2018-01-18,1,3289,4539,2000,9387,9609,1855,56,20907,0,0,0,0,168,57,225
2018-01-18,2,3218,4510,1941,9028,9258,1787,57,20131,0,0,0,0,159,51,210
2018-01-18,3,3185,4527,1916,8848,9054,1744,59,19705,0,0,0,0,152,46,198
2018-01-18,4,3197,4614,1926,8832,9014,1733,62,19640,0,0,0,0,150,48,198
2018-01-18,5,3271,4828,2013,9073,9203,1783,67,20126,0,0,0,0,151,45,196
2018-01-18,6,3435,5229,2246,9734,9842,1945,74,21596,0,0,0,0,155,43,198
2018-01-18,7,3671,5547,2596,10941,10888,2233,82,24144,0,43,0,43,162,48,210
2018-01-18,8,3684,5555,2801,11800,11245,2309,85,25439,38,945,106,1089,158,47,205
2018-01-18,9,3653,5481,2782,11797,11207,2251,77,25331,189,2989,471,3649,162,48,210
2018-01-18,10,3616,5414,2769,11769,11151,2169,70,25158,333,4210,799,5342,176,56,232
2018-01-18,11,3583,5326,2738,11608,11151,2119,64,24943,394,4614,967,5975,212,67,279
2018-01-18,12,3547,5236,2689,11357,11168,2096,61,24681,396,4656,998,6050,300,108,408
2018-01-18,13,3530,5194,2657,11258,11262,2098,58,24676,396,4635,1015,6046,329,203,532
2018-01-18,14,3533,5165,2620,11221,11415,2126,56,24817,403,4516,962,5881,330,297,627
2018-01-18,15,3557,5147,2580,11230,11567,2172,54,25024,329,3953,793,5075,430,394,824
2018-01-18,16,3605,5233,2578,11274,11569,2249,54,25146,214,2361,487,3062,577,483,1060
2018-01-18,17,3762,5471,2657,11593,11833,2382,57,25866,39,433,102,574,592,508,1100
2018-01-18,18,4041,5607,2814,12466,12724,2654,64,27908,0,1,1,2,613,567,1180
2018-01-18,19,4080,5526,2827,12921,12882,2732,64,28599,0,0,0,0,604,659,1263
2018-01-18,20,4028,5460,2766,12682,12619,2670,63,28035,0,0,0,0,595,708,1303
2018-01-18,21,3939,5280,2672,12213,12185,2546,61,27005,0,0,0,0,602,766,1368
2018-01-18,22,3785,4996,2519,11556,11605,2366,59,25586,0,0,0,0,599,812,1411
2018-01-18,23,3617,4713,2334,10671,10782,2138,55,23646,0,0,0,0,546,829,1375
2018-01-18,24,3437,4533,2178,9945,10114,1951,53,22063,0,0,0,0,513,860,1373
2018-01-19,1,3339,4443,2103,9663,9806,1880,55,21404,0,0,0,0,437,909,1346
2018-01-19,2,3261,4396,2060,9316,9439,1807,56,20618,0,0,0,0,389,969,1358
2018-01-19,3,3226,4393,2042,9123,9263,1765,57,20208,0,0,0,0,360,1016,1376
2018-01-19,4,3224,4457,2067,9071,9191,1753,60,20075,0,0,0,0,323,1043,1366
2018-01-19,5,3298,4648,2169,9308,9436,1798,64,20606,0,0,0,0,277,1085,1362
2018-01-19,6,3457,4985,2410,9970,10046,1941,72,22029,0,0,0,0,240,1105,1345
2018-01-19,7,3676,5312,2769,11154,10975,2220,79,24428,0,39,0,39,216,1157,1373
2018-01-19,8,3695,5371,2988,12109,11440,2347,83,25979,27,785,32,844,202,1181,1383
2018-01-19,9,3680,5363,2966,12182,11593,2369,76,26220,162,2468,208,2838,191,1242,1433
2018-01-19,10,3662,5344,2919,12025,11678,2350,70,26123,302,3645,423,4370,163,1321,1484
2018-01-19,11,3647,5301,2861,11796,11636,2298,64,25794,355,4030,583,4968,143,1501,1644
2018-01-19,12,3634,5253,2768,11613,11515,2253,60,25441,392,3918,682,4992,130,1696,1826
2018-01-19,13,3614,5242,2695,11520,11421,2233,56,25230,409,3758,713,4880,125,1926,2051
2018-01-19,14,3604,5225,2626,11469,11437,2247,54,25207,418,3568,679,4665,134,2064,2198
2018-01-19,15,3609,5230,2574,11555,11425,2253,52,25285,392,3029,606,4027,146,2235,2381
2018-01-19,16,3652,5301,2561,11615,11422,2283,52,25372,262,1757,379,2398,165,2359,2524
2018-01-19,17,3802,5497,2650,11989,11746,2410,55,26200,51,367,98,516,169,2435,2604
2018-01-19,18,4093,5582,2805,12674,12652,2679,62,28067,0,1,0,1,187,2447,2634
2018-01-19,19,4128,5517,2802,12961,12909,2734,63,28667,0,0,0,0,201,2468,2669
2018-01-19,20,4076,5394,2739,12779,12662,2653,63,28157,0,0,0,0,186,2531,2717
2018-01-19,21,3986,5216,2648,12392,12333,2531,62,27318,0,0,0,0,181,2606,2787
2018-01-19,22,3863,5006,2517,11833,11819,2386,61,26099,0,0,0,0,186,2644,2830
2018-01-19,23,3728,4770,2364,11113,11160,2199,58,24530,0,0,0,0,177,2674,2851
2018-01-19,24,3568,4596,2221,10363,10406,2019,58,22846,0,0,0,0,188,2691,2879
2018-01-20,1,3449,4511,2172,9791,10106,1937,64,21897,0,0,0,0,204,2733,2937
2018-01-20,2,3363,4458,2126,9428,9705,1844,67,21044,0,0,0,0,210,2749,2959
2018-01-20,3,3319,4453,2109,9184,9431,1791,68,20474,0,0,0,0,218,2752,2970
2018-01-20,4,3302,4483,2123,9116,9305,1772,70,20262,0,0,0,0,227,2747,2974
2018-01-20,5,3329,4579,2186,9220,9337,1782,72,20411,0,0,0,0,226,2746,2972
2018-01-20,6,3403,4737,2302,9544,9623,1830,77,21074,0,0,0,0,218,2764,2982
2018-01-20,7,3507,4940,2477,9970,10035,1949,83,22037,0,31,0,31,223,2731,2954
2018-01-20,8,3527,5057,2655,10384,10195,2007,87,22673,44,866,85,995,182,2791,2973
2018-01-20,9,3576,5108,2785,10677,10418,2011,82,23188,260,2956,436,3652,151,2877,3028
2018-01-20,10,3628,5126,2807,10794,10583,2006,78,23461,452,4209,765,5426,126,2949,3075
2018-01-20,11,3634,5125,2762,10637,10648,1973,75,23334,499,4627,940,6066,118,2964,3082
2018-01-20,12,3619,5115,2660,10414,10490,1913,71,22887,506,4683,984,6173,123,2979,3102
2018-01-20,13,3606,5091,2559,10237,10243,1880,65,22425,511,4679,1015,6205,123,2968,3091
2018-01-20,14,3588,5073,2469,10084,10109,1868,61,22122,528,4545,991,6064,114,2958,3072
2018-01-20,15,3591,5094,2396,10027,10074,1896,59,22056,493,4102,855,5450,118,2923,3041
2018-01-20,16,3647,5192,2404,10254,10201,1985,59,22499,342,2599,546,3487,118,2867,2985
2018-01-20,17,3833,5456,2510,10811,10693,2187,67,23758,70,592,146,808,140,2773,2913
2018-01-20,18,4147,5584,2674,11859,11849,2536,79,26323,1,12,3,16,188,2651,2839
2018-01-20,19,4173,5514,2680,12178,12058,2637,81,26954,0,0,0,0,266,2480,2746
2018-01-20,20,4116,5428,2628,12066,11938,2576,80,26661,0,0,0,0,255,2220,2475
2018-01-20,21,4040,5298,2563,11800,11688,2465,79,26032,0,0,0,0,242,1973,2215
2018-01-20,22,3927,5098,2453,11384,11250,2345,78,25057,0,0,0,0,244,1709,1953
2018-01-20,23,3781,4867,2316,10792,10634,2182,75,23683,0,0,0,0,249,1497,1746
2018-01-20,24,3641,4703,2196,10147,10039,2019,74,22279,0,0,0,0,284,1277,1561
2018-01-21,1,3560,4649,2145,9694,9924,1952,75,21645,0,0,0,0,224,1150,1374
2018-01-21,2,3489,4593,2100,9356,9557,1859,77,20849,0,0,0,0,223,913,1136
2018-01-21,3,3462,4589,2092,9154,9292,1806,79,20331,0,0,0,0,246,721,967
2018-01-21,4,3456,4604,2099,9084,9188,1789,84,20145,0,0,0,0,279,577,856
2018-01-21,5,3501,4679,2151,9168,9234,1807,88,20297,0,0,0,0,249,475,724
2018-01-21,6,3560,4791,2251,9396,9456,1871,94,20817,0,0,0,0,223,388,611
2018-01-21,7,3646,4971,2396,9790,9787,1974,102,21653,0,40,0,40,198,311,509
2018-01-21,8,3624,5081,2565,10145,9800,2018,105,22068,25,1019,88,1132,180,253,433
2018-01-21,9,3620,5082,2697,10561,9706,2011,97,22375,147,3337,418,3902,164,203,367
2018-01-21,10,3609,5068,2745,10808,9644,1954,87,22493,261,4693,674,5628,150,172,322
2018-01-21,11,3580,5019,2712,10735,9445,1894,79,22153,320,5020,794,6134,156,167,323
2018-01-21,12,3541,5028,2648,10648,9203,1835,72,21758,351,4970,825,6146,147,189,336
2018-01-21,13,3500,4977,2588,10472,8996,1815,66,21349,358,4878,803,6039,144,219,363
2018-01-21,14,3478,4996,2523,10353,8983,1834,62,21232,354,4613,788,5755,145,317,462
2018-01-21,15,3492,5040,2462,10351,9156,1887,58,21452,304,3978,696,4978,150,467,617
2018-01-21,16,3546,5188,2483,10439,9459,2007,58,21963,226,2404,462,3092,169,645,814
2018-01-21,17,3763,5483,2586,10678,10333,2221,63,23295,61,540,124,725,153,768,921
2018-01-21,18,4109,5637,2782,11736,11891,2587,77,26291,0,6,1,7,171,870,1041
2018-01-21,19,4165,5601,2779,12418,12205,2668,81,27372,0,0,0,0,195,950,1145
2018-01-21,20,4135,5517,2738,12367,12280,2645,82,27374,0,0,0,0,211,924,1135
2018-01-21,21,4065,5366,2658,12016,12081,2578,81,26756,0,0,0,0,221,930,1151
2018-01-21,22,3933,5138,2515,11416,11673,2437,79,25605,0,0,0,0,240,890,1130
2018-01-21,23,3747,4888,2347,10679,10920,2223,75,23897,0,0,0,0,247,817,1064
2018-01-21,24,3585,4748,2206,9939,10178,2023,75,22215,0,0,0,0,268,727,995
2018-01-22,1,3461,4661,2071,9344,9923,1877,76,21221,0,0,0,0,210,640,850
2018-01-22,2,3406,4644,2039,9038,9660,1840,78,20616,0,0,0,0,212,625,837
2018-01-22,3,3394,4670,2042,8909,9544,1815,81,20349,0,0,0,0,212,617,829
2018-01-22,4,3406,4768,2085,8940,9555,1816,84,20395,0,0,0,0,213,611,824
2018-01-22,5,3496,5007,2211,9256,9884,1878,90,21108,0,0,0,0,195,574,769
2018-01-22,6,3683,5399,2480,10013,10706,2079,99,22897,0,0,0,0,170,539,709
2018-01-22,7,3906,5777,2862,11336,11818,2376,108,25638,0,22,0,22,153,497,650
2018-01-22,8,3935,5814,3085,12265,12114,2450,110,26939,33,785,100,918,131,387,518
2018-01-22,9,3884,5770,3063,12201,12010,2356,100,26667,244,2778,501,3523,105,272,377
2018-01-22,10,3827,5720,3005,12072,11765,2212,91,26140,378,4196,772,5346,83,206,289
2018-01-22,11,3763,5651,2945,11860,11532,2146,83,25622,410,4750,921,6081,54,176,230
2018-01-22,12,3697,5584,2850,11582,11307,2107,77,25073,450,4959,974,6383,47,152,199
2018-01-22,13,3661,5551,2787,11467,11194,2122,72,24855,441,5048,996,6485,37,137,174
2018-01-22,14,3633,5524,2727,11438,11145,2166,67,24815,433,4986,981,6400,29,151,180
2018-01-22,15,3635,5519,2664,11314,11250,2239,65,24868,459,4523,898,5880,24,172,196
2018-01-22,16,3685,5610,2661,11370,11433,2294,65,25162,375,2937,626,3938,23,224,247
2018-01-22,17,3899,5861,2758,11870,11863,2408,70,26211,97,701,186,984,22,297,319
2018-01-22,18,4237,6009,2944,12826,12944,2683,79,28532,1,11,3,15,26,384,410
2018-01-22,19,4291,5934,2974,13282,13508,2833,85,29708,0,0,0,0,46,468,514
2018-01-22,20,4252,5831,2927,13101,13321,2785,85,29292,0,0,0,0,43,480,523
2018-01-22,21,4167,5628,2830,12668,13024,2671,84,28448,0,0,0,0,48,473,521
2018-01-22,22,4008,5314,2661,11957,12526,2494,81,27058,0,0,0,0,60,472,532
2018-01-22,23,3803,5021,2458,10981,11697,2264,77,25019,0,0,0,0,58,409,467
2018-01-22,24,3621,4850,2290,10139,10854,2057,75,23125,0,0,0,0,61,352,413
2018-01-23,1,3535,4789,2207,9820,9984,1912,74,21791,0,0,0,0,61,307,368
2018-01-23,2,3473,4752,2170,9460,9656,1853,76,21045,0,0,0,0,58,221,279
2018-01-23,3,3453,4761,2162,9271,9489,1823,79,20661,0,0,0,0,54,176,230
2018-01-23,4,3465,4843,2190,9258,9479,1821,82,20640,0,0,0,0,53,156,209
2018-01-23,5,3551,5070,2304,9558,9736,1892,89,21274,0,0,0,0,46,144,190
2018-01-23,6,3734,5468,2563,10286,10513,2091,97,22988,0,0,0,0,38,152,190
2018-01-23,7,3951,5822,2945,11629,11541,2396,106,25673,0,25,0,25,36,158,194
2018-01-23,8,3944,5834,3133,12350,11916,2446,108,26820,54,1088,122,1264,37,165,202
2018-01-23,9,3867,5767,3087,12130,11722,2326,97,26274,349,3726,635,4710,42,171,213
2018-01-23,10,3791,5701,3023,11757,11545,2180,86,25569,519,5185,983,6687,47,201,248
2018-01-23,11,3728,5628,2944,11417,11371,2077,77,24942,559,5538,1122,7219,49,225,274
2018-01-23,12,3672,5559,2863,11142,11231,2018,70,24461,567,5618,1156,7341,53,231,284
2018-01-23,13,3626,5535,2803,10981,11270,2002,65,24317,557,5612,1167,7336,56,232,288
2018-01-23,14,3603,5508,2745,10994,11444,2039,62,24539,572,5551,1144,7267,57,199,256
2018-01-23,15,3605,5509,2682,11071,11658,2102,59,24891,544,5073,1023,6640,60,175,235
2018-01-23,16,3655,5617,2674,11307,11847,2194,60,25408,415,3421,717,4553,65,156,221
2018-01-23,17,3846,5868,2763,11917,12264,2350,64,26595,109,887,211,1207,63,135,198
2018-01-23,18,4188,6013,2942,13012,13242,2671,72,28997,1,16,3,20,62,128,190
2018-01-23,19,4255,5945,2961,13387,13529,2799,77,29793,0,0,0,0,61,117,178
2018-01-23,20,4218,5851,2899,13257,13325,2744,80,29405,0,0,0,0,66,116,182
2018-01-23,21,4136,5642,2801,12887,12872,2613,79,28451,0,0,0,0,76,108,184
2018-01-23,22,3974,5331,2633,12244,12166,2422,77,26908,0,0,0,0,79,105,184
2018-01-23,23,3770,5037,2438,11284,11292,2181,74,24831,0,0,0,0,85,102,187
2018-01-23,24,3590,4860,2265,10440,10513,1986,73,23012,0,0,0,0,90,108,198
2018-01-24,1,3472,4788,2145,9629,9628,1892,71,21220,0,0,0,0,111,125,236
2018-01-24,2,3408,4747,2093,9292,9347,1829,73,20541,0,0,0,0,116,122,238
2018-01-24,3,3384,4757,2077,9133,9186,1795,76,20189,0,0,0,0,111,119,230
2018-01-24,4,3397,4836,2097,9141,9190,1795,79,20204,0,0,0,0,108,106,214
2018-01-24,5,3483,5061,2192,9439,9485,1859,86,20869,0,0,0,0,118,104,222
2018-01-24,6,3654,5445,2436,10186,10315,2041,95,22637,0,0,0,0,131,107,238
2018-01-24,7,3884,5792,2788,11415,11501,2342,103,25361,0,27,0,27,144,103,247
2018-01-24,8,3875,5814,2978,12067,11755,2401,105,26328,67,1188,146,1401,150,87,237
2018-01-24,9,3806,5754,2952,12020,11691,2298,93,26102,424,4103,766,5293,153,84,237
2018-01-24,10,3732,5693,2907,11905,11415,2176,82,25577,626,5604,1177,7407,163,87,250
2018-01-24,11,3670,5624,2854,11634,11144,2097,73,24948,625,5918,1269,7812,184,79,263
2018-01-24,12,3615,5554,2794,11322,10977,2056,66,24422,530,5959,1227,7716,218,75,293
2018-01-24,13,3590,5527,2755,11179,10932,2056,62,24228,500,5943,1217,7660,293,72,365
2018-01-24,14,3584,5511,2716,11111,11001,2094,59,24265,457,5897,1178,7532,306,75,381
2018-01-24,15,3606,5513,2683,11133,11158,2156,57,24505,369,5444,961,6774,351,89,440
2018-01-24,16,3665,5611,2694,11314,11284,2244,58,24899,245,3758,649,4652,379,107,486
2018-01-24,17,3854,5858,2781,11683,11666,2390,62,25801,68,1011,192,1271,362,107,469
2018-01-24,18,4184,6001,2944,12639,12663,2674,69,28045,1,33,3,37,344,126,470
2018-01-24,19,4239,5908,2970,13249,12992,2794,70,29105,0,0,0,0,334,166,500
2018-01-24,20,4199,5803,2913,13081,12858,2741,73,28753,0,0,0,0,295,212,507
2018-01-24,21,4114,5608,2813,12616,12530,2612,73,27830,0,0,0,0,277,270,547
2018-01-24,22,3949,5304,2656,11879,11887,2423,71,26260,0,0,0,0,240,312,552
2018-01-24,23,3750,5006,2458,10900,11055,2191,68,24214,0,0,0,0,230,357,587
2018-01-24,24,3570,4820,2301,10114,10368,1993,67,22542,0,0,0,0,217,448,665
2018-01-25,1,3455,4669,2214,9746,10040,1913,72,21771,0,0,0,0,216,717,933
2018-01-25,2,3389,4623,2174,9377,9681,1853,74,20985,0,0,0,0,189,920,1109
2018-01-25,3,3362,4624,2161,9181,9461,1822,76,20541,0,0,0,0,171,1127,1298
2018-01-25,4,3374,4699,2193,9170,9412,1798,79,20459,0,0,0,0,140,1270,1410
2018-01-25,5,3459,4917,2297,9435,9673,1852,85,21045,0,0,0,0,131,1519,1650
2018-01-25,6,3632,5288,2557,10158,10344,2021,92,22615,0,0,0,0,123,1741,1864
2018-01-25,7,3855,5624,2936,11377,11444,2309,99,25229,0,20,0,20,127,1887,2014
2018-01-25,8,3855,5658,3136,12204,11779,2405,100,26488,48,989,73,1110,131,2012,2143
2018-01-25,9,3794,5624,3101,12054,11779,2347,93,26273,355,3436,405,4196,138,2193,2331
2018-01-25,10,3741,5593,3043,11849,11717,2262,86,25914,537,4938,691,6166,138,2285,2423
2018-01-25,11,3703,5550,2979,11593,11647,2193,78,25511,574,5335,860,6769,160,2321,2481
2018-01-25,12,3677,5503,2893,11342,11485,2121,73,25022,575,5344,941,6860,198,2261,2459
2018-01-25,13,3652,5500,2835,11246,11402,2085,70,24802,573,5284,987,6844,282,2237,2519
2018-01-25,14,3643,5497,2785,11255,11298,2085,67,24705,562,5069,930,6561,360,2252,2612
2018-01-25,15,3648,5517,2723,11126,11186,2108,65,24485,516,4450,775,5741,461,2320,2781
2018-01-25,16,3689,5613,2727,11347,11199,2179,65,24789,383,2737,505,3625,535,2334,2869
2018-01-25,17,3871,5841,2816,11925,11750,2340,69,26084,108,738,176,1022,479,2288,2767
2018-01-25,18,4197,5964,2972,12800,12856,2671,79,28405,3,22,4,29,433,2229,2662
2018-01-25,19,4243,5890,3000,13373,13124,2796,83,29375,0,0,0,0,390,2220,2610
2018-01-25,20,4200,5783,2949,13267,13004,2746,83,29099,0,0,0,0,363,2266,2629
2018-01-25,21,4116,5569,2862,12849,12631,2611,81,28172,0,0,0,0,356,2258,2614
2018-01-25,22,3957,5272,2700,12114,12049,2416,78,26657,0,0,0,0,336,2257,2593
2018-01-25,23,3759,4990,2510,11159,11247,2181,74,24661,0,0,0,0,308,2237,2545
2018-01-25,24,3587,4821,2349,10327,10444,1987,72,22831,0,0,0,0,262,2215,2477
2018-01-26,1,3534,4690,2260,9796,9956,1914,74,21740,0,0,0,0,194,2240,2434
2018-01-26,2,3469,4646,2217,9450,9613,1847,75,20984,0,0,0,0,175,2258,2433
2018-01-26,3,3442,4647,2205,9273,9424,1810,77,20584,0,0,0,0,146,2215,2361
2018-01-26,4,3448,4720,2235,9268,9393,1806,80,20547,0,0,0,0,130,2071,2201
2018-01-26,5,3529,4932,2345,9542,9677,1868,86,21173,0,0,0,0,120,1774,1894
2018-01-26,6,3707,5290,2582,10291,10419,2029,95,22834,0,0,0,0,106,1381,1487
2018-01-26,7,3921,5620,2948,11718,11415,2310,105,25547,0,21,0,21,97,1051,1148
2018-01-26,8,3944,5670,3151,12418,11502,2382,105,26406,51,1083,95,1229,91,765,856
2018-01-26,9,3898,5641,3117,12192,11283,2298,95,25868,375,3786,569,4730,79,543,622
2018-01-26,10,3847,5601,3058,11857,10979,2179,85,25099,555,5280,907,6742,70,358,428
2018-01-26,11,3795,5546,2987,11510,10806,2085,77,24478,585,5623,1063,7271,60,284,344
2018-01-26,12,3741,5478,2885,11118,10547,2008,72,23744,588,5706,1130,7424,50,254,304
2018-01-26,13,3689,5447,2809,10780,10236,1974,66,23055,584,5690,1143,7417,43,244,287
2018-01-26,14,3651,5423,2746,10717,10244,2004,61,23026,597,5613,1124,7334,41,202,243
2018-01-26,15,3628,5422,2682,10753,10408,2045,58,23264,569,5226,1013,6808,38,200,238
2018-01-26,16,3659,5485,2677,10903,10611,2127,58,23699,433,3528,713,4674,30,222,252
2018-01-26,17,3834,5697,2756,11447,11046,2291,62,24846,121,1021,234,1376,35,250,285
2018-01-26,18,4162,5817,2909,12389,12046,2605,72,27112,2,26,7,35,41,352,393
2018-01-26,19,4213,5736,2912,13033,12567,2731,78,28409,0,0,0,0,50,428,478
2018-01-26,20,4177,5607,2842,12889,12431,2679,79,28078,0,0,0,0,57,409,466
2018-01-26,21,4112,5430,2750,12549,12144,2569,79,27341,0,0,0,0,65,381,446
2018-01-26,22,3998,5217,2615,12048,11745,2427,78,26298,0,0,0,0,67,366,433
2018-01-26,23,3836,4985,2456,11332,11186,2247,76,24841,0,0,0,0,76,352,428
2018-01-26,24,3679,4818,2297,10622,10507,2062,74,23264,0,0,0,0,77,357,434
2018-01-27,1,3579,4689,2156,9936,9777,1926,75,21714,0,0,0,0,99,177,276
2018-01-27,2,3502,4632,2097,9527,9427,1854,76,20884,0,0,0,0,104,201,305
2018-01-27,3,3463,4620,2076,9286,9180,1814,78,20358,0,0,0,0,95,235,330
2018-01-27,4,3461,4649,2078,9247,9072,1800,81,20200,0,0,0,0,91,270,361
2018-01-27,5,3491,4746,2127,9319,9173,1820,85,20397,0,0,0,0,88,250,338
2018-01-27,6,3571,4902,2235,9647,9492,1892,92,21123,0,0,0,0,83,236,319
2018-01-27,7,3650,5091,2388,10189,9895,2010,98,22192,0,20,0,20,71,229,300
2018-01-27,8,3628,5220,2552,10630,9934,2034,102,22700,47,1120,104,1271,78,216,294
2018-01-27,9,3627,5285,2674,10700,9924,2010,93,22727,344,3837,616,4797,103,196,299
2018-01-27,10,3617,5295,2714,10464,9846,1922,83,22315,532,5280,999,6811,118,202,320
2018-01-27,11,3573,5264,2683,10087,9655,1823,74,21639,592,5603,1172,7367,100,207,307
2018-01-27,12,3530,5205,2595,9707,9452,1748,65,20972,607,5673,1232,7512,75,242,317
2018-01-27,13,3477,5149,2510,9445,9369,1740,60,20614,617,5644,1240,7501,77,288,365
2018-01-27,14,3440,5117,2440,9313,9425,1771,58,20567,632,5640,1242,7514,72,291,363
2018-01-27,15,3438,5125,2394,9391,9621,1849,56,20917,606,5352,1149,7107,77,295,372
2018-01-27,16,3480,5230,2404,9745,9819,1958,57,21579,473,3790,842,5105,90,280,370
2018-01-27,17,3660,5478,2494,10631,10335,2132,61,23159,145,1115,282,1542,95,242,337
2018-01-27,18,3990,5649,2648,11865,11403,2429,68,25765,4,38,22,64,114,231,345
2018-01-27,19,4044,5593,2657,12257,11836,2552,72,26717,0,0,0,0,139,227,366
2018-01-27,20,4004,5502,2592,12091,11673,2520,74,26358,0,0,0,0,126,225,351
2018-01-27,21,3950,5363,2516,11877,11292,2435,74,25678,0,0,0,0,116,236,352
2018-01-27,22,3854,5163,2407,11537,10777,2310,73,24697,0,0,0,0,110,257,367
2018-01-27,23,3723,4932,2279,10979,10198,2137,71,23385,0,0,0,0,102,259,361
2018-01-27,24,3577,4744,2142,10354,9629,1977,69,22029,0,0,0,0,90,264,354
2018-01-28,1,3418,4539,1964,9483,9281,1880,66,20711,0,0,0,0,93,321,414
2018-01-28,2,3340,4475,1909,9132,8916,1804,67,19919,0,0,0,0,83,329,412
2018-01-28,3,3306,4459,1894,8929,8641,1761,69,19400,0,0,0,0,71,324,395
2018-01-28,4,3293,4475,1908,8848,8497,1734,72,19152,0,0,0,0,63,334,397
2018-01-28,5,3324,4544,1954,8895,8504,1735,76,19210,0,0,0,0,62,328,390
2018-01-28,6,3394,4651,2050,9096,8665,1783,82,19626,0,0,0,0,64,329,393
2018-01-28,7,3440,4808,2197,9431,8855,1855,90,20232,0,21,0,21,68,328,396
2018-01-28,8,3399,4918,2363,9582,8771,1847,90,20290,56,1207,134,1397,71,331,402
2018-01-28,9,3414,4930,2489,9637,8886,1855,82,20461,390,4055,705,5150,71,369,440
2018-01-28,10,3415,4925,2537,9483,9010,1826,76,20395,591,5509,1091,7191,75,459,534
2018-01-28,11,3377,4880,2506,9217,9109,1818,67,20211,632,5796,1231,7659,69,550,619
2018-01-28,12,3371,4894,2439,9027,9229,1844,61,20161,645,5859,1273,7777,61,603,664
2018-01-28,13,3363,4853,2373,8996,9420,1903,58,20377,650,5848,1272,7770,55,648,703
2018-01-28,14,3357,4869,2303,9120,9706,1980,55,20861,673,5837,1264,7774,43,649,692
2018-01-28,15,3376,4911,2250,9379,10044,2104,53,21579,667,5499,1181,7347,35,632,667
2018-01-28,16,3431,5050,2230,9905,10324,2226,53,22508,532,3950,852,5334,30,590,620
2018-01-28,17,3615,5308,2336,10708,10816,2410,56,23990,160,1169,276,1605,23,494,517
2018-01-28,18,3941,5478,2539,11775,11775,2735,64,26348,5,39,22,66,25,449,474
2018-01-28,19,3942,5444,2588,12154,12041,2832,65,27092,0,0,0,0,29,419,448
2018-01-28,20,3905,5375,2563,12033,11832,2733,64,26662,0,0,0,0,29,395,424
2018-01-28,21,3841,5226,2493,11672,11399,2573,64,25709,0,0,0,0,30,370,400
2018-01-28,22,3712,4994,2358,11120,10779,2377,63,24340,0,0,0,0,32,358,390
2018-01-28,23,3573,4755,2193,10354,10139,2140,61,22694,0,0,0,0,36,355,391
2018-01-28,24,3414,4610,2044,9646,9492,1947,60,21145,0,0,0,0,45,337,382
2018-01-29,1,3305,4476,1901,9127,9084,1821,58,20090,0,0,0,0,35,298,333
2018-01-29,2,3240,4452,1860,8878,8769,1771,59,19477,0,0,0,0,35,299,334
2018-01-29,3,3212,4474,1862,8764,8668,1736,61,19230,0,0,0,0,37,279,316
2018-01-29,4,3220,4571,1896,8772,8665,1723,65,19225,0,0,0,0,35,276,311
2018-01-29,5,3304,4813,2012,9089,8957,1764,70,19880,0,0,0,0,35,268,303
2018-01-29,6,3483,5207,2273,9854,9679,1917,79,21530,0,0,0,0,40,271,311
2018-01-29,7,3701,5559,2639,11138,10659,2170,89,24056,0,24,0,24,47,272,319
2018-01-29,8,3730,5609,2845,11855,10934,2263,88,25139,46,1274,109,1429,46,267,313
2018-01-29,9,3704,5584,2824,11716,11183,2274,79,25252,294,4085,586,4965,44,277,321
2018-01-29,10,3670,5552,2789,11506,11426,2282,71,25285,460,5523,920,6903,43,304,347
2018-01-29,11,3631,5501,2738,11203,11707,2298,65,25273,504,5792,1065,7361,37,333,370
2018-01-29,12,3590,5441,2660,10985,11956,2316,61,25318,520,5725,1105,7350,38,339,377
2018-01-29,13,3570,5415,2598,10825,12209,2367,59,25459,510,5685,1119,7314,37,343,380
2018-01-29,14,3554,5390,2536,10811,12516,2419,56,25802,526,5691,1083,7300,37,325,362
2018-01-29,15,3557,5373,2468,10892,12664,2487,55,26098,470,5244,974,6688,38,293,331
2018-01-29,16,3611,5452,2448,11195,12688,2552,55,26491,351,3534,672,4557,40,251,291
2018-01-29,17,3766,5667,2524,11581,12796,2673,59,27109,116,1034,231,1381,42,214,256
2018-01-29,18,4056,5827,2687,12429,13401,2899,65,28795,3,25,15,43,46,194,240
2018-01-29,19,4085,5752,2730,13042,13409,2970,66,29488,0,0,0,0,54,179,233
2018-01-29,20,4043,5643,2688,12778,13113,2874,64,28829,0,0,0,0,60,167,227
2018-01-29,21,3955,5441,2602,12307,12531,2704,63,27605,0,0,0,0,65,151,216
2018-01-29,22,3794,5137,2448,11536,11773,2468,60,25837,0,0,0,0,72,139,211
2018-01-29,23,3608,4846,2263,10668,10915,2208,57,23849,0,0,0,0,71,124,195
2018-01-29,24,3422,4668,2102,9861,10148,1996,56,22061,0,0,0,0,77,120,197
2018-01-30,1,3315,4500,1987,9714,9465,1862,58,21099,0,0,0,0,91,111,202
2018-01-30,2,3250,4458,1936,9393,9144,1797,60,20394,0,0,0,0,94,100,194
2018-01-30,3,3224,4465,1918,9204,8925,1750,61,19940,0,0,0,0,98,85,183
2018-01-30,4,3236,4547,1938,9203,8875,1736,64,19878,0,0,0,0,102,76,178
2018-01-30,5,3316,4768,2033,9459,9140,1783,69,20451,0,0,0,0,98,63,161
2018-01-30,6,3487,5162,2280,10183,9835,1927,77,22022,0,0,0,0,97,53,150
2018-01-30,7,3703,5492,2648,11423,10966,2188,86,24663,0,17,0,17,90,51,141
2018-01-30,8,3719,5523,2858,12016,11327,2255,86,25684,68,984,129,1181,91,49,140
2018-01-30,9,3683,5469,2831,11704,11345,2232,78,25359,419,3350,663,4432,89,41,130
2018-01-30,10,3634,5426,2798,11289,11452,2196,70,25007,635,4708,1045,6388,87,42,129
2018-01-30,11,3592,5370,2738,10961,11564,2184,64,24773,677,5111,1209,6997,77,46,123
2018-01-30,12,3554,5309,2687,10698,11673,2184,60,24615,681,5251,1254,7186,77,62,139
2018-01-30,13,3529,5286,2646,10608,11822,2212,57,24699,691,5292,1268,7251,74,90,164
2018-01-30,14,3520,5263,2604,10661,12093,2276,56,25086,711,5322,1269,7302,73,126,199
2018-01-30,15,3540,5249,2554,10784,12281,2358,55,25478,696,5001,1184,6881,72,184,256
2018-01-30,16,3594,5332,2544,11090,12368,2444,55,25957,549,3363,861,4773,77,282,359
2018-01-30,17,3747,5528,2624,11596,12576,2550,58,26780,183,1053,320,1556,78,395,473
2018-01-30,18,4043,5699,2783,12324,13128,2761,65,28278,6,31,23,60,92,560,652
2018-01-30,19,4077,5626,2837,13044,13274,2810,66,29194,0,0,0,0,116,731,847
2018-01-30,20,4014,5532,2786,12863,12951,2718,65,28597,0,0,0,0,118,881,999
2018-01-30,21,3927,5334,2689,12455,12434,2586,63,27538,0,0,0,0,118,1038,1156
2018-01-30,22,3764,5044,2527,11799,11692,2398,60,25949,0,0,0,0,113,1194,1307
2018-01-30,23,3591,4760,2337,10912,10734,2165,58,23869,0,0,0,0,102,1269,1371
2018-01-30,24,3407,4583,2181,10186,9970,1965,57,22178,0,0,0,0,93,1322,1415
2018-01-31,1,3308,4465,2123,9505,9222,1864,56,20647,0,0,0,0,93,1195,1288
2018-01-31,2,3240,4424,2083,9238,8963,1795,57,20053,0,0,0,0,93,1161,1254
2018-01-31,3,3209,4428,2074,9056,8789,1751,59,19655,0,0,0,0,96,1166,1262
2018-01-31,4,3220,4507,2107,9076,8785,1737,61,19659,0,0,0,0,111,1156,1267
2018-01-31,5,3297,4728,2219,9373,9089,1784,67,20313,0,0,0,0,123,1083,1206
2018-01-31,6,3470,5115,2484,10149,9808,1938,75,21970,0,0,0,0,116,1004,1120
2018-01-31,7,3683,5447,2868,11524,10863,2206,84,24677,0,29,0,29,114,889,1003
2018-01-31,8,3693,5478,3068,12118,11146,2273,86,25623,70,1316,143,1529,107,692,799
2018-01-31,9,3650,5437,3015,11808,11229,2215,77,25329,444,4192,743,5379,102,511,613
2018-01-31,10,3607,5406,2940,11393,11259,2150,69,24871,649,5596,1130,7375,94,350,444
2018-01-31,11,3575,5368,2862,11076,11370,2126,64,24636,682,5887,1271,7840,91,280,371
2018-01-31,12,3542,5321,2760,10820,11485,2120,60,24485,676,5897,1301,7874,71,255,326
2018-01-31,13,3520,5307,2687,10746,11577,2151,58,24532,671,5908,1297,7876,59,244,303
2018-01-31,14,3519,5288,2624,10783,11858,2204,56,24901,681,5962,1281,7924,48,256,304
2018-01-31,15,3545,5296,2564,10846,12114,2290,56,25306,652,5605,1169,7426,39,278,317
2018-01-31,16,3605,5370,2559,11130,12277,2383,56,25846,491,4109,848,5448,34,302,336
2018-01-31,17,3758,5568,2633,11751,12443,2506,59,26759,161,1266,302,1729,26,330,356
2018-01-31,18,4048,5721,2802,12581,13080,2739,65,28465,4,48,12,64,26,381,407
2018-01-31,19,4085,5666,2864,13175,13202,2790,66,29233,0,0,0,0,36,460,496
2018-01-31,20,4013,5566,2826,12958,12873,2716,65,28612,0,0,0,0,40,455,495
2018-01-31,21,3924,5356,2741,12536,12399,2581,62,27578,0,0,0,0,46,443,489
2018-01-31,22,3764,5060,2579,11892,11741,2393,59,26085,0,0,0,0,60,405,465
2018-01-31,23,3587,4778,2386,10986,10892,2167,56,24101,0,0,0,0,61,311,372
2018-01-31,24,3410,4613,2220,10235,10062,1969,55,22321,0,0,0,0,70,242,312
2018-02-01,1,3274,4488,2122,9669,9581,1883,55,21188,0,0,0,0,70,189,259
2018-02-01,2,3203,4455,2078,9337,9278,1813,56,20484,0,0,0,0,60,154,214
2018-02-01,3,3171,4469,2068,9107,9075,1775,58,20015,0,0,0,0,54,131,185
2018-02-01,4,3180,4536,2092,9153,9019,1762,61,19995,0,0,0,0,51,114,165
2018-02-01,5,3252,4755,2203,9483,9245,1810,67,20605,0,0,0,0,47,88,135
2018-02-01,6,3430,5142,2464,10269,9931,1959,75,22234,0,0,0,0,46,84,130
2018-02-01,7,3656,5471,2836,11513,10992,2216,86,24807,0,26,0,26,49,96,145
2018-02-01,8,3645,5488,3024,12175,11329,2293,83,25880,57,1146,112,1315,51,95,146
2018-02-01,9,3611,5428,2946,11845,11358,2246,76,25525,331,3673,569,4573,41,94,135
2018-02-01,10,3570,5380,2877,11398,11418,2208,68,25092,511,5048,918,6477,36,98,134
2018-02-01,11,3545,5313,2806,11049,11500,2174,63,24786,570,5470,1064,7104,33,92,125
2018-02-01,12,3529,5244,2706,10669,11585,2167,59,24480,581,5487,1125,7193,34,91,125
2018-02-01,13,3511,5218,2642,10482,11732,2183,57,24454,587,5523,1120,7230,32,88,120
2018-02-01,14,3516,5193,2580,10463,11952,2228,55,24698,612,5417,1097,7126,27,99,126
2018-02-01,15,3537,5184,2529,10626,12044,2308,54,25032,593,4959,1012,6564,27,128,155
2018-02-01,16,3580,5239,2488,11029,11981,2403,53,25466,463,3254,714,4431,29,154,183
2018-02-01,17,3659,5368,2547,11546,12146,2548,55,26295,165,986,268,1419,26,135,161
2018-02-01,18,3944,5568,2686,12353,12757,2800,60,27970,5,24,12,41,32,140,172
2018-02-01,19,4060,5559,2735,13029,13202,2839,62,29132,0,0,0,0,42,142,184
2018-02-01,20,3971,5494,2683,12852,12889,2752,62,28555,0,0,0,0,51,137,188
2018-02-01,21,3891,5318,2612,12477,12326,2633,60,27496,0,0,0,0,67,137,204
2018-02-01,22,3740,5040,2467,11859,11689,2448,57,26053,0,0,0,0,98,125,223
2018-02-01,23,3567,4766,2287,10982,10906,2220,54,24162,0,0,0,0,91,103,194
2018-02-01,24,3388,4589,2122,10282,10149,2017,53,22501,0,0,0,0,86,102,188
2018-02-02,1,3262,4460,2005,9517,9529,1864,53,20963,0,0,0,0,82,57,139
2018-02-02,2,3192,4424,1946,9198,9180,1796,55,20229,0,0,0,0,86,56,142
2018-02-02,3,3158,4422,1925,9007,8973,1759,57,19796,0,0,0,0,83,60,143
2018-02-02,4,3162,4505,1945,9001,8918,1749,59,19727,0,0,0,0,77,56,133
2018-02-02,5,3236,4704,2029,9261,9167,1800,64,20292,0,0,0,0,74,49,123
2018-02-02,6,3399,5050,2261,9918,9838,1954,72,21782,0,0,0,0,83,50,133
2018-02-02,7,3624,5370,2609,11043,10882,2202,82,24209,0,32,0,32,93,52,145
2018-02-02,8,3612,5400,2798,11638,11198,2269,79,25184,102,1176,150,1428,96,52,148
2018-02-02,9,3593,5351,2757,11319,11225,2218,72,24834,632,3793,707,5132,95,51,146
2018-02-02,10,3575,5291,2708,10943,11273,2141,66,24423,867,5221,1092,7180,103,68,171
2018-02-02,11,3559,5205,2647,10605,11381,2106,60,24152,915,5673,1226,7814,110,78,188
2018-02-02,12,3540,5114,2569,10404,11471,2092,57,24024,865,5735,1272,7872,106,83,189
2018-02-02,13,3528,5068,2505,10315,11614,2110,55,24094,855,5789,1266,7910,92,80,172
2018-02-02,14,3526,5037,2458,10456,11838,2157,53,24504,852,5759,1242,7853,77,70,147
2018-02-02,15,3545,5016,2410,10672,11948,2229,51,24900,789,5348,1132,7269,74,66,140
2018-02-02,16,3574,5020,2384,10941,11924,2318,51,25234,606,3660,812,5078,69,62,131
2018-02-02,17,3645,5122,2419,11557,12025,2446,52,26080,235,1156,309,1700,58,59,117
2018-02-02,18,3921,5306,2525,12272,12625,2675,58,27630,7,44,24,75,57,60,117
2018-02-02,19,4003,5285,2565,12594,13017,2743,60,28414,0,0,0,0,65,73,138
2018-02-02,20,3904,5205,2506,12319,12667,2657,59,27702,0,0,0,0,72,99,171
2018-02-02,21,3813,5078,2431,11928,12124,2538,58,26648,0,0,0,0,84,101,185
2018-02-02,22,3695,4890,2318,11403,11523,2375,56,25357,0,0,0,0,106,101,207
2018-02-02,23,3569,4667,2184,10726,10813,2171,53,23763,0,0,0,0,156,101,257
2018-02-02,24,3416,4483,2042,10067,10112,1980,51,22210,0,0,0,0,177,101,278
2018-02-03,1,\N,\N,\N,\N,\N,\N,\N,\N,0,0,0,0,217,101,318
2018-02-03,2,\N,\N,\N,\N,\N,\N,\N,\N,0,0,0,0,198,96,294
2018-02-03,3,\N,\N,\N,\N,\N,\N,\N,\N,0,0,0,0,179,96,275
2018-02-03,4,\N,\N,\N,\N,\N,\N,\N,\N,0,0,0,0,170,94,264
2018-02-03,5,\N,\N,\N,\N,\N,\N,\N,\N,0,0,0,0,160,83,243
2018-02-03,6,\N,\N,\N,\N,\N,\N,\N,\N,0,0,0,0,146,76,222
2018-02-03,7,\N,\N,\N,\N,\N,\N,\N,\N,0,26,0,26,128,82,210
2018-02-03,8,\N,\N,\N,\N,\N,\N,\N,\N,122,1263,168,1553,128,74,202
2018-02-03,9,\N,\N,\N,\N,\N,\N,\N,\N,725,4108,792,5625,127,67,194
2018-02-03,10,\N,\N,\N,\N,\N,\N,\N,\N,982,5544,1195,7721,127,84,211
2018-02-03,11,\N,\N,\N,\N,\N,\N,\N,\N,1028,5905,1321,8254,125,105,230
2018-02-03,12,\N,\N,\N,\N,\N,\N,\N,\N,1003,5964,1365,8332,115,112,227
2018-02-03,13,\N,\N,\N,\N,\N,\N,\N,\N,996,6010,1363,8369,105,113,218
2018-02-03,14,\N,\N,\N,\N,\N,\N,\N,\N,1035,5994,1355,8384,93,108,201
2018-02-03,15,\N,\N,\N,\N,\N,\N,\N,\N,1070,5715,1293,8078,82,97,179
2018-02-03,16,\N,\N,\N,\N,\N,\N,\N,\N,920,4106,980,6006,69,92,161
2018-02-03,17,\N,\N,\N,\N,\N,\N,\N,\N,344,1365,394,2103,59,74,133
2018-02-03,18,\N,\N,\N,\N,\N,\N,\N,\N,12,74,41,127,55,76,131
2018-02-03,19,\N,\N,\N,\N,\N,\N,\N,\N,0,0,0,0,59,107,166
2018-02-03,20,\N,\N,\N,\N,\N,\N,\N,\N,0,0,0,0,62,123,185
2018-02-03,21,\N,\N,\N,\N,\N,\N,\N,\N,0,0,0,0,74,124,198
2018-02-03,22,\N,\N,\N,\N,\N,\N,\N,\N,0,0,0,0,99,136,235
2018-02-03,23,\N,\N,\N,\N,\N,\N,\N,\N,0,0,0,0,103,120,223
2018-02-03,24,\N,\N,\N,\N,\N,\N,\N,\N,0,0,0,0,106,131,237
2018-02-04,1,3255,4262,1785,9294,9083,1924,50,20351,0,0,0,0,138,129,267
2018-02-04,2,3180,4217,1729,8945,8716,1831,50,19543,0,0,0,0,137,118,255
2018-02-04,3,3129,4198,1710,8742,8533,1774,52,19101,0,0,0,0,135,109,244
2018-02-04,4,3109,4225,1711,8664,8387,1747,53,18852,0,0,0,0,128,110,238
2018-02-04,5,3134,4290,1752,8689,8391,1752,57,18889,0,0,0,0,111,104,215
2018-02-04,6,3188,4400,1843,8917,8540,1797,62,19316,0,0,0,0,98,99,197
2018-02-04,7,3247,4547,1988,9216,8721,1879,70,19886,0,37,0,37,84,103,187
2018-02-04,8,3210,4654,2143,9353,8574,1884,70,19881,97,1403,164,1664,81,92,173
2018-02-04,9,3252,4651,2257,9454,8679,1881,66,20079,616,4177,723,5516,75,81,156
2018-02-04,10,3273,4649,2301,9396,8792,1843,60,20092,868,5551,1094,7513,70,85,155
2018-02-04,11,3288,4603,2274,9227,8886,1805,56,19974,928,5898,1215,8041,59,96,155
2018-02-04,12,3300,4616,2209,9099,9026,1786,53,19965,877,5893,1249,8019,48,100,148
2018-02-04,13,3315,4572,2157,9021,9208,1803,51,20083,871,5911,1243,8025,40,95,135
2018-02-04,14,3312,4576,2111,9051,9427,1838,50,20365,890,5841,1215,7946,31,86,117
2018-02-04,15,3341,4603,2076,9210,9693,1944,48,20896,849,5414,1110,7373,28,81,109
2018-02-04,16,3393,4699,2075,9580,9893,2055,48,21576,668,3738,806,5212,28,89,117
2018-02-04,17,3450,4883,2135,10331,10094,2200,50,22675,250,1246,323,1819,22,89,111
2018-02-04,18,3743,5105,2277,11113,10935,2365,56,24469,9,64,27,100,21,110,131
2018-02-04,19,3834,5124,2347,11575,11648,2535,59,25817,0,0,0,0,24,159,183
2018-02-04,20,3750,5081,2317,11570,11449,2471,57,25547,0,0,0,0,25,214,239
2018-02-04,21,3673,4940,2260,11550,11048,2370,55,25024,0,0,0,0,31,271,302
2018-02-04,22,3555,4709,2137,10652,10540,2229,53,23474,0,0,0,0,43,333,376
2018-02-04,23,3448,4472,1981,9968,9891,2037,49,21945,0,0,0,0,49,374,423
2018-02-04,24,3288,4323,1846,9326,9312,1873,47,20559,0,0,0,0,55,406,461
2018-02-05,1,3142,4234,1778,9514,9475,1838,48,20875,0,0,0,0,44,319,363
2018-02-05,2,3075,4215,1739,9148,9122,1753,49,20072,0,0,0,0,54,417,471
2018-02-05,3,3047,4223,1733,8949,8939,1714,51,19653,0,0,0,0,66,514,580
2018-02-05,4,3056,4315,1764,8962,8931,1709,53,19655,0,0,0,0,70,573,643
2018-02-05,5,3137,4537,1872,9213,9183,1762,59,20217,0,0,0,0,72,503,575
2018-02-05,6,3326,4932,2126,9954,9938,1924,68,21884,0,0,0,0,80,416,496
2018-02-05,7,3540,5280,2506,11136,11097,2215,75,24523,0,32,0,32,95,354,449
2018-02-05,8,3551,5326,2733,11686,11646,2316,75,25723,111,1375,177,1663,107,301,408
2018-02-05,9,3540,5306,2689,11432,11393,2255,69,25149,686,4219,797,5702,108,230,338
2018-02-05,10,3529,5284,2644,11030,10996,2161,63,24250,920,5550,1185,7655,107,167,274
2018-02-05,11,3530,5239,2595,10743,10709,2112,59,23623,964,5887,1310,8161,100,128,228
2018-02-05,12,3526,5192,2531,10563,10629,2095,56,23343,896,5910,1334,8140,83,124,207
2018-02-05,13,3540,5181,2488,10464,10609,2154,54,23281,878,5956,1329,8163,73,129,202
2018-02-05,14,3544,5153,2435,10572,10727,2194,53,23546,880,5939,1308,8127,62,209,271
2018-02-05,15,3565,5143,2392,10697,10853,2233,51,23834,840,5600,1197,7637,54,348,402
2018-02-05,16,3610,5187,2369,10965,11058,2355,51,24429,654,4065,875,5594,59,549,608
2018-02-05,17,3697,5309,2414,11600,11596,2487,53,25736,251,1425,351,2027,64,856,920
2018-02-05,18,3974,5513,2557,12312,12307,2745,59,27423,9,78,20,107,74,1218,1292
2018-02-05,19,4083,5504,2646,12822,12818,2775,61,28476,0,0,0,0,104,1549,1653
2018-02-05,20,3997,5414,2608,12588,12716,2710,59,28073,0,0,0,0,141,1595,1736
2018-02-05,21,3860,5219,2523,12138,12278,2578,57,27051,0,0,0,0,176,1603,1779
2018-02-05,22,3685,4919,2376,11513,11591,2391,54,25549,0,0,0,0,224,1583,1807
2018-02-05,23,3518,4640,2197,10639,10658,2154,50,23501,0,0,0,0,261,1539,1800
2018-02-05,24,3332,4467,2041,9897,9885,1957,48,21787,0,0,0,0,290,1471,1761
2018-02-06,1,3202,4423,1926,9401,9487,1834,48,20770,0,0,0,0,341,1583,1924
2018-02-06,2,3134,4392,1880,9040,9121,1769,49,19979,0,0,0,0,359,1497,1856
2018-02-06,3,3106,4394,1862,8841,8922,1730,51,19544,0,0,0,0,362,1354,1716
2018-02-06,4,3116,4479,1889,8840,8867,1720,54,19480,0,0,0,0,375,1210,1585
2018-02-06,5,3199,4708,1995,9092,9144,1770,59,20066,0,0,0,0,383,923,1306
2018-02-06,6,3371,5108,2258,9777,9868,1930,68,21643,0,0,0,0,382,625,1007
2018-02-06,7,3590,5429,2655,10948,11002,2203,77,24230,0,42,0,42,370,404,774
2018-02-06,8,3595,5448,2879,11551,11320,2276,75,25223,128,1502,189,1819,364,238,602
2018-02-06,9,3562,5390,2798,11306,11254,2218,69,24847,757,4480,849,6086,352,153,505
2018-02-06,10,3529,5346,2720,10895,11181,2132,63,24271,994,5841,1242,8077,365,164,529
2018-02-06,11,3519,5292,2639,10545,11192,2069,58,23864,1050,6139,1356,8545,368,196,564
2018-02-06,12,3508,5235,2551,10327,11272,2038,55,23692,1003,6132,1368,8503,355,225,580
2018-02-06,13,3504,5214,2485,10210,11383,2059,53,23705,996,6160,1370,8526,327,246,573
2018-02-06,14,3511,5183,2422,10345,11607,2089,52,24093,1028,6163,1372,8563,285,234,519
2018-02-06,15,3535,5173,2356,10541,11843,2147,51,24581,1035,5887,1325,8247,244,209,453
2018-02-06,16,3541,5223,2327,10991,11962,2219,51,25223,895,4487,1043,6425,217,191,408
2018-02-06,17,3614,5337,2368,11730,12140,2340,52,26262,353,1644,433,2430,192,164,356
2018-02-06,18,3896,5553,2521,12362,12702,2572,58,27694,16,104,32,152,176,147,323
2018-02-06,19,4026,5552,2625,12853,13110,2727,60,28750,0,0,0,0,166,139,305
2018-02-06,20,3960,5475,2596,12612,12821,2677,59,28169,0,0,0,0,140,147,287
2018-02-06,21,3879,5286,2526,12200,12351,2554,57,27162,0,0,0,0,124,157,281
2018-02-06,22,3719,4995,2379,11521,11676,2367,55,25619,0,0,0,0,119,149,268
2018-02-06,23,3534,4719,2195,10591,10866,2134,53,23645,0,0,0,0,139,158,297
2018-02-06,24,3355,4545,2041,9788,10096,1940,52,21876,0,0,0,0,143,164,307
2018-02-07,1,3235,4453,1965,9452,9509,1826,54,20841,0,0,0,0,125,260,385
2018-02-07,2,3173,4426,1919,9083,9158,1764,55,20060,0,0,0,0,119,232,351
2018-02-07,3,3149,4440,1902,8887,8978,1722,58,19645,0,0,0,0,116,221,337
2018-02-07,4,3161,4513,1926,8898,8918,1715,61,19593,0,0,0,0,122,215,337
2018-02-07,5,3246,4738,2028,9142,9196,1768,67,20173,0,0,0,0,124,227,351
2018-02-07,6,3440,5127,2288,9830,9881,1942,76,21729,0,0,0,0,127,234,361
2018-02-07,7,3667,5445,2675,10974,10903,2215,86,24178,0,51,1,52,125,229,354
2018-02-07,8,3647,5450,2854,11542,11143,2288,84,25057,158,1591,198,1947,119,212,331
2018-02-07,9,3597,5377,2777,11250,10958,2203,75,24487,865,4663,876,6404,116,216,332
2018-02-07,10,3543,5308,2690,10748,10863,2108,67,23786,1099,6069,1277,8445,103,240,343
2018-02-07,11,3504,5224,2606,10386,10921,2071,61,23439,1115,6234,1383,8732,95,266,361
2018-02-07,12,3469,5137,2506,10151,11010,2048,57,23266,1052,6211,1392,8655,79,269,348
2018-02-07,13,3441,5105,2442,10049,11104,2067,54,23275,1046,6236,1399,8681,66,263,329
2018-02-07,14,3426,5077,2397,10183,11330,2129,53,23695,1085,6256,1407,8748,58,223,281
2018-02-07,15,3429,5071,2359,10410,11523,2219,52,24204,1101,6005,1352,8458,57,189,246
2018-02-07,16,3469,5106,2338,10842,11679,2307,52,24880,990,4591,1069,6650,49,163,212
2018-02-07,17,3540,5226,2373,11471,11862,2426,54,25813,433,1718,461,2612,47,141,188
2018-02-07,18,3829,5450,2495,12210,12466,2659,59,27394,18,99,32,149,54,130,184
2018-02-07,19,3984,5446,2570,12728,12874,2799,61,28462,0,0,0,0,61,119,180
2018-02-07,20,3955,5382,2539,12471,12585,2698,61,27815,0,0,0,0,63,115,178
2018-02-07,21,3886,5214,2480,12045,12192,2560,60,26857,0,0,0,0,61,109,170
2018-02-07,22,3731,4934,2347,11474,11546,2381,58,25459,0,0,0,0,62,107,169
2018-02-07,23,3547,4660,2170,10625,10758,2148,56,23587,0,0,0,0,56,104,160
2018-02-07,24,3375,4486,2014,9889,10052,1954,54,21949,0,0,0,0,54,103,157
2018-02-08,1,3246,4364,1935,9346,9523,1869,56,20795,0,0,0,0,59,124,183
2018-02-08,2,3181,4329,1884,8995,9155,1809,58,20017,0,0,0,0,52,123,175
2018-02-08,3,3154,4337,1862,8814,8950,1764,60,19588,0,0,0,0,48,121,169
2018-02-08,4,3165,4414,1881,8793,8901,1758,63,19514,0,0,0,0,44,125,169
2018-02-08,5,3249,4631,1974,9021,9171,1812,69,20073,0,0,0,0,47,130,177
2018-02-08,6,3438,5023,2228,9712,9883,1965,78,21638,0,0,0,0,49,131,180
2018-02-08,7,3657,5340,2595,10701,10731,2217,85,23734,1,63,1,65,49,129,178
2018-02-08,8,3634,5342,2775,11287,10892,2293,83,24555,165,1633,208,2006,49,134,183
2018-02-08,9,3591,5280,2708,10994,10706,2227,75,24003,882,4636,886,6404,48,135,183
2018-02-08,10,3542,5226,2642,10532,10731,2150,68,23481,1119,6041,1290,8450,56,158,214
2018-02-08,11,3504,5156,2564,10267,10890,2130,63,23350,1134,6240,1401,8775,53,179,232
2018-02-08,12,3483,5079,2498,10144,11163,2130,59,23496,1078,6223,1403,8704,43,181,224
2018-02-08,13,3474,5053,2467,10113,11406,2148,57,23724,1067,6253,1407,8727,35,178,213
2018-02-08,14,3481,5039,2429,10262,11695,2221,55,24233,1106,6269,1431,8806,29,150,179
2018-02-08,15,3494,5036,2387,10492,11873,2299,54,24717,1119,5991,1375,8485,27,128,155
2018-02-08,16,3519,5069,2364,10843,11981,2396,53,25273,1030,4640,1091,6761,24,110,134
2018-02-08,17,3607,5157,2395,11498,12150,2511,55,26214,472,1770,483,2725,22,94,116
2018-02-08,18,3875,5362,2503,12090,12435,2724,60,27309,19,99,32,150,35,93,128
2018-02-08,19,3998,5348,2563,12686,12980,2856,62,28585,0,0,0,0,50,148,198
2018-02-08,20,3916,5278,2528,12399,12700,2748,62,27909,0,0,0,0,60,190,250
2018-02-08,21,3826,5114,2471,11948,12228,2615,60,26851,0,0,0,0,77,202,279
2018-02-08,22,3679,4849,2345,11337,11566,2429,57,25390,0,0,0,0,103,205,308
2018-02-08,23,3506,4583,2174,10582,10709,2192,55,23537,0,0,0,0,103,194,297
2018-02-08,24,3335,4407,2025,9870,9933,1989,53,21845,0,0,0,0,110,195,305
2018-02-09,1,3211,4367,1980,9272,9542,1866,51,20731,0,0,0,0,105,332,437
2018-02-09,2,3143,4327,1930,8948,9181,1791,52,19972,0,0,0,0,97,379,476
2018-02-09,3,3112,4323,1908,8764,8956,1758,54,19532,0,0,0,0,93,418,511
2018-02-09,4,3120,4396,1927,8749,8926,1749,56,19480,0,0,0,0,95,445,540
2018-02-09,5,3194,4603,2018,8997,9179,1804,62,20042,0,0,0,0,96,393,489
2018-02-09,6,3366,4965,2256,9630,9831,1940,70,21471,0,0,0,0,91,353,444
2018-02-09,7,3568,5268,2614,10782,10893,2179,80,23934,0,73,1,74,95,330,425
2018-02-09,8,3561,5316,2829,11371,11105,2244,77,24797,182,1692,232,2106,90,296,386
2018-02-09,9,3543,5288,2782,11097,11033,2191,70,24391,925,4642,942,6509,91,265,356
2018-02-09,10,3526,5256,2718,10811,11049,2118,63,24041,1137,6005,1316,8458,94,248,342
2018-02-09,11,3517,5210,2654,10572,11105,2078,58,23813,1150,6202,1411,8763,98,266,364
2018-02-09,12,3496,5146,2563,10385,11160,2066,55,23666,1057,6142,1406,8605,92,323,415
2018-02-09,13,3506,5120,2494,10340,11295,2079,54,23768,1057,6167,1401,8625,81,417,498
2018-02-09,14,3515,5096,2435,10449,11567,2117,52,24185,1084,6164,1424,8672,69,740,809
2018-02-09,15,3535,5080,2375,10553,11740,2185,51,24529,1063,5864,1370,8297,62,1170,1232
2018-02-09,16,3570,5092,2339,10820,11819,2266,51,24955,939,4569,1103,6611,72,1611,1683
2018-02-09,17,3646,5155,2386,11248,11907,2383,51,25589,416,1772,498,2686,71,1873,1944
2018-02-09,18,3879,5352,2512,11903,12407,2571,56,26937,19,104,33,156,92,2070,2162
2018-02-09,19,3979,5328,2602,12432,12676,2692,58,27858,0,0,0,0,124,2190,2314
2018-02-09,20,3885,5227,2550,12070,12327,2622,57,27076,0,0,0,0,185,2251,2436
2018-02-09,21,3771,5079,2481,11606,11904,2498,56,26064,0,0,0,0,240,2282,2522
2018-02-09,22,3629,4885,2362,11088,11400,2349,54,24891,0,0,0,0,283,2264,2547
2018-02-09,23,3508,4659,2230,10387,10724,2163,51,23325,0,0,0,0,286,2241,2527
2018-02-09,24,3356,4493,2104,9680,10013,1982,49,21724,0,0,0,0,274,2279,2553
2018-02-10,1,3244,4422,2038,9257,9561,1879,48,20745,0,0,0,0,326,2413,2739
2018-02-10,2,3166,4380,1994,8882,9176,1791,48,19896,0,0,0,0,304,2491,2795
2018-02-10,3,3123,4372,1982,8686,8900,1746,50,19382,0,0,0,0,305,2549,2854
2018-02-10,4,3111,4406,2000,8598,8774,1725,51,19149,0,0,0,0,314,2610,2924
2018-02-10,5,3140,4503,2066,8676,8834,1734,56,19300,0,0,0,0,325,2607,2932
2018-02-10,6,3213,4668,2191,8950,9087,1788,62,19887,0,0,0,0,319,2574,2893
2018-02-10,7,3278,4832,2391,9457,9402,1871,70,20800,0,66,1,67,333,2571,2904
2018-02-10,8,3269,4938,2552,9772,9453,1904,69,21198,170,1651,223,2044,345,2554,2899
2018-02-10,9,3320,4976,2660,9832,9493,1937,64,21326,889,4449,885,6223,344,2533,2877
2018-02-10,10,3368,4976,2657,9677,9554,1927,59,21218,1096,5700,1248,8044,421,2549,2970
2018-02-10,11,3384,4958,2600,9418,9535,1883,55,20892,1113,6001,1372,8486,459,2743,3202
2018-02-10,12,3379,4931,2505,9187,9445,1823,53,20508,1013,5906,1350,8269,483,2917,3400
2018-02-10,13,3401,4900,2400,9095,9441,1795,51,20383,1000,5872,1337,8209,538,3054,3592
2018-02-10,14,3395,4871,2305,9063,9447,1805,50,20365,1016,5924,1343,8283,601,3020,3621
2018-02-10,15,3430,4873,2233,9146,9516,1838,50,20549,934,5556,1232,7722,719,2794,3513
2018-02-10,16,3461,4933,2206,9343,9533,1929,49,20854,792,4153,940,5885,799,2600,3399
2018-02-10,17,3545,5067,2269,9632,9814,2076,52,21573,363,1629,423,2415,864,2223,3087
2018-02-10,18,3815,5314,2407,10349,10437,2333,56,23176,17,85,30,132,932,1721,2653
2018-02-10,19,3929,5315,2520,11250,11161,2549,59,25019,0,0,0,0,955,1310,2265
2018-02-10,20,3838,5240,2488,11216,11124,2504,58,24902,0,0,0,0,952,1028,1980
2018-02-10,21,3765,5123,2440,10946,10795,2393,56,24191,0,0,0,0,929,803,1732
2018-02-10,22,3656,4936,2340,10522,10371,2270,54,23218,0,0,0,0,896,792,1688
2018-02-10,23,3533,4723,2218,10018,9911,2105,51,22085,0,0,0,0,840,734,1574
2018-02-10,24,3401,4562,2110,9470,9451,1942,49,20912,0,0,0,0,756,705,1461
2018-02-11,1,3290,4470,2075,9330,9087,1850,51,20318,0,0,0,0,756,637,1393
2018-02-11,2,3225,4437,2041,9001,8754,1758,53,19566,0,0,0,0,672,588,1260
2018-02-11,3,3186,4432,2037,8789,8535,1707,56,19087,0,0,0,0,504,557,1061
2018-02-11,4,3179,4457,2063,8682,8429,1694,58,18863,0,0,0,0,372,518,890
2018-02-11,5,3210,4522,2127,8741,8463,1699,63,18966,0,0,0,0,262,482,744
2018-02-11,6,3288,4643,2240,8953,8654,1758,69,19434,0,0,0,0,165,443,608
2018-02-11,7,3322,4774,2400,9380,8823,1854,78,20135,1,78,2,81,107,405,512
2018-02-11,8,3301,4855,2556,9657,8842,1877,80,20456,168,1814,238,2220,111,376,487
2018-02-11,9,3345,4829,2667,9622,8860,1865,75,20422,914,4731,942,6587,111,389,500
2018-02-11,10,3391,4783,2677,9289,8868,1818,64,20039,1098,5991,1304,8393,103,384,487
2018-02-11,11,3381,4694,2610,9044,8870,1755,61,19730,1105,6218,1404,8727,123,317,440
2018-02-11,12,3315,4661,2506,8784,8832,1722,57,19395,1011,6137,1403,8551,129,253,382
2018-02-11,13,3276,4594,2432,8560,8918,1729,54,19261,1000,6127,1381,8508,153,183,336
2018-02-11,14,3260,4589,2362,8585,8944,1772,53,19354,1012,6175,1394,8581,270,142,412
2018-02-11,15,3262,4618,2298,8708,9052,1844,52,19656,916,5863,1311,8090,399,139,538
2018-02-11,16,3276,4715,2294,9094,9269,1964,53,20380,771,4505,1039,6315,578,212,790
2018-02-11,17,3332,4878,2372,9676,9655,2084,56,21471,352,1821,490,2663,648,353,1001
2018-02-11,18,3599,5141,2546,10366,10226,2334,62,22988,17,92,31,140,696,547,1243
2018-02-11,19,3798,5194,2658,11387,10977,2529,63,24956,0,0,0,0,746,850,1596
2018-02-11,20,3797,5155,2643,11442,11017,2505,64,25028,0,0,0,0,688,992,1680
2018-02-11,21,3779,5019,2577,11271,10816,2412,63,24562,0,0,0,0,600,1156,1756
2018-02-11,22,3669,4793,2438,10835,10422,2263,61,23581,0,0,0,0,483,1343,1826
2018-02-11,23,3533,4564,2275,10081,9811,2065,58,22015,0,0,0,0,454,1449,1903
2018-02-11,24,3374,4430,2145,9413,9363,1896,57,20729,0,0,0,0,450,1600,2050
2018-02-12,1,3256,4422,2143,8705,8518,1848,56,19127,0,0,0,0,452,2041,2493
2018-02-12,2,3196,4417,2127,8463,8213,1786,57,18519,0,0,0,0,455,2130,2585
2018-02-12,3,3180,4436,2134,8390,8135,1748,60,18333,0,0,0,0,436,2183,2619
2018-02-12,4,3196,4533,2183,8482,8196,1737,62,18477,0,0,0,0,398,2134,2532
2018-02-12,5,3281,4766,2317,8902,8662,1785,68,19417,0,0,0,0,369,1973,2342
2018-02-12,6,3469,5176,2599,9756,9627,1941,75,21399,0,0,0,0,303,1794,2097
2018-02-12,7,3670,5508,3012,11373,10775,2200,84,24432,0,76,2,78,267,1619,1886
2018-02-12,8,3681,5536,3236,12035,11723,2328,86,26172,154,1590,216,1960,223,1629,1852
2018-02-12,9,3644,5500,3168,11735,11797,2334,79,25945,794,4025,832,5651,190,1683,1873
2018-02-12,10,3609,5454,3078,11277,11720,2280,73,25350,882,5154,1143,7179,188,1667,1855
2018-02-12,11,3589,5399,3003,10831,11477,2222,69,24599,851,5443,1215,7509,187,1678,1865
2018-02-12,12,3565,5341,2890,10483,11375,2172,65,24095,769,5420,1127,7316,195,1643,1838
2018-02-12,13,3532,5327,2824,10298,11280,2168,63,23809,749,5381,1079,7209,216,1613,1829
2018-02-12,14,3510,5301,2762,10210,11275,2176,60,23721,782,5250,1056,7088,222,1542,1764
2018-02-12,15,3501,5298,2698,10127,11179,2207,59,23572,759,4805,986,6550,239,1497,1736
2018-02-12,16,3530,5338,2680,10248,11007,2297,59,23611,724,3496,740,4960,269,1435,1704
2018-02-12,17,3645,5454,2731,10664,11189,2434,61,24348,398,1386,340,2124,235,1242,1477
2018-02-12,18,3918,5699,2894,11386,11985,2704,67,26142,22,112,24,158,224,1078,1302
2018-02-12,19,4100,5685,3042,12498,12733,2812,69,28112,0,0,0,0,232,993,1225
2018-02-12,20,4084,5577,3016,12558,12575,2753,70,27956,0,0,0,0,299,911,1210
2018-02-12,21,3991,5378,2930,12196,12162,2642,70,27070,0,0,0,0,369,824,1193
2018-02-12,22,3828,5071,2757,11276,11517,2453,67,25313,0,0,0,0,411,744,1155
2018-02-12,23,3629,4785,2554,10392,10466,2207,65,23130,0,0,0,0,454,624,1078
2018-02-12,24,3452,4621,2395,9617,9716,2002,64,21399,0,0,0,0,503,545,1048
2018-02-13,1,3371,4572,2333,9546,9584,1905,63,21098,0,0,0,0,668,512,1180
2018-02-13,2,3311,4547,2311,9215,9250,1835,64,20364,0,0,0,0,627,439,1066
2018-02-13,3,3288,4554,2320,9060,9071,1789,66,19986,0,0,0,0,588,403,991
2018-02-13,4,3303,4648,2373,9100,9045,1787,69,20001,0,0,0,0,549,384,933
2018-02-13,5,3388,4894,2527,9435,9352,1838,77,20701,0,0,0,0,514,328,842
2018-02-13,6,3579,5295,2813,10230,10067,2009,83,22389,0,0,0,0,483,265,748
2018-02-13,7,3778,5602,3226,11584,11157,2291,91,25123,0,70,1,71,452,230,682
2018-02-13,8,3776,5606,3403,12051,11733,2386,90,26260,173,1331,199,1703,365,198,563
2018-02-13,9,3738,5529,3292,11644,11583,2333,83,25643,887,3570,770,5227,308,203,511
2018-02-13,10,3689,5456,3150,11110,11376,2226,74,24786,1067,4669,1108,6844,251,256,507
2018-02-13,11,3650,5375,3009,10689,11217,2157,68,24131,1081,4937,1214,7232,175,281,456
2018-02-13,12,3609,5291,2859,10318,11070,2101,63,23551,1032,4802,1193,7027,119,305,424
2018-02-13,13,3578,5261,2761,10114,10925,2089,58,23186,1017,4638,1171,6826,80,312,392
2018-02-13,14,3552,5230,2679,10130,10851,2097,56,23134,1031,4576,1143,6750,56,282,338
2018-02-13,15,3542,5219,2609,10191,10732,2136,54,23113,1018,4308,1055,6381,41,258,299
2018-02-13,16,3571,5258,2579,10298,10661,2238,54,23251,920,3238,789,4947,33,255,288
2018-02-13,17,3688,5357,2641,10761,10979,2390,56,24186,429,1264,360,2053,16,214,230
2018-02-13,18,3963,5619,2809,11698,11853,2649,62,26262,24,99,25,148,10,220,230
2018-02-13,19,4158,5622,2961,12750,12700,2767,65,28282,0,0,0,0,10,192,202
2018-02-13,20,4145,5538,2947,12757,12641,2736,67,28201,0,0,0,0,14,184,198
2018-02-13,21,4062,5349,2882,12396,12333,2645,68,27441,0,0,0,0,32,194,226
2018-02-13,22,3898,5056,2720,11750,11749,2460,66,26025,0,0,0,0,49,199,248
2018-02-13,23,3684,4773,2523,10834,10930,2224,64,24052,0,0,0,0,61,193,254
2018-02-13,24,3511,4601,2357,10008,10181,2025,62,22276,0,0,0,0,81,196,277
2018-02-14,1,3416,4503,2256,9471,9601,1892,63,21027,0,0,0,0,105,146,251
2018-02-14,2,3353,4474,2216,9138,9269,1824,64,20295,0,0,0,0,110,123,233
2018-02-14,3,3329,4484,2210,8943,9106,1787,66,19902,0,0,0,0,119,111,230
2018-02-14,4,3340,4569,2244,8945,9092,1781,68,19886,0,0,0,0,126,96,222
2018-02-14,5,3422,4783,2358,9254,9382,1833,75,20544,0,0,0,0,126,78,204
2018-02-14,6,3598,5177,2619,10003,10121,1991,81,22196,0,0,0,0,121,67,188
2018-02-14,7,3787,5479,2996,11346,11179,2267,89,24881,1,64,2,67,118,59,177
2018-02-14,8,3767,5482,3171,11946,11733,2361,87,26127,193,1346,240,1779,122,54,176
2018-02-14,9,3707,5422,3088,11849,11583,2311,81,25824,806,3459,883,5148,140,48,188
2018-02-14,10,3643,5348,2986,11346,11376,2197,74,24993,946,4569,1235,6750,151,59,210
2018-02-14,11,3599,5264,2887,10774,11206,2124,68,24172,944,4852,1342,7138,158,69,227
2018-02-14,12,3557,5182,2788,10539,11047,2077,63,23726,897,4786,1331,7014,179,94,273
2018-02-14,13,3533,5161,2731,10471,10924,2070,60,23525,850,4797,1366,7013,210,158,368
2018-02-14,14,3520,5145,2676,10338,10867,2097,58,23360,854,4701,1330,6885,244,331,575
2018-02-14,15,3516,5144,2638,10359,10891,2134,57,23441,788,4348,1217,6353,312,615,927
2018-02-14,16,3557,5189,2635,10630,10960,2215,57,23862,692,3217,931,4840,395,990,1385
2018-02-14,17,3665,5282,2682,11287,11258,2356,58,24959,358,1326,434,2118,432,1134,1566
2018-02-14,18,3939,5542,2834,12308,12137,2607,63,27115,25,96,29,150,474,1081,1555
2018-02-14,19,4142,5528,2965,13194,12766,2728,66,28754,0,0,0,0,516,1068,1584
2018-02-14,20,4130,5437,2920,12998,12628,2692,66,28384,0,0,0,0,495,1186,1681
2018-02-14,21,4047,5262,2842,12629,12312,2600,66,27607,0,0,0,0,491,1316,1807
2018-02-14,22,3880,4978,2683,11994,11701,2431,64,26190,0,0,0,0,464,1440,1904
2018-02-14,23,3668,4701,2490,11090,10866,2204,62,24222,0,0,0,0,320,1524,1844
2018-02-14,24,3494,4530,2328,10283,10149,2003,61,22496,0,0,0,0,266,1587,1853
2018-02-15,1,3313,4491,2237,9678,9732,1885,61,21356,0,0,0,0,240,2024,2264
2018-02-15,2,3252,4460,2198,9344,9380,1814,62,20600,0,0,0,0,341,2050,2391
2018-02-15,3,3226,4466,2194,9090,9190,1772,64,20116,0,0,0,0,433,2027,2460
2018-02-15,4,3242,4544,2231,9066,9188,1759,67,20080,0,0,0,0,528,1994,2522
2018-02-15,5,3326,4767,2355,9386,9466,1812,73,20737,0,0,0,0,597,1815,2412
2018-02-15,6,3517,5161,2633,10127,10213,1962,81,22383,0,0,0,0,647,1528,2175
2018-02-15,7,3711,5460,3031,11478,11249,2226,90,25043,1,84,4,89,663,1298,1961
2018-02-15,8,3716,5487,3209,12071,11494,2311,87,25963,196,1561,262,2019,633,696,1329
2018-02-15,9,3676,5441,3123,11580,11341,2265,80,25266,856,3992,904,5752,623,326,949
2018-02-15,10,3630,5403,3014,11025,11157,2169,73,24424,1013,5219,1212,7444,616,199,815
2018-02-15,11,3601,5367,2901,10574,10996,2108,68,23746,1040,5461,1339,7840,591,268,859
2018-02-15,12,3570,5318,2785,10253,10939,2075,64,23331,1054,5568,1384,8006,561,419,980
2018-02-15,13,3539,5314,2711,10024,10903,2051,61,23039,1045,5564,1412,8021,530,524,1054
2018-02-15,14,3519,5298,2651,10079,10974,2065,59,23177,1068,5564,1443,8075,472,531,1003
2018-02-15,15,3506,5303,2588,10318,10976,2115,58,23467,1090,5279,1396,7765,426,542,968
2018-02-15,16,3522,5345,2563,10625,11066,2208,58,23957,1022,4192,1160,6374,376,534,910
2018-02-15,17,3624,5424,2624,11238,11307,2354,59,24958,513,1795,569,2877,284,439,723
2018-02-15,18,3884,5661,2772,12055,12089,2584,63,26791,34,117,40,191,239,349,588
2018-02-15,19,4076,5663,2919,12895,12746,2701,66,28408,0,0,0,0,215,296,511
2018-02-15,20,4065,5557,2893,12825,12589,2674,69,28157,0,0,0,0,164,290,454
2018-02-15,21,3990,5361,2825,12508,12336,2576,70,27490,0,0,0,0,138,289,427
2018-02-15,22,3837,5077,2677,11916,11769,2411,67,26163,0,0,0,0,138,273,411
2018-02-15,23,3639,4810,2494,11059,10902,2183,65,24209,0,0,0,0,119,269,388
2018-02-15,24,3470,4650,2329,10308,10247,1988,63,22606,0,0,0,0,100,255,355
2018-02-16,1,3394,4603,2222,9541,9378,1884,60,20863,0,0,0,0,75,307,382
2018-02-16,2,3335,4582,2184,9216,9017,1815,62,20110,0,0,0,0,64,264,328
2018-02-16,3,3305,4592,2179,8988,8832,1780,65,19665,0,0,0,0,62,226,288
2018-02-16,4,3319,4673,2209,8995,8799,1763,68,19625,0,0,0,0,67,195,262
2018-02-16,5,3406,4893,2319,9284,9092,1812,74,20262,0,0,0,0,66,181,247
2018-02-16,6,3581,5270,2574,10020,9811,1954,83,21868,0,0,0,0,65,166,231
2018-02-16,7,3772,5550,2956,11183,10881,2204,92,24360,1,89,3,93,70,162,232
2018-02-16,8,3770,5569,3134,11677,11243,2256,90,25266,218,1652,292,2162,79,153,232
2018-02-16,9,3740,5510,3055,11384,11166,2201,80,24831,903,4041,1016,5960,88,147,235
2018-02-16,10,3700,5431,2948,10906,11056,2111,71,24144,1080,5140,1393,7613,115,153,268
2018-02-16,11,3661,5335,2836,10562,10964,2056,65,23647,1091,5497,1487,8075,118,142,260
2018-02-16,12,3607,5235,2714,10235,10951,2029,60,23275,1079,5493,1468,8040,113,124,237
2018-02-16,13,3554,5191,2626,10009,10872,2040,57,22978,1059,5512,1469,8040,108,107,215
2018-02-16,14,3514,5157,2552,10057,10950,2089,54,23150,1088,5506,1486,8080,99,95,194
2018-02-16,15,3490,5138,2481,10284,11056,2164,53,23557,1099,5204,1421,7724,102,83,185
2018-02-16,16,3496,5148,2461,10613,11145,2257,53,24068,1030,4162,1184,6376,92,78,170
2018-02-16,17,3578,5210,2507,11042,11430,2377,54,24903,532,1835,609,2976,69,73,142
2018-02-16,18,3823,5461,2636,11461,11937,2574,60,26032,38,144,50,232,56,76,132
2018-02-16,19,4010,5451,2759,12259,12366,2671,63,27359,0,0,0,0,56,88,144
2018-02-16,20,3996,5340,2703,12196,12118,2609,65,26988,0,0,0,0,58,103,161
2018-02-16,21,3941,5203,2635,11862,11763,2513,67,26205,0,0,0,0,60,107,167
2018-02-16,22,3830,4997,2514,11313,11272,2369,66,25020,0,0,0,0,75,97,172
2018-02-16,23,3670,4769,2374,10635,10584,2174,65,23458,0,0,0,0,100,73,173
2018-02-16,24,3520,4597,2224,9917,10004,1996,63,21980,0,0,0,0,122,61,183
2018-02-17,1,3386,4502,2086,9646,9472,1952,63,21133,0,0,0,0,89,71,160
2018-02-17,2,3316,4455,2033,9254,9123,1866,64,20307,0,0,0,0,67,70,137
2018-02-17,3,3276,4446,2015,9019,8897,1819,67,19802,0,0,0,0,60,73,133
2018-02-17,4,3275,4478,2029,8944,8825,1800,70,19639,0,0,0,0,59,69,128
2018-02-17,5,3317,4573,2077,9060,8881,1820,76,19837,0,0,0,0,51,66,117
2018-02-17,6,3395,4737,2198,9361,9221,1873,81,20536,0,0,0,0,46,68,114
2018-02-17,7,3433,4867,2365,9860,9532,1994,89,21475,1,122,5,128,51,72,123
2018-02-17,8,3391,4977,2513,10202,9560,2026,88,21876,257,2049,338,2644,56,68,124
2018-02-17,9,3414,5027,2604,10227,9640,2023,80,21970,971,4891,1073,6935,60,71,131
2018-02-17,10,3417,5006,2598,9857,9603,1958,70,21488,1136,6075,1433,8644,58,79,137
2018-02-17,11,3396,4942,2536,9497,9530,1867,61,20955,1129,6344,1524,8997,51,82,133
2018-02-17,12,3349,4854,2440,9335,9362,1817,57,20571,1113,6279,1495,8887,53,83,136
2018-02-17,13,3295,4784,2347,9186,9292,1800,54,20332,1094,6278,1500,8872,64,74,138
2018-02-17,14,3251,4748,2277,9154,9360,1840,53,20407,1122,6274,1519,8915,72,60,132
2018-02-17,15,3253,4748,2223,9213,9539,1932,51,20735,1134,5979,1488,8601,77,56,133
2018-02-17,16,3288,4800,2234,9385,9809,2031,52,21277,1057,4900,1260,7217,89,70,159
2018-02-17,17,3395,4903,2284,9808,10117,2183,55,22163,560,2219,644,3423,105,124,229
2018-02-17,18,3669,5193,2422,10617,10816,2442,59,23934,42,177,55,274,137,229,366
2018-02-17,19,3843,5232,2524,11456,11501,2565,63,25585,0,0,0,0,188,379,567
2018-02-17,20,3814,5155,2474,11485,11403,2506,62,25456,0,0,0,0,272,530,802
2018-02-17,21,3769,5021,2403,11194,11107,2417,61,24779,0,0,0,0,352,692,1044
2018-02-17,22,3670,4837,2302,10690,10674,2296,60,23720,0,0,0,0,427,880,1307
2018-02-17,23,3561,4603,2184,10142,10202,2132,59,22535,0,0,0,0,552,992,1544
2018-02-17,24,3408,4425,2073,9538,9595,1968,58,21159,0,0,0,0,687,1134,1821
2018-02-18,1,3266,4344,2117,9324,9272,1857,59,20512,0,0,0,0,905,1274,2179
2018-02-18,2,3186,4285,2076,8978,8976,1776,59,19789,0,0,0,0,906,1377,2283
2018-02-18,3,3133,4259,2060,8760,8735,1730,61,19286,0,0,0,0,906,1467,2373
2018-02-18,4,3112,4277,2066,8655,8596,1708,64,19023,0,0,0,0,912,1549,2461
2018-02-18,5,3146,4346,2115,8667,8602,1716,69,19054,0,0,0,0,877,1598,2475
2018-02-18,6,3193,4460,2210,8960,8785,1758,72,19575,0,0,0,0,846,1604,2450
2018-02-18,7,3217,4569,2370,9431,9039,1834,78,20382,2,111,4,117,834,1638,2472
2018-02-18,8,3178,4680,2536,9632,9055,1875,78,20640,238,1964,339,2541,838,1698,2536
2018-02-18,9,3217,4714,2669,9608,9107,1893,72,20680,887,4778,1007,6672,909,1849,2758
2018-02-18,10,3253,4733,2720,9472,9094,1857,67,20490,1032,5879,1369,8280,917,2030,2947
2018-02-18,11,3265,4715,2719,9471,9067,1824,62,20424,1024,6166,1460,8650,922,2204,3126
2018-02-18,12,3309,4758,2672,9528,9025,1807,58,20418,1020,6023,1394,8437,934,2362,3296
2018-02-18,13,3333,4741,2638,9507,8990,1813,56,20366,970,6005,1344,8319,950,2475,3425
2018-02-18,14,3364,4770,2602,9428,9037,1817,54,20336,985,6017,1289,8291,960,2542,3502
2018-02-18,15,3408,4821,2565,9405,9232,1878,53,20568,967,5711,1232,7910,1010,2573,3583
2018-02-18,16,3454,4937,2575,9497,9487,1970,55,21009,919,4527,962,6408,1086,2560,3646
2018-02-18,17,3544,5067,2622,10040,9935,2138,57,22170,511,2048,515,3074,1086,2430,3516
2018-02-18,18,3828,5345,2760,11062,11035,2403,62,24562,46,155,49,250,1073,2287,3360
2018-02-18,19,3929,5355,2872,12033,11468,2560,64,26125,0,0,0,0,1055,2287,3342
2018-02-18,20,3866,5262,2835,11938,11383,2548,63,25932,0,0,0,0,993,2419,3412
2018-02-18,21,3806,5118,2750,11575,11091,2459,62,25187,0,0,0,0,933,2530,3463
2018-02-18,22,3674,4881,2601,11137,10595,2312,59,24103,0,0,0,0,870,2645,3515
2018-02-18,23,3533,4646,2433,10332,9980,2114,55,22481,0,0,0,0,806,2716,3522
2018-02-18,24,3367,4517,2297,9586,9367,1938,53,20944,0,0,0,0,738,2762,3500
2018-02-19,1,3268,4532,2313,9199,9254,1871,58,20382,0,0,0,0,694,2874,3568
2018-02-19,2,3195,4517,2306,8900,8939,1816,59,19714,0,0,0,0,660,2916,3576
2018-02-19,3,3159,4537,2323,8757,8748,1777,60,19342,0,0,0,0,624,3003,3627
2018-02-19,4,3154,4617,2378,8792,8697,1776,62,19327,0,0,0,0,605,2957,3562
2018-02-19,5,3202,4800,2506,9093,8919,1839,68,19919,0,0,0,0,539,2930,3469
2018-02-19,6,3334,5075,2752,9717,9535,2014,74,21340,0,0,0,0,449,2913,3362
2018-02-19,7,3441,5276,3060,10679,10251,2265,82,23277,1,108,3,112,381,2890,3271
2018-02-19,8,3447,5397,3262,11069,10556,2387,86,24098,230,1737,247,2214,255,2981,3236
2018-02-19,9,3525,5469,3333,10891,10793,2384,87,24155,865,4045,762,5672,199,3067,3266
2018-02-19,10,3616,5506,3291,10447,10880,2327,79,23733,1010,4971,1056,7037,237,3047,3284
2018-02-19,11,3686,5507,3211,10121,10975,2256,81,23433,1030,5273,1203,7506,268,3022,3290
2018-02-19,12,3677,5471,3078,9820,11022,2211,79,23132,1044,5281,1204,7529,290,3001,3291
2018-02-19,13,3668,5442,2959,9724,11119,2172,77,23092,1037,5256,1211,7504,305,2979,3284
2018-02-19,14,3672,5421,2850,9577,11181,2160,76,22994,1061,5298,1182,7541,285,3005,3290
2018-02-19,15,3700,5408,2773,9618,11294,2185,77,23174,1050,5075,1101,7226,261,3035,3296
2018-02-19,16,3759,5489,2767,9819,11381,2284,79,23563,983,3955,858,5796,242,3053,3295
2018-02-19,17,3816,5590,2843,10616,11698,2425,84,24823,553,1834,479,2866,186,3071,3257
2018-02-19,18,4044,5881,3013,11495,12329,2702,86,26612,45,166,47,258,144,3058,3202
2018-02-19,19,4293,5870,3177,12570,13124,2889,89,28672,0,0,0,0,136,2970,3106
2018-02-19,20,4244,5750,3141,12710,12900,2844,88,28542,0,0,0,0,150,2950,3100
2018-02-19,21,4153,5568,3051,12409,12583,2733,85,27810,0,0,0,0,208,2944,3152
2018-02-19,22,3989,5260,2884,11753,11939,2539,82,26313,0,0,0,0,287,2852,3139
2018-02-19,23,3768,4958,2703,10856,11224,2281,80,24441,0,0,0,0,283,2723,3006
2018-02-19,24,3563,4790,2543,10021,10482,2068,78,22649,0,0,0,0,297,2515,2812
2018-02-20,1,3456,4831,2514,10190,9869,1956,81,22096,0,0,0,0,245,1807,2052
2018-02-20,2,3404,4813,2506,9866,9554,1902,83,21405,0,0,0,0,203,1560,1763
2018-02-20,3,3398,4827,2523,9704,9381,1880,86,21051,0,0,0,0,170,1315,1485
2018-02-20,4,3429,4921,2582,9736,9370,1872,90,21068,0,0,0,0,161,1070,1231
2018-02-20,5,3529,5161,2727,10082,9707,1942,96,21827,0,0,0,0,158,860,1018
2018-02-20,6,3735,5581,3036,10891,10574,2147,107,23719,0,0,0,0,144,670,814
2018-02-20,7,3930,5874,3449,12230,11717,2466,116,26529,2,138,6,146,135,510,645
2018-02-20,8,3925,5879,3614,12840,12078,2538,115,27571,289,2249,384,2922,106,300,406
2018-02-20,9,3849,5802,3504,12433,11799,2412,104,26749,986,5077,1093,7156,80,192,272
2018-02-20,10,3765,5712,3345,11854,11351,2237,94,25536,1116,6128,1423,8667,69,137,206
2018-02-20,11,3697,5619,3186,11359,11039,2096,85,24579,1123,6376,1507,9006,54,106,160
2018-02-20,12,3641,5536,3021,10990,10772,2004,79,23846,1118,6324,1489,8931,46,100,146
2018-02-20,13,3595,5510,2919,10772,10649,1940,75,23436,1088,6328,1478,8894,45,93,138
2018-02-20,14,3559,5481,2841,10785,10610,1932,72,23398,1102,6341,1485,8928,27,117,144
2018-02-20,15,3539,5487,2772,10866,10478,1967,69,23380,1107,6166,1444,8717,18,177,195
2018-02-20,16,3580,5546,2753,11118,10512,2045,72,23747,1052,5180,1221,7453,19,253,272
2018-02-20,17,3731,5657,2831,11725,10918,2224,76,24943,586,2510,663,3759,28,313,341
2018-02-20,18,4028,5930,3005,12863,11932,2571,81,27447,49,216,68,333,35,389,424
2018-02-20,19,4244,5971,3181,13812,12968,2808,88,29677,0,0,0,0,49,446,495
2018-02-20,20,4245,5885,3162,13799,12948,2793,90,29630,0,0,0,0,61,400,461
2018-02-20,21,4171,5675,3082,13423,12615,2706,90,28834,0,0,0,0,52,357,409
2018-02-20,22,4015,5379,2910,12648,12015,2524,88,27275,0,0,0,0,43,320,363
2018-02-20,23,3782,5099,2714,11684,11264,2278,85,25311,0,0,0,0,39,295,334
2018-02-20,24,3614,4949,2555,10832,10632,2071,83,23618,0,0,0,0,40,283,323
2018-02-21,1,3567,4890,2485,10170,10283,1995,87,22535,0,0,0,0,100,266,366
2018-02-21,2,3519,4882,2458,9848,9921,1936,89,21794,0,0,0,0,84,260,344
2018-02-21,3,3510,4900,2465,9683,9716,1906,92,21396,0,0,0,0,75,263,338
2018-02-21,4,3540,4993,2510,9716,9692,1905,95,21408,0,0,0,0,74,251,325
2018-02-21,5,3637,5217,2641,10061,10010,1981,101,22153,0,0,0,0,61,230,291
2018-02-21,6,3836,5623,2934,10871,10834,2170,110,23986,0,0,0,0,60,225,285
2018-02-21,7,4018,5904,3349,12213,11854,2461,119,26647,2,106,6,114,58,229,287
2018-02-21,8,3988,5900,3524,12820,12144,2532,118,27614,225,1771,359,2355,46,188,234
2018-02-21,9,3897,5822,3426,12411,11882,2422,106,26822,745,3908,962,5615,39,153,192
2018-02-21,10,3804,5715,3289,11824,11476,2255,95,25650,855,4823,1250,6928,38,120,158
2018-02-21,11,3731,5602,3166,11323,11175,2127,86,24710,931,5259,1389,7579,34,127,161
2018-02-21,12,3664,5500,3034,10947,10994,2035,79,24055,968,5334,1369,7671,33,173,206
2018-02-21,13,3610,5463,2959,10731,10865,1986,74,23656,959,5336,1336,7631,40,214,254
2018-02-21,14,3573,5440,2899,10747,10844,1972,70,23633,997,5257,1354,7608,36,323,359
2018-02-21,15,3554,5440,2850,10828,10813,2001,68,23710,958,4916,1329,7203,36,453,489
2018-02-21,16,3607,5493,2839,11085,10882,2087,68,24123,913,3819,1096,5828,40,646,686
2018-02-21,17,3753,5611,2911,11495,11323,2261,67,25146,510,1850,629,2989,55,746,801
2018-02-21,18,4065,5873,3064,12387,12263,2577,77,27304,44,160,66,270,101,816,917
2018-02-21,19,4293,5903,3226,13452,13292,2823,83,29650,0,0,0,0,187,858,1045
2018-02-21,20,4302,5827,3194,13500,13317,2805,85,29707,0,0,0,0,203,882,1085
2018-02-21,21,4232,5647,3109,13120,12976,2704,86,28886,0,0,0,0,214,868,1082
2018-02-21,22,4070,5344,2938,12378,12318,2526,84,27306,0,0,0,0,225,846,1071
2018-02-21,23,3835,5065,2731,11416,11402,2285,80,25184,0,0,0,0,208,904,1112
2018-02-21,24,3668,4909,2569,10590,10698,2081,79,23448,0,0,0,0,209,976,1185
2018-02-22,1,3595,4859,2496,10294,9997,1966,76,22334,0,0,0,0,521,1339,1860
2018-02-22,2,3536,4835,2470,9986,9630,1899,78,21593,0,0,0,0,587,1318,1905
2018-02-22,3,3514,4848,2476,9844,9407,1861,81,21192,0,0,0,0,625,1283,1908
2018-02-22,4,3537,4944,2521,9875,9371,1853,83,21182,0,0,0,0,745,1321,2066
2018-02-22,5,3628,5163,2648,10211,9684,1918,91,21904,0,0,0,0,632,1359,1991
2018-02-22,6,3815,5568,2935,10996,10461,2095,98,23651,0,0,0,0,501,1334,1835
2018-02-22,7,3985,5841,3340,12274,11497,2383,106,26260,3,145,6,154,376,1186,1562
2018-02-22,8,3973,5838,3512,12806,11905,2468,103,27282,207,2082,294,2583,288,1239,1527
2018-02-22,9,3905,5763,3431,12429,11663,2386,94,26572,733,4399,740,5872,252,1335,1587
2018-02-22,10,3825,5678,3311,11917,11389,2256,85,25647,922,5321,969,7212,270,1455,1725
2018-02-22,11,3771,5592,3197,11358,11199,2156,76,24789,993,5558,1144,7695,338,1750,2088
2018-02-22,12,3732,5506,3069,10850,11067,2087,69,24073,1003,5368,1226,7597,457,1969,2426
2018-02-22,13,3688,5479,2998,10584,10953,2050,64,23651,977,5173,1299,7449,576,2140,2716
2018-02-22,14,3663,5465,2943,10521,10848,2054,61,23484,931,5028,1343,7302,606,2217,2823
2018-02-22,15,3647,5473,2887,10618,10821,2099,59,23596,831,4812,1302,6945,577,2236,2813
2018-02-22,16,3687,5514,2883,10993,10922,2186,58,24159,707,3899,1045,5651,563,2217,2780
2018-02-22,17,3835,5615,2952,11657,11323,2337,62,25379,413,1906,557,2876,469,2201,2670
2018-02-22,18,4128,5862,3092,12568,12157,2598,69,27391,39,179,58,276,410,1896,2306
2018-02-22,19,4349,5887,3257,13645,13126,2787,76,29635,0,0,0,0,426,1716,2142
2018-02-22,20,4351,5798,3232,13651,13073,2765,78,29567,0,0,0,0,401,1729,2130
2018-02-22,21,4271,5605,3154,13318,12700,2686,78,28782,0,0,0,0,345,1619,1964
2018-02-22,22,4109,5318,2986,12719,12038,2523,75,27355,0,0,0,0,342,1555,1897
2018-02-22,23,3882,5039,2792,11847,11246,2290,72,25455,0,0,0,0,420,1746,2166
2018-02-22,24,3709,4875,2641,11015,10422,2088,71,23595,0,0,0,0,493,1899,2392
2018-02-23,1,3641,4817,2552,10674,9865,1961,71,22571,0,0,0,0,343,1721,2064
2018-02-23,2,3580,4787,2537,10370,9480,1893,72,21816,0,0,0,0,334,1975,2309
2018-02-23,3,3555,4791,2550,10210,9284,1860,74,21429,0,0,0,0,313,2139,2452
2018-02-23,4,3568,4871,2604,10220,9248,1855,77,21400,0,0,0,0,309,2233,2542
2018-02-23,5,3656,5081,2737,10521,9546,1914,82,22063,0,0,0,0,323,2339,2662
2018-02-23,6,3832,5469,3011,11268,10283,2072,90,23714,0,0,0,0,367,2450,2817
2018-02-23,7,4000,5730,3395,12139,11229,2322,97,25788,5,138,6,149,436,2364,2800
2018-02-23,8,3997,5750,3581,12611,11522,2406,95,26634,335,1927,354,2616,469,2449,2918
2018-02-23,9,3949,5708,3491,12205,11506,2344,88,26143,1003,4303,933,6239,563,2502,3065
2018-02-23,10,3895,5645,3349,11517,11268,2228,81,25095,1135,5322,1230,7687,615,2488,3103
2018-02-23,11,3849,5579,3221,10938,11068,2131,76,24213,1156,5687,1388,8231,559,2459,3018
2018-02-23,12,3789,5510,3059,10485,10884,2055,72,23496,1158,5664,1419,8241,493,2391,2884
2018-02-23,13,3720,5490,2961,10229,10780,2003,68,23080,1151,5672,1440,8263,458,2334,2792
2018-02-23,14,3670,5469,2877,10198,10726,1978,64,22966,1169,5675,1479,8323,407,2258,2665
2018-02-23,15,3639,5471,2810,10263,10617,2001,63,22943,1166,5515,1451,8132,341,2107,2448
2018-02-23,16,3675,5495,2799,10505,10616,2071,63,23255,1112,4511,1253,6876,288,1951,2239
2018-02-23,17,3810,5556,2852,11062,10804,2228,65,24159,653,2283,731,3667,205,1898,2103
2018-02-23,18,4086,5786,2978,11964,11514,2501,71,26049,66,228,84,378,149,1681,1830
2018-02-23,19,4286,5793,3106,12885,12475,2724,77,28161,0,0,0,0,109,1485,1594
2018-02-23,20,4287,5676,3067,12901,12441,2698,79,28119,0,0,0,0,96,1278,1374
2018-02-23,21,4235,5498,2985,12394,12171,2615,80,27260,0,0,0,0,72,1055,1127
2018-02-23,22,4121,5283,2845,11874,11704,2476,78,26132,0,0,0,0,80,812,892
2018-02-23,23,3923,5048,2677,11142,11116,2281,76,24616,0,0,0,0,83,613,696
2018-02-23,24,3776,4883,2517,10384,10433,2094,76,22987,0,0,0,0,96,504,600
2018-02-24,1,3767,4797,2392,10591,9877,2041,78,22587,0,0,0,0,128,449,577
2018-02-24,2,3697,4758,2345,10360,9468,1957,80,21865,0,0,0,0,129,397,526
2018-02-24,3,3655,4749,2341,10177,9250,1915,83,21425,0,0,0,0,143,355,498
2018-02-24,4,3660,4787,2358,10151,9172,1898,85,21306,0,0,0,0,198,293,491
2018-02-24,5,3716,4883,2415,10247,9237,1923,90,21497,0,0,0,0,253,296,549
2018-02-24,6,3798,5047,2539,10552,9518,1989,97,22157,0,0,0,0,280,320,600
2018-02-24,7,3835,5169,2715,10951,9754,2098,106,22909,5,187,10,202,286,372,658
2018-02-24,8,3822,5294,2854,11115,9777,2104,104,23099,339,2461,431,3231,299,437,736
2018-02-24,9,3821,5372,2955,10974,9710,2039,95,22817,1010,5255,1141,7406,299,502,801
2018-02-24,10,3793,5371,2940,10671,9519,1921,85,22196,1171,6299,1457,8927,318,617,935
2018-02-24,11,3756,5322,2868,10296,9367,1792,79,21534,1185,6584,1567,9336,317,982,1299
2018-02-24,12,3688,5247,2746,9943,9142,1722,73,20879,1163,6523,1555,9241,310,1374,1684
2018-02-24,13,3613,5184,2648,9643,9007,1672,66,20388,1135,6504,1552,9191,294,1713,2007
2018-02-24,14,3532,5144,2573,9561,8938,1689,65,20253,1137,6520,1558,9215,298,1915,2213
2018-02-24,15,3506,5149,2507,9716,8997,1744,64,20521,1119,6290,1510,8919,294,2037,2331
2018-02-24,16,3548,5207,2521,10011,9282,1900,65,21257,1016,5241,1290,7547,331,2136,2467
2018-02-24,17,3683,5321,2582,10424,9764,2084,68,22340,584,2596,750,3930,379,2098,2477
2018-02-24,18,3982,5557,2717,11306,10534,2365,73,24277,60,255,91,406,384,2138,2522
2018-02-24,19,4212,5625,2845,12028,11526,2554,79,26186,0,0,0,0,403,2168,2571
2018-02-24,20,4218,5548,2809,12028,11488,2550,82,26147,0,0,0,0,363,2283,2646
2018-02-24,21,4188,5419,2729,11731,11238,2507,82,25558,0,0,0,0,320,2440,2760
2018-02-24,22,4090,5226,2622,11443,10883,2394,80,24800,0,0,0,0,268,2521,2789
2018-02-24,23,3916,4996,2489,10840,10385,2237,77,23540,0,0,0,0,202,2294,2496
2018-02-24,24,3776,4829,2350,10211,9876,2073,75,22235,0,0,0,0,173,1890,2063
2018-02-25,1,3644,4706,2253,9678,9417,1940,72,21108,0,0,0,0,128,1900,2028
2018-02-25,2,3582,4661,2207,9354,9090,1862,74,20379,0,0,0,0,128,1314,1442
2018-02-25,3,3550,4657,2207,9142,8900,1821,76,19939,0,0,0,0,128,779,907
2018-02-25,4,3541,4669,2223,9059,8834,1806,79,19778,0,0,0,0,137,486,623
2018-02-25,5,3574,4738,2280,9125,8921,1825,82,19954,0,0,0,0,132,297,429
2018-02-25,6,3650,4865,2392,9400,9155,1892,88,20535,0,0,0,0,121,211,332
2018-02-25,7,3662,4964,2557,9881,9311,1992,97,21282,7,199,9,215,116,221,337
2018-02-25,8,3611,5069,2709,10238,9116,1998,94,21447,366,2483,425,3274,102,194,296
2018-02-25,9,3597,5073,2810,10259,8969,1949,87,21264,1024,5322,1118,7464,98,182,280
2018-02-25,10,3585,5050,2801,10138,8832,1845,79,20894,1168,6353,1417,8938,99,175,274
2018-02-25,11,3547,4996,2727,9789,8593,1741,72,20195,1205,6628,1528,9361,104,164,268
2018-02-25,12,3488,5004,2651,9482,8415,1675,66,19639,1209,6539,1559,9307,111,146,257
2018-02-25,13,3431,4955,2598,9309,8267,1645,62,19283,1196,6532,1571,9299,138,128,266
2018-02-25,14,3399,4977,2529,9252,8340,1652,60,19304,1206,6604,1587,9397,214,151,365
2018-02-25,15,3387,5014,2498,9346,8515,1728,58,19647,1190,6443,1551,9184,337,254,591
2018-02-25,16,3435,5107,2503,9661,8870,1824,59,20415,1131,5504,1350,7985,515,442,957
2018-02-25,17,3547,5243,2573,10302,9238,1999,62,21601,682,2792,792,4266,648,643,1291
2018-02-25,18,3802,5481,2729,11496,10008,2297,67,23869,75,281,101,457,741,841,1582
2018-02-25,19,4029,5548,2871,12369,11071,2526,72,26039,0,0,0,0,824,1067,1891
2018-02-25,20,4063,5476,2869,12408,11216,2528,75,26226,0,0,0,0,797,1176,1973
2018-02-25,21,4046,5327,2791,12089,11055,2446,76,25666,0,0,0,0,737,1217,1954
2018-02-25,22,3931,5097,2651,11534,10728,2312,75,24650,0,0,0,0,648,1235,1883
2018-02-25,23,3753,4841,2478,10711,10184,2121,71,23087,0,0,0,0,590,1262,1852
2018-02-25,24,3586,4700,2337,9926,9681,1955,70,21631,0,0,0,0,530,1309,1839
2018-02-26,1,3485,4596,2213,9860,9613,1914,68,21455,0,0,0,0,481,1033,1514
2018-02-26,2,3413,4587,2191,9526,9256,1855,70,20708,0,0,0,0,530,1061,1591
2018-02-26,3,3383,4591,2205,9322,9071,1825,73,20291,0,0,0,0,538,1083,1621
2018-02-26,4,3403,4685,2258,9323,9061,1831,77,20292,0,0,0,0,492,1110,1602
2018-02-26,5,3485,4915,2391,9620,9391,1894,83,20988,0,0,0,0,477,1021,1498
2018-02-26,6,3682,5326,2683,10396,10106,2074,94,22670,0,0,0,0,376,892,1268
2018-02-26,7,3844,5620,3089,11633,11161,2344,101,25239,6,220,12,238,370,790,1160
2018-02-26,8,3849,5662,3296,12304,11465,2433,98,26300,242,2577,405,3224,373,678,1051
2018-02-26,9,3819,5659,3224,12233,11254,2349,88,25925,632,5266,973,6871,345,626,971
2018-02-26,10,3791,5628,3118,12112,11076,2216,80,25484,716,6268,1152,8136,359,654,1013
2018-02-26,11,3771,5580,3033,11827,10918,2120,72,24937,720,6484,1165,8369,343,820,1163
2018-02-26,12,3746,5536,2923,11529,10811,2058,68,24466,656,6348,1095,8099,353,1030,1383
2018-02-26,13,3708,5532,2859,11500,10764,2038,65,24367,638,6278,1039,7955,407,1227,1634
2018-02-26,14,3671,5521,2798,11564,10850,2047,62,24523,664,6196,1009,7869,411,1308,1719
2018-02-26,15,3636,5515,2744,11780,10904,2099,61,24844,709,5759,965,7433,464,1367,1831
2018-02-26,16,3642,5563,2721,11906,10985,2185,62,25138,677,4535,807,6019,506,1509,2015
2018-02-26,17,3751,5651,2789,12328,11208,2333,64,25934,415,2031,443,2889,535,1377,1912
2018-02-26,18,4032,5864,2950,13068,11879,2607,70,27623,57,189,60,306,578,1246,1824
2018-02-26,19,4286,5886,3121,13746,12675,2823,73,29317,0,0,0,0,725,1118,1843
2018-02-26,20,4297,5789,3109,13696,12600,2787,72,29155,0,0,0,0,884,1116,2000
2018-02-26,21,4197,5588,3015,13151,12297,2660,72,28180,0,0,0,0,1016,1189,2205
2018-02-26,22,4029,5282,2838,12387,11734,2488,70,26680,0,0,0,0,1070,1229,2299
2018-02-26,23,3801,4982,2625,11345,10995,2246,68,24654,0,0,0,0,1108,1184,2292
2018-02-26,24,3619,4805,2464,10506,10231,2049,66,22852,0,0,0,0,1144,1199,2343
2018-02-27,1,3487,4661,2379,10296,10006,2057,66,22425,0,0,0,0,1150,1014,2164
2018-02-27,2,3423,4626,2354,10027,9630,1972,67,21696,0,0,0,0,1163,978,2141
2018-02-27,3,3401,4626,2365,9875,9432,1921,68,21296,0,0,0,0,1170,993,2163
2018-02-27,4,3415,4708,2416,9865,9402,1911,71,21249,0,0,0,0,1171,968,2139
2018-02-27,5,3498,4936,2544,10172,9658,1968,75,21873,0,0,0,0,1179,902,2081
2018-02-27,6,3690,5340,2855,10919,10415,2124,83,23541,0,0,0,0,1171,851,2022
2018-02-27,7,3841,5613,3255,12114,11441,2455,91,26102,7,151,10,168,1158,767,1925
2018-02-27,8,3841,5644,3429,12609,11889,2603,90,27191,290,1716,340,2346,1115,691,1806
2018-02-27,9,3802,5616,3321,12096,11701,2569,85,26451,843,3678,856,5377,1100,708,1808
2018-02-27,10,3753,5583,3178,11545,11392,2489,80,25506,1030,4442,1114,6586,1069,651,1720
2018-02-27,11,3724,5551,3046,11033,11321,2447,76,24877,1100,4724,1283,7107,966,703,1669
2018-02-27,12,3694,5515,2920,10596,11348,2424,74,24442,1125,4694,1298,7117,847,762,1609
2018-02-27,13,3663,5512,2833,10325,11421,2288,71,24104,1141,4647,1277,7065,748,866,1614
2018-02-27,14,3642,5500,2761,10297,11445,2289,68,24099,1163,4591,1279,7033,660,936,1596
2018-02-27,15,3621,5508,2701,10367,11365,2256,66,24054,1165,4469,1254,6888,566,1065,1631
2018-02-27,16,3656,5549,2668,10661,11266,2366,66,24359,1103,3621,1113,5837,472,1234,1706
2018-02-27,17,3761,5621,2747,11055,11558,2484,70,25166,679,1910,678,3267,319,1550,1869
2018-02-27,18,4023,5835,2908,11955,12290,2835,76,27155,83,205,96,384,237,1796,2033
2018-02-27,19,4260,5862,3079,13138,13230,2996,82,29446,0,0,0,0,214,1934,2148
2018-02-27,20,4262,5768,3063,13232,13175,2962,83,29452,0,0,0,0,218,1905,2123
2018-02-27,21,4183,5567,2981,12941,12780,2872,81,28674,0,0,0,0,216,1861,2077
2018-02-27,22,4017,5265,2813,12332,12082,2683,78,27175,0,0,0,0,232,1805,2037
2018-02-27,23,3787,4972,2607,11499,11266,2416,74,25255,0,0,0,0,226,1820,2046
2018-02-27,24,3608,4799,2446,10783,10536,2172,73,23563,0,0,0,0,201,1808,2009
2018-02-28,1,3503,4680,2311,10308,10046,2021,71,22447,0,0,0,0,183,1534,1717
2018-02-28,2,3445,4653,2275,10019,9753,1952,72,21796,0,0,0,0,166,1450,1616
2018-02-28,3,3424,4664,2281,9864,9628,1915,75,21482,0,0,0,0,153,1328,1481
2018-02-28,4,3446,4745,2313,9880,9678,1905,78,21542,0,0,0,0,179,1186,1365
2018-02-28,5,3536,4974,2431,10174,9921,1972,85,22151,0,0,0,0,203,1061,1264
2018-02-28,6,3729,5385,2701,10894,10714,2157,94,23859,0,0,0,0,210,921,1131
2018-02-28,7,3880,5640,3083,12084,11758,2452,104,26399,8,232,18,258,223,811,1034
2018-02-28,8,3867,5657,3239,12863,12036,2519,99,27517,333,2565,493,3391,195,742,937
2018-02-28,9,3811,5611,3152,12271,11841,2403,89,26604,874,5328,1173,7375,173,640,813
2018-02-28,10,3737,5553,3034,11520,11501,2257,79,25357,1014,6287,1470,8771,155,562,717
2018-02-28,11,3684,5492,2931,11184,11284,2156,71,24695,1042,6564,1568,9174,162,679,841
2018-02-28,12,3624,5431,2824,10900,11095,2085,65,24144,981,6541,1552,9074,179,866,1045
2018-02-28,13,3582,5410,2754,10783,10896,2050,60,23789,924,6341,1521,8786,219,1092,1311
2018-02-28,14,3559,5393,2698,10803,10868,2051,58,23779,910,6296,1509,8715,249,1215,1464
2018-02-28,15,3539,5395,2651,10930,10945,2095,56,24026,849,6045,1454,8348,290,1315,1605
2018-02-28,16,3583,5433,2653,11220,10976,2187,57,24439,756,4995,1222,6973,355,1377,1732
2018-02-28,17,3705,5500,2696,11715,11208,2346,58,25327,462,2634,705,3801,331,1213,1544
2018-02-28,18,3963,5724,2839,12526,11945,2641,64,27175,53,270,94,417,309,1029,1338
2018-02-28,19,4210,5769,2989,13583,12953,2852,68,29457,0,0,0,0,295,872,1167
2018-02-28,20,4216,5698,2959,13569,12899,2815,70,29354,0,0,0,0,291,847,1138
2018-02-28,21,4147,5509,2869,13059,12669,2733,71,28533,0,0,0,0,331,880,1211
2018-02-28,22,3980,5205,2710,12384,12183,2562,69,27198,0,0,0,0,348,870,1218
2018-02-28,23,3752,4915,2508,11509,11372,2329,67,25277,0,0,0,0,349,824,1173
2018-02-28,24,3574,4734,2340,10785,10645,2125,65,23620,0,0,0,0,359,800,1159
2018-03-01,1,3456,4593,2216,10056,9730,1981,62,21830,0,0,0,0,407,784,1191
2018-03-01,2,3387,4574,2168,9683,9429,1912,63,21087,0,0,0,0,428,771,1199
2018-03-01,3,3357,4579,2163,9485,9235,1875,66,20662,0,0,0,0,433,772,1205
2018-03-01,4,3370,4664,2190,9467,9209,1869,70,20615,0,0,0,0,477,753,1230
2018-03-01,5,3449,4884,2295,9717,9473,1934,77,21201,0,0,0,0,519,705,1224
2018-03-01,6,3621,5269,2564,10413,10144,2100,84,22740,0,0,0,0,606,645,1251
2018-03-01,7,3748,5514,2937,11616,10990,2378,92,25075,3,216,10,229,686,576,1262
2018-03-01,8,3761,5527,3102,12301,11451,2457,89,26297,121,2204,235,2560,703,530,1233
2018-03-01,9,3720,5470,3039,12391,11455,2363,81,26290,335,4477,570,5382,703,556,1259
2018-03-01,10,3673,5400,2971,12276,11281,2226,73,25857,407,5387,736,6530,738,574,1312
2018-03-01,11,3633,5319,2889,12157,11156,2129,68,25510,438,5745,793,6976,702,623,1325
2018-03-01,12,3605,5238,2822,11997,10994,2066,63,25120,480,5742,797,7019,704,710,1414
2018-03-01,13,3582,5221,2766,11850,10878,2037,60,24825,466,5740,804,7010,789,860,1649
2018-03-01,14,3583,5206,2721,11760,10811,2045,57,24673,450,5684,737,6871,878,1015,1893
2018-03-01,15,3585,5200,2685,11794,10810,2099,55,24758,442,5423,669,6534,927,1125,2052
2018-03-01,16,3615,5216,2665,11972,10878,2188,55,25092,410,4580,542,5532,979,1199,2178
2018-03-01,17,3709,5282,2721,12375,11321,2352,56,26103,238,2345,295,2878,954,1089,2043
2018-03-01,18,3913,5466,2824,12946,12177,2621,60,27803,34,247,44,325,960,933,1893
2018-03-01,19,4152,5556,2964,13869,12720,2814,63,29466,0,0,0,0,1001,843,1844
2018-03-01,20,4167,5483,2945,13886,12664,2777,65,29391,0,0,0,0,945,883,1828
2018-03-01,21,4097,5292,2868,13375,12372,2690,66,28503,0,0,0,0,929,914,1843
2018-03-01,22,3954,5017,2709,12617,11843,2520,64,27044,0,0,0,0,868,965,1833
2018-03-01,23,3751,4753,2506,11549,11027,2287,61,24924,0,0,0,0,815,1002,1817
2018-03-01,24,3563,4583,2338,10594,10245,2091,59,22989,0,0,0,0,727,1054,1781
2018-03-02,1,3374,4507,2241,10015,9632,1883,59,21588,0,0,0,0,562,1072,1634
2018-03-02,2,3294,4465,2200,9647,9364,1815,59,20884,0,0,0,0,417,1105,1522
2018-03-02,3,3259,4472,2194,9448,9179,1770,61,20458,0,0,0,0,326,1110,1436
2018-03-02,4,3257,4537,2230,9426,9126,1772,64,20388,0,0,0,0,269,1137,1406
2018-03-02,5,3329,4734,2341,9676,9307,1829,70,20881,0,0,0,0,204,1111,1315
2018-03-02,6,3507,5085,2602,10343,9898,2002,76,22319,0,0,0,0,149,1067,1216
2018-03-02,7,3631,5325,2990,11575,10735,2279,82,24671,8,245,13,266,137,1061,1198
2018-03-02,8,3643,5382,3160,12190,11415,2446,79,26129,207,2154,287,2648,153,1063,1216
2018-03-02,9,3632,5381,3099,12291,11586,2467,73,26417,491,4418,647,5556,153,1119,1272
2018-03-02,10,3601,5348,3018,12137,11652,2441,69,26299,561,5286,797,6644,162,1199,1361
2018-03-02,11,3582,5295,2928,11858,11643,2397,64,25963,574,5561,855,6990,190,1359,1549
2018-03-02,12,3578,5239,2832,11577,11523,2345,61,25506,572,5644,906,7122,250,1490,1740
2018-03-02,13,3554,5227,2753,11319,11396,2346,59,25119,545,5560,916,7021,360,1576,1936
2018-03-02,14,3538,5213,2680,11108,11333,2347,57,24845,541,5502,850,6893,401,1649,2050
2018-03-02,15,3531,5201,2638,10899,11251,2349,55,24555,541,5349,824,6714,570,1696,2266
2018-03-02,16,3543,5200,2609,11034,11167,2398,56,24654,518,4480,687,5685,673,1701,2374
2018-03-02,17,3627,5243,2667,11533,11394,2493,57,25477,330,2397,391,3118,584,1614,2198
2018-03-02,18,3820,5408,2755,12080,11667,2697,60,26503,46,258,62,366,494,1522,2016
2018-03-02,19,4026,5471,2879,13030,12345,2725,63,28163,0,0,0,0,402,1406,1808
2018-03-02,20,4029,5373,2852,13107,12423,2700,63,28294,0,0,0,0,348,1423,1771
2018-03-02,21,3955,5204,2770,12686,12092,2550,63,27392,0,0,0,0,349,1427,1776
2018-03-02,22,3859,5006,2634,12083,11595,2354,62,26095,0,0,0,0,332,1376,1708
2018-03-02,23,3706,4794,2478,11244,10922,2168,59,24394,0,0,0,0,291,1378,1669
2018-03-02,24,3542,4616,2328,10424,10179,1995,57,22656,0,0,0,0,280,1408,1688
2018-03-03,1,3417,4492,2219,10124,9708,1965,59,21856,0,0,0,0,348,1244,1592
2018-03-03,2,3325,4434,2173,9783,9326,1878,60,21047,0,0,0,0,319,1198,1517
2018-03-03,3,3257,4431,2172,9577,9083,1829,61,20551,0,0,0,0,283,1152,1435
2018-03-03,4,3243,4460,2195,9523,9023,1805,63,20414,0,0,0,0,257,1119,1376
2018-03-03,5,3280,4556,2264,9636,9099,1823,66,20624,0,0,0,0,215,1089,1304
2018-03-03,6,3374,4715,2412,9960,9414,1873,69,21317,0,0,0,0,190,1073,1263
2018-03-03,7,3369,4827,2598,10615,9588,1972,74,22248,8,255,14,277,173,1067,1240
2018-03-03,8,3360,4944,2740,11086,9717,2001,72,22876,238,2259,291,2788,158,1140,1298
2018-03-03,9,3411,5016,2823,11118,9681,2039,68,22907,612,4379,724,5715,154,1288,1442
2018-03-03,10,3445,5036,2816,11006,9776,2033,67,22882,756,5021,951,6728,169,1466,1635
2018-03-03,11,3454,5022,2745,10744,9691,1997,64,22496,790,5171,1034,6995,195,1609,1804
2018-03-03,12,3431,4981,2642,10448,9793,1916,62,22219,820,5138,1084,7042,226,1778,2004
2018-03-03,13,3396,4943,2531,10184,9757,1855,61,21857,788,4887,1135,6810,297,1960,2257
2018-03-03,14,3371,4929,2440,9949,9619,1832,61,21461,730,4792,1088,6610,347,2024,2371
2018-03-03,15,3375,4933,2374,9744,9246,1851,61,20902,690,4540,1030,6260,457,2082,2539
2018-03-03,16,3415,4975,2363,9808,9317,1915,62,21102,597,3641,835,5073,547,2209,2756
2018-03-03,17,3526,5062,2436,10194,9718,2080,64,22055,370,1962,490,2822,521,2200,2721
2018-03-03,18,3741,5256,2539,11036,10287,2375,68,23767,52,224,77,353,512,2177,2689
2018-03-03,19,3963,5353,2677,11957,11409,2591,75,26031,0,0,0,0,492,2158,2650
2018-03-03,20,3949,5295,2669,12052,11508,2576,75,26210,0,0,0,0,522,2201,2723
2018-03-03,21,3895,5161,2611,11871,11360,2513,75,25819,0,0,0,0,540,2267,2807
2018-03-03,22,3798,4973,2502,11574,10964,2397,73,25008,0,0,0,0,557,2311,2868
2018-03-03,23,3675,4767,2369,10992,10267,2233,69,23561,0,0,0,0,509,2396,2905
2018-03-03,24,3536,4600,2243,10373,9928,2068,67,22435,0,0,0,0,476,2455,2931
2018-03-04,1,3372,4447,2149,10310,9147,1937,62,21456,0,0,0,0,264,2202,2466
2018-03-04,2,3298,4405,2115,9956,8811,1858,62,20687,0,0,0,0,228,2193,2421
2018-03-04,3,3269,4395,2121,9740,8604,1803,64,20211,0,0,0,0,203,2152,2355
2018-03-04,4,3263,4421,2149,9753,8536,1786,67,20142,0,0,0,0,188,2086,2274
2018-03-04,5,3287,4491,2219,9836,8582,1800,70,20288,0,0,0,0,150,1998,2148
2018-03-04,6,3350,4603,2352,10087,8797,1841,76,20801,0,0,0,0,115,1940,2055
2018-03-04,7,3371,4676,2525,10480,9034,1915,82,21511,14,323,22,359,84,1930,2014
2018-03-04,8,3355,4782,2666,10564,9078,1930,83,21655,404,2853,476,3733,52,1919,1971
2018-03-04,9,3372,4797,2754,10367,9124,1904,78,21473,957,5466,1125,7548,44,1934,1978
2018-03-04,10,3375,4803,2743,10057,8949,1840,72,20917,1129,6443,1414,8986,41,1840,1881
2018-03-04,11,3362,4782,2651,9995,8750,1744,67,20556,1172,6719,1561,9452,40,1552,1592
2018-03-04,12,3341,4814,2548,9802,8559,1700,62,20123,1171,6693,1582,9446,41,1248,1289
2018-03-04,13,3329,4784,2455,9716,8376,1703,58,19852,1160,6673,1601,9434,42,1041,1083
2018-03-04,14,3292,4798,2371,9586,8356,1686,56,19684,1164,6635,1591,9390,38,931,969
2018-03-04,15,3287,4817,2315,9688,8392,1726,55,19861,1154,6343,1569,9066,35,876,911
2018-03-04,16,3334,4910,2284,9968,8718,1826,56,20568,1100,5353,1362,7815,34,819,853
2018-03-04,17,3425,5014,2373,10496,9262,2007,58,21823,702,2971,808,4481,35,770,805
2018-03-04,18,3628,5207,2511,11561,10290,2307,62,24220,94,358,121,573,38,732,770
2018-03-04,19,3869,5319,2681,12171,10947,2574,67,25759,0,0,0,0,43,622,665
2018-03-04,20,3947,5277,2705,12310,11115,2617,71,26113,0,0,0,0,44,495,539
2018-03-04,21,3924,5124,2645,12065,10983,2543,72,25663,0,0,0,0,51,353,404
2018-03-04,22,3815,4884,2506,11563,10601,2428,71,24663,0,0,0,0,74,270,344
2018-03-04,23,3691,4665,2334,10807,10005,2227,68,23107,0,0,0,0,73,249,322
2018-03-04,24,3534,4538,2192,10064,9379,2039,66,21548,0,0,0,0,74,258,332
2018-03-05,1,3413,4515,2085,9330,8903,1823,65,20121,0,0,0,0,57,236,293
2018-03-05,2,3354,4514,2064,9088,8722,1768,67,19644,0,0,0,0,54,251,305
2018-03-05,3,3345,4551,2082,9031,8616,1736,69,19453,0,0,0,0,55,271,326
2018-03-05,4,3371,4653,2138,9132,8667,1742,73,19614,0,0,0,0,62,294,356
2018-03-05,5,3455,4898,2278,9522,9040,1815,81,20458,0,0,0,0,76,314,390
2018-03-05,6,3651,5296,2576,10339,9807,2030,88,22265,0,0,0,0,88,333,421
2018-03-05,7,3790,5568,2985,11584,10724,2269,96,24673,20,359,33,412,99,358,457
2018-03-05,8,3811,5594,3157,12082,11041,2334,94,25551,468,2948,588,4004,95,356,451
2018-03-05,9,3773,5542,3068,11633,10878,2223,85,24819,1028,5664,1264,7956,96,377,473
2018-03-05,10,3729,5482,2956,11062,10697,2088,78,23926,1165,6571,1548,9284,109,406,515
2018-03-05,11,3697,5401,2848,10708,10492,1973,72,23246,1194,6836,1601,9631,91,404,495
2018-03-05,12,3660,5322,2732,10270,10366,1883,67,22586,1191,6833,1597,9621,79,369,448
2018-03-05,13,3619,5294,2646,10035,10307,1854,64,22260,1159,6865,1615,9639,75,330,405
2018-03-05,14,3568,5257,2571,10066,10344,1873,63,22345,1166,6894,1600,9660,63,283,346
2018-03-05,15,3522,5230,2511,10150,10533,1945,61,22689,1154,6662,1578,9394,58,233,291
2018-03-05,16,3509,5259,2470,10269,10691,2060,61,23081,1093,5814,1372,8279,49,185,234
2018-03-05,17,3582,5348,2521,10661,10983,2200,63,23908,698,3196,825,4719,46,173,219
2018-03-05,18,3815,5533,2650,11431,11487,2397,67,25382,105,384,130,619,44,160,204
2018-03-05,19,4096,5642,2831,12633,12386,2674,71,27764,0,0,0,0,44,146,190
2018-03-05,20,4139,5597,2848,12989,12525,2694,72,28280,0,0,0,0,42,197,239
2018-03-05,21,4064,5398,2778,12693,12143,2585,73,27494,0,0,0,0,42,230,272
2018-03-05,22,3919,5093,2612,12044,11493,2407,72,26016,0,0,0,0,47,242,289
2018-03-05,23,3723,4824,2422,11059,10616,2175,69,23919,0,0,0,0,43,238,281
2018-03-05,24,3549,4666,2253,10247,9858,1976,67,22148,0,0,0,0,43,226,269
2018-03-06,1,3421,4648,2165,9609,9108,1856,69,20642,0,0,0,0,45,234,279
2018-03-06,2,3366,4623,2133,9279,8800,1797,70,19945,0,0,0,0,53,224,277
2018-03-06,3,3353,4635,2139,9053,8637,1755,72,19518,0,0,0,0,71,223,294
2018-03-06,4,3374,4726,2178,8999,8513,1752,75,19340,0,0,0,0,75,221,296
2018-03-06,5,3468,4962,2310,9284,8801,1816,81,19982,0,0,0,0,95,224,319
2018-03-06,6,3661,5369,2597,10006,9547,2018,92,21663,0,0,0,0,111,225,336
2018-03-06,7,3780,5627,2995,11317,10390,2240,98,24045,21,340,33,394,119,234,353
2018-03-06,8,3788,5637,3155,11979,10718,2273,95,25065,374,2739,504,3617,106,241,347
2018-03-06,9,3730,5563,3041,11524,10567,2153,86,24330,838,5155,1106,7099,89,286,375
2018-03-06,10,3671,5503,2914,10930,10400,2049,79,23457,988,6062,1363,8413,86,363,449
2018-03-06,11,3622,5434,2780,10483,10337,1986,72,22879,1061,6562,1495,9118,77,365,442
2018-03-06,12,3572,5365,2668,10176,10326,1941,69,22512,1103,6620,1542,9265,66,349,415
2018-03-06,13,3526,5348,2583,9943,10367,1945,66,22320,1106,6688,1578,9372,64,316,380
2018-03-06,14,3503,5318,2515,9981,10542,1998,64,22585,1112,6736,1567,9415,52,276,328
2018-03-06,15,3482,5302,2452,10092,10735,2070,62,22960,1109,6484,1534,9127,39,234,273
2018-03-06,16,3494,5322,2416,10358,10844,2172,62,23436,1047,5574,1327,7948,33,199,232
2018-03-06,17,3583,5403,2448,10885,11055,2293,64,24297,690,3171,796,4657,31,170,201
2018-03-06,18,3799,5580,2570,11504,11385,2472,68,25429,113,386,126,625,31,124,155
2018-03-06,19,4067,5684,2753,12550,12182,2685,72,27489,0,0,0,0,31,101,132
2018-03-06,20,4099,5637,2769,12622,12128,2688,72,27510,0,0,0,0,27,97,124
2018-03-06,21,4039,5442,2698,12309,11762,2577,73,26722,0,0,0,0,22,95,117
2018-03-06,22,3897,5145,2546,11718,11117,2394,72,25301,0,0,0,0,23,97,120
2018-03-06,23,3696,4874,2358,10901,10304,2156,69,23429,0,0,0,0,21,93,114
2018-03-06,24,3515,4708,2198,10107,9569,1960,66,21702,0,0,0,0,21,89,110
2018-03-07,1,3419,4620,2145,9715,9085,1844,61,20705,0,0,0,0,27,100,127
2018-03-07,2,3353,4594,2112,9407,8782,1787,62,20038,0,0,0,0,31,94,125
2018-03-07,3,3326,4611,2114,9267,8632,1742,64,19705,0,0,0,0,35,95,130
2018-03-07,4,3338,4699,2146,9284,8638,1733,67,19722,0,0,0,0,42,94,136
2018-03-07,5,3423,4931,2263,9566,8891,1790,73,20320,0,0,0,0,37,72,109
2018-03-07,6,3614,5329,2542,10247,9621,1981,82,21931,0,0,0,0,36,64,100
2018-03-07,7,3722,5575,2934,11437,10590,2209,89,24325,18,372,32,422,41,60,101
2018-03-07,8,3731,5578,3082,12095,11057,2242,88,25482,271,2430,335,3036,39,49,88
2018-03-07,9,3679,5502,2981,11666,10942,2215,78,24900,573,4374,722,5669,39,50,89
2018-03-07,10,3629,5440,2864,11360,10863,2162,71,24456,653,5014,921,6588,38,64,102
2018-03-07,11,3592,5369,2756,11053,10897,2114,65,24129,766,5370,1058,7194,39,70,109
2018-03-07,12,3545,5297,2653,10842,10858,2094,62,23855,853,5043,1138,7034,51,92,143
2018-03-07,13,3503,5276,2581,10702,10833,2106,60,23702,863,4926,1214,7003,69,106,175
2018-03-07,14,3487,5250,2519,10685,10891,2140,57,23773,881,4884,1212,6977,90,123,213
2018-03-07,15,3477,5234,2470,10734,10899,2204,56,23893,898,4411,1219,6528,114,156,270
2018-03-07,16,3501,5246,2431,11008,10908,2275,56,24246,862,3657,1088,5607,176,193,369
2018-03-07,17,3584,5313,2470,11292,10953,2336,57,24638,606,2156,680,3442,173,232,405
2018-03-07,18,3768,5481,2556,11970,11356,2441,60,25827,103,261,110,474,169,302,471
2018-03-07,19,4040,5580,2726,12574,12048,2670,65,27357,0,0,0,0,164,482,646
2018-03-07,20,4070,5553,2731,12649,12017,2671,65,27401,0,0,0,0,188,691,879
2018-03-07,21,4013,5376,2665,12362,11803,2562,63,26790,0,0,0,0,235,862,1097
2018-03-07,22,3871,5079,2509,11751,11211,2379,62,25402,0,0,0,0,309,982,1291
2018-03-07,23,3671,4808,2315,10857,10341,2139,59,23396,0,0,0,0,311,1040,1351
2018-03-07,24,3488,4633,2153,10107,9580,1938,57,21681,0,0,0,0,302,1089,1391
2018-03-08,1,3294,4479,2032,9538,9109,1886,56,20589,0,0,0,0,185,966,1151
2018-03-08,2,3221,4452,1988,9213,8791,1813,56,19873,0,0,0,0,172,1003,1175
2018-03-08,3,3187,4463,1980,9035,8615,1778,59,19487,0,0,0,0,163,1025,1188
2018-03-08,4,3194,4553,2004,9041,8592,1771,62,19465,0,0,0,0,154,1061,1215
2018-03-08,5,3271,4778,2111,9297,8856,1831,69,20052,0,0,0,0,141,1096,1237
2018-03-08,6,3442,5181,2371,9966,9588,1989,76,21618,0,1,0,1,132,1088,1220
2018-03-08,7,3555,5410,2731,11172,10462,2235,83,23952,30,418,48,496,124,1011,1135
2018-03-08,8,3570,5413,2880,11741,10694,2287,80,24802,384,2779,501,3664,116,884,1000
2018-03-08,9,3551,5342,2790,11490,10457,2194,71,24213,763,4915,1004,6682,116,811,927
2018-03-08,10,3526,5282,2708,11220,10261,2094,65,23640,870,5648,1288,7806,116,749,865
2018-03-08,11,3512,5207,2625,10999,10165,2024,61,23249,901,5978,1392,8271,119,847,966
2018-03-08,12,3502,5129,2555,10774,10137,1990,58,22959,918,6008,1374,8300,119,966,1085
2018-03-08,13,3492,5110,2503,10641,10184,1996,57,22878,908,5952,1381,8241,121,1138,1259
2018-03-08,14,3510,5088,2457,10665,10387,2024,55,23131,860,5857,1333,8050,115,1317,1432
2018-03-08,15,3534,5065,2404,10810,10542,2104,54,23510,815,5363,1220,7398,121,1487,1608
2018-03-08,16,3567,5065,2387,11033,10675,2187,54,23949,730,4364,991,6085,134,1646,1780
2018-03-08,17,3630,5115,2405,11358,10871,2332,54,24615,454,2462,571,3487,129,1567,1696
2018-03-08,18,3796,5274,2484,11841,11184,2570,57,25652,72,363,84,519,132,1569,1701
2018-03-08,19,4005,5368,2632,12498,12012,2720,61,27292,0,0,0,0,139,1604,1743
2018-03-08,20,3976,5353,2631,12570,11975,2676,61,27281,0,0,0,0,169,1617,1786
2018-03-08,21,3881,5185,2564,12242,11635,2572,59,26509,0,0,0,0,207,1566,1773
2018-03-08,22,3736,4907,2424,11656,11080,2405,56,25197,0,0,0,0,241,1533,1774
2018-03-08,23,3558,4644,2238,10767,10306,2174,52,23299,0,0,0,0,257,1647,1904
2018-03-08,24,3371,4468,2079,10018,9540,1986,49,21593,0,0,0,0,244,1808,2052
2018-03-09,1,3302,4368,1970,9453,8948,1895,48,20344,0,0,0,0,266,2060,2326
2018-03-09,2,3222,4337,1921,9123,8614,1820,48,19605,0,0,0,0,239,2117,2356
2018-03-09,3,3180,4346,1908,8953,8416,1784,50,19203,0,0,0,0,221,2067,2288
2018-03-09,4,3173,4420,1931,8957,8373,1773,53,19156,0,0,0,0,214,1989,2203
2018-03-09,5,3244,4628,2027,9213,8627,1824,58,19723,0,0,0,0,212,1909,2121
2018-03-09,6,3412,4992,2269,9862,9303,1965,64,21194,0,1,0,1,203,1802,2005
2018-03-09,7,3505,5218,2620,10727,10066,2193,70,23056,16,421,33,470,201,1756,1957
2018-03-09,8,3536,5257,2792,11554,10453,2253,67,24327,222,2807,345,3374,157,1696,1853
2018-03-09,9,3548,5217,2728,11408,10489,2162,62,24120,457,4912,689,6058,117,1606,1723
2018-03-09,10,3544,5181,2656,11149,10439,2098,58,23744,603,5730,888,7221,85,1408,1493
2018-03-09,11,3545,5126,2583,10879,10470,2045,54,23448,681,6000,997,7678,65,1369,1434
2018-03-09,12,3538,5059,2507,10630,10558,2012,53,23253,716,5812,1045,7573,51,1433,1484
2018-03-09,13,3534,5034,2441,10508,10626,2015,52,23201,748,5629,1097,7474,43,1556,1599
2018-03-09,14,3548,5010,2387,10543,10738,2049,51,23381,712,5469,1059,7240,45,1787,1832
2018-03-09,15,3568,4978,2333,10669,10901,2105,50,23725,687,4918,986,6591,45,2023,2068
2018-03-09,16,3605,4956,2294,10803,10923,2202,50,23979,594,3991,801,5386,50,2176,2226
2018-03-09,17,3659,4972,2330,11029,10999,2294,50,24372,382,2276,479,3137,45,2052,2097
2018-03-09,18,3814,5084,2396,11492,11137,2540,53,25222,71,330,86,487,50,1959,2009
2018-03-09,19,4006,5170,2535,12088,11826,2685,56,26656,0,0,0,0,55,1904,1959
2018-03-09,20,3965,5142,2542,12144,11711,2639,56,26550,0,0,0,0,60,1875,1935
2018-03-09,21,3859,5003,2470,11775,11347,2536,55,25713,0,0,0,0,73,1834,1907
2018-03-09,22,3719,4798,2351,11242,10855,2390,52,24539,0,0,0,0,126,1786,1912
2018-03-09,23,3585,4575,2209,10487,10212,2205,49,22952,0,0,0,0,71,1740,1811
2018-03-09,24,3412,4393,2073,9781,9502,2022,46,21351,0,0,0,0,52,1692,1744
2018-03-10,1,3268,4278,1966,9309,9184,1867,44,20404,0,0,0,0,127,1725,1852
2018-03-10,2,3184,4240,1923,8959,8829,1783,44,19615,0,0,0,0,112,1654,1766
2018-03-10,3,3124,4237,1920,8747,8552,1718,45,19061,0,0,0,0,95,1577,1672
2018-03-10,4,3099,4274,1941,8681,8406,1692,46,18824,0,0,0,0,82,1401,1483
2018-03-10,5,3122,4369,2007,8764,8507,1707,48,19026,0,0,0,0,83,1180,1263
2018-03-10,6,3193,4532,2138,8993,8894,1770,52,19709,0,0,0,0,76,993,1069
2018-03-10,7,3165,4625,2325,9347,9209,1889,56,20501,17,327,27,371,74,806,880
2018-03-10,8,3162,4730,2451,9678,9455,1983,56,21172,228,1966,255,2449,65,552,617
2018-03-10,9,3233,4763,2511,9973,9708,2092,54,21826,419,3127,472,4018,59,413,472
2018-03-10,10,3291,4771,2492,9998,9885,2125,51,22060,474,3351,567,4392,51,342,393
2018-03-10,11,3309,4750,2424,9928,9884,2115,49,21976,500,3545,642,4687,47,338,385
2018-03-10,12,3295,4708,2319,9768,9849,2067,48,21731,440,3166,569,4175,59,365,424
2018-03-10,13,3281,4664,2224,9600,9738,2043,46,21427,413,2848,541,3802,68,426,494
2018-03-10,14,3298,4630,2141,9475,9661,2010,44,21190,381,2686,455,3522,68,555,623
2018-03-10,15,3332,4621,2082,9386,9473,2011,43,20914,343,2345,394,3082,70,691,761
2018-03-10,16,3353,4662,2071,9417,9449,2064,44,20975,315,1839,342,2496,76,773,849
2018-03-10,17,3421,4730,2106,9633,9534,2124,46,21338,213,990,181,1384,66,703,769
2018-03-10,18,3601,4905,2191,10218,10022,2303,49,22593,41,149,37,227,76,650,726
2018-03-10,19,3821,5031,2333,11072,11012,2495,53,24632,0,0,0,0,94,612,706
2018-03-10,20,3788,5032,2355,11333,11122,2480,52,24987,0,0,0,0,94,569,663
2018-03-10,21,3695,4924,2302,11084,10866,2397,51,24398,0,0,0,0,103,566,669
2018-03-10,22,3576,4731,2208,10676,10432,2268,49,23425,0,0,0,0,106,582,688
2018-03-10,23,3461,4522,2087,10089,9837,2097,46,22069,0,0,0,0,107,629,736
2018-03-10,24,3317,4360,1975,9436,9291,1935,45,20707,0,0,0,0,104,685,789
2018-03-11,1,3198,4271,1919,8765,8711,1826,46,19347,0,0,0,0,136,1087,1223
2018-03-11,2,3115,4237,1881,8433,8360,1746,46,18585,0,0,0,0,109,1129,1238
2018-03-11,3,3115,4237,1881,8433,8360,1746,46,18585,0,0,0,0,109,1129,1238
2018-03-11,4,3063,4256,1900,8231,8047,1677,49,18004,0,0,0,0,85,1093,1178
2018-03-11,5,3075,4321,1960,8291,8063,1683,52,18089,0,0,0,0,79,1014,1093
2018-03-11,6,3115,4437,2073,8491,8196,1722,58,18467,0,0,0,0,68,824,892
2018-03-11,7,3120,4510,2226,8802,8437,1790,61,19090,0,0,0,0,65,656,721
2018-03-11,8,3100,4602,2341,8971,8499,1825,60,19356,31,385,44,460,71,538,609
2018-03-11,9,3153,4601,2400,9029,8669,1832,56,19586,411,2406,516,3333,73,420,493
2018-03-11,10,3203,4610,2423,8827,8680,1797,54,19358,839,4471,1031,6341,68,360,428
2018-03-11,11,3230,4566,2399,8501,8692,1741,52,18985,947,5221,1253,7421,60,331,391
2018-03-11,12,3199,4574,2262,8290,8727,1696,49,18763,1009,5671,1360,8040,46,346,392
2018-03-11,13,3181,4524,2182,8154,8715,1701,48,18618,1088,5923,1404,8415,40,373,413
2018-03-11,14,3167,4528,2104,8206,8723,1737,47,18713,1108,5918,1403,8429,43,414,457
2018-03-11,15,3183,4543,2052,8369,8853,1772,46,19040,1110,5841,1347,8298,36,442,478
2018-03-11,16,3226,4612,2043,8786,9155,1833,46,19820,1108,5649,1272,8029,33,457,490
2018-03-11,17,3259,4728,2091,9432,9494,1973,46,20946,1033,4749,1046,6828,34,500,534
2018-03-11,18,3442,4861,2190,10502,10083,2156,49,22790,690,2753,611,4054,27,516,543
2018-03-11,19,3671,4994,2322,11365,10976,2401,53,24795,121,415,105,641,20,500,520
2018-03-11,20,3725,5023,2357,11715,11200,2515,54,25484,0,0,0,0,18,496,514
2018-03-11,21,3662,4908,2327,11704,11058,2455,53,25270,0,0,0,0,20,432,452
2018-03-11,22,3520,4665,2210,11169,10515,2273,50,24008,0,0,0,0,24,386,410
2018-03-11,23,3427,4438,2046,10414,9856,2070,46,22387,0,0,0,0,71,342,413
2018-03-11,24,3262,4298,1917,9612,9169,1898,44,20723,0,0,0,0,62,336,398
2018-03-12,1,3262,4173,1847,9056,8853,1829,42,19780,0,0,0,0,66,317,383
2018-03-12,2,3167,4151,1811,8735,8494,1759,41,19029,0,0,0,0,66,294,360
2018-03-12,3,3116,4167,1813,8534,8216,1725,41,18517,0,0,0,0,48,255,303
2018-03-12,4,3106,4258,1853,8584,8299,1712,42,18636,0,0,0,0,37,220,257
2018-03-12,5,3149,4480,1961,8820,8564,1758,44,19186,0,0,0,0,37,195,232
2018-03-12,6,3299,4868,2214,9437,9217,1899,50,20603,0,0,0,0,38,154,192
2018-03-12,7,3540,5235,2593,10613,10329,2139,56,23137,0,1,0,1,40,118,158
2018-03-12,8,3553,5285,2821,11517,10882,2230,61,24689,37,458,56,551,46,98,144
2018-03-12,9,3555,5259,2786,11416,10726,2196,59,24398,460,3006,650,4116,43,78,121
2018-03-12,10,3571,5228,2730,11211,10742,2142,57,24152,838,5145,1111,7094,43,80,123
2018-03-12,11,3582,5184,2664,10864,10804,2087,56,23811,902,5752,1255,7909,54,102,156
2018-03-12,12,3575,5127,2569,10737,10859,2057,54,23707,932,6006,1338,8276,66,154,220
2018-03-12,13,3559,5109,2502,10668,10952,2055,53,23728,897,6045,1270,8212,97,186,283
2018-03-12,14,3545,5074,2451,10700,11129,2080,52,23961,886,5975,1316,8177,129,239,368
2018-03-12,15,3564,5027,2395,10797,11321,2124,51,24292,863,5851,1275,7989,155,311,466
2018-03-12,16,3608,5004,2354,10894,11507,2185,50,24636,821,5654,1195,7670,171,388,559
2018-03-12,17,3620,4983,2349,11177,11656,2285,49,25167,742,4773,1013,6528,216,493,709
2018-03-12,18,3676,4945,2369,11550,11793,2401,51,25794,484,2720,605,3809,214,550,764
2018-03-12,19,3826,5067,2400,11755,11902,2556,52,26265,84,358,99,541,191,616,807
2018-03-12,20,4041,5230,2512,12378,12602,2716,56,27752,0,0,0,0,241,694,935
2018-03-12,21,3978,5114,2495,12368,12577,2663,56,27664,0,0,0,0,265,689,954
2018-03-12,22,3808,4827,2349,11834,11899,2447,53,26233,0,0,0,0,304,666,970
2018-03-12,23,3611,4547,2166,10969,11027,2192,48,24236,0,0,0,0,433,641,1074
2018-03-12,24,3396,4359,1990,10147,10107,1986,45,22285,0,0,0,0,494,636,1130
2018-03-13,1,3241,4218,1884,9426,9393,1921,43,20784,0,0,0,0,474,799,1273
2018-03-13,2,3130,4179,1824,9019,9023,1832,43,19917,0,0,0,0,506,781,1287
2018-03-13,3,3067,4183,1801,8796,8785,1773,43,19397,0,0,0,0,503,777,1280
2018-03-13,4,3045,4261,1810,8737,8709,1756,44,19246,0,0,0,0,485,785,1270
2018-03-13,5,3086,4478,1887,8906,8920,1802,46,19674,0,0,0,0,445,797,1242
2018-03-13,6,3216,4872,2111,9488,9536,1923,52,20999,0,0,0,0,392,729,1121
2018-03-13,7,3436,5208,2454,10696,10623,2144,58,23522,0,1,0,1,356,688,1044
2018-03-13,8,3458,5231,2652,11750,11102,2219,61,25132,26,429,33,488,396,634,1030
2018-03-13,9,3470,5187,2639,11855,11145,2196,61,25257,304,2513,306,3123,418,431,849
2018-03-13,10,3498,5142,2618,11896,11160,2168,59,25283,575,4233,595,5403,499,350,849
2018-03-13,11,3533,5094,2567,11809,11162,2154,56,25181,655,4942,737,6334,533,276,809
2018-03-13,12,3559,5033,2524,11596,11207,2126,55,24984,649,5363,837,6849,493,376,869
2018-03-13,13,3613,5017,2496,11357,11214,2123,54,24748,636,5331,869,6836,473,544,1017
2018-03-13,14,3657,4994,2448,11095,11280,2160,53,24588,623,5173,830,6626,474,774,1248
2018-03-13,15,3714,4957,2394,10949,11314,2222,52,24537,599,4891,731,6221,452,957,1409
2018-03-13,16,3779,4942,2376,10961,11409,2293,52,24714,593,4555,707,5855,458,1085,1543
2018-03-13,17,3852,4936,2380,11074,11394,2387,50,24906,565,3630,665,4860,481,1187,1668
2018-03-13,18,3861,4942,2397,11386,11442,2463,51,25342,387,2040,372,2799,433,1222,1655
2018-03-13,19,3962,5008,2447,11661,11553,2592,51,25857,78,258,70,406,376,1193,1569
2018-03-13,20,4141,5165,2573,12448,12306,2685,56,27494,0,0,0,0,336,1202,1538
2018-03-13,21,4100,5029,2565,12559,12332,2644,56,27590,0,0,0,0,312,1191,1503
2018-03-13,22,3904,4753,2411,11973,11773,2462,53,26261,0,0,0,0,255,1210,1465
2018-03-13,23,3610,4472,2223,11046,10971,2222,49,24287,0,0,0,0,241,1235,1476
2018-03-13,24,3381,4271,2041,10194,10110,2015,45,22364,0,0,0,0,250,1266,1516
2018-03-14,1,3191,4147,1890,9499,9661,1921,44,21125,0,0,0,0,241,1191,1432
2018-03-14,2,3092,4102,1839,9099,9254,1838,44,20234,0,0,0,0,265,1295,1560
2018-03-14,3,3037,4102,1818,8900,8995,1790,44,19729,0,0,0,0,248,1426,1674
2018-03-14,4,3020,4166,1839,8828,8904,1772,44,19548,0,0,0,0,231,1537,1768
2018-03-14,5,3065,4367,1928,9035,9101,1814,47,19996,0,0,0,0,246,1575,1821
2018-03-14,6,3189,4734,2172,9658,9717,1922,52,21349,0,0,0,0,245,1604,1849
2018-03-14,7,3414,5077,2538,10925,10788,2150,58,23921,0,1,0,1,233,1592,1825
2018-03-14,8,3430,5110,2770,11950,11213,2290,61,25513,40,483,45,568,231,1582,1813
2018-03-14,9,3428,5092,2746,11899,11617,2319,61,25895,459,2809,526,3794,245,1644,1889
2018-03-14,10,3449,5059,2697,11564,11628,2277,60,25529,798,4915,1035,6748,240,1688,1928
2018-03-14,11,3475,5023,2639,11268,11667,2195,57,25187,855,5699,1212,7766,245,1745,1990
2018-03-14,12,3470,4989,2553,11058,11655,2142,55,24910,870,6133,1323,8326,243,1885,2128
2018-03-14,13,3455,4995,2499,10883,11562,2098,53,24596,797,6305,1232,8334,245,1914,2159
2018-03-14,14,3452,4981,2437,10718,11528,2106,51,24402,722,6233,1168,8123,262,1936,2198
2018-03-14,15,3462,4958,2379,10541,11438,2112,49,24139,687,5883,1080,7650,298,1995,2293
2018-03-14,16,3485,4945,2334,10512,11404,2159,48,24123,653,5308,894,6855,361,2069,2430
2018-03-14,17,3498,4913,2337,10780,11511,2262,48,24602,624,4319,758,5701,425,2113,2538
2018-03-14,18,3548,4871,2355,11129,11696,2399,49,25273,446,2474,471,3391,473,2076,2549
2018-03-14,19,3657,4991,2409,11498,11914,2556,51,26018,92,345,86,523,531,2002,2533
2018-03-14,20,3877,5143,2546,12417,12836,2624,55,27932,0,0,0,0,586,1961,2547
2018-03-14,21,3861,5025,2561,12679,12845,2569,55,28148,0,0,0,0,626,1978,2604
2018-03-14,22,3733,4742,2422,12167,12276,2427,53,26923,0,0,0,0,666,2030,2696
2018-03-14,23,3589,4459,2238,11234,11370,2206,49,24859,0,0,0,0,697,2100,2797
2018-03-14,24,3386,4258,2076,10418,10533,2006,47,23004,0,0,0,0,687,2115,2802
2018-03-15,1,3258,4146,2011,9590,9505,1925,48,21068,0,0,0,0,789,1860,2649
2018-03-15,2,3161,4102,1971,9212,9159,1840,48,20259,0,0,0,0,794,1981,2775
2018-03-15,3,3103,4101,1959,9004,8932,1777,49,19762,0,0,0,0,749,2281,3030
2018-03-15,4,3095,4173,1990,8992,8869,1758,50,19669,0,0,0,0,681,2491,3172
2018-03-15,5,3157,4383,2093,9241,9108,1807,54,20209,0,0,0,0,609,2548,3157
2018-03-15,6,3313,4757,2353,9898,9770,1959,60,21687,0,0,0,0,428,2591,3019
2018-03-15,7,3539,5095,2730,11061,10865,2244,67,24238,0,1,0,1,322,2520,2842
2018-03-15,8,3557,5133,2949,12185,11470,2336,71,26061,40,502,47,589,286,2430,2716
2018-03-15,9,3559,5112,2898,11981,11454,2302,68,25804,471,2969,552,3992,287,2486,2773
2018-03-15,10,3566,5089,2824,11547,11285,2231,64,25127,849,5004,1038,6891,346,2508,2854
2018-03-15,11,3564,5063,2743,11278,11228,2167,60,24733,935,5764,1235,7934,398,2558,2956
2018-03-15,12,3543,5023,2623,11070,11160,2088,58,24376,944,6191,1371,8506,382,2605,2987
2018-03-15,13,3520,5025,2552,10957,11013,2034,56,24059,853,6262,1369,8484,456,2563,3019
2018-03-15,14,3514,5004,2479,10842,10935,2015,54,23846,815,6247,1376,8438,524,2503,3027
2018-03-15,15,3521,4979,2408,10783,10812,2026,53,23673,743,6228,1327,8298,663,2508,3171
2018-03-15,16,3556,4963,2368,10766,10815,2083,53,23716,611,5830,1123,7564,770,2520,3290
2018-03-15,17,3587,4934,2364,10795,10927,2204,53,23978,509,4906,917,6332,836,2520,3356
2018-03-15,18,3620,4897,2393,11090,11119,2330,54,24592,323,2961,550,3834,764,2398,3162
2018-03-15,19,3745,5023,2448,11520,11212,2465,55,25252,58,507,98,663,649,2269,2918
2018-03-15,20,3982,5199,2580,12653,12190,2688,59,27590,0,0,0,0,555,2147,2702
2018-03-15,21,3964,5067,2607,12700,12256,2649,59,27664,0,0,0,0,500,2098,2598
2018-03-15,22,3827,4793,2467,12159,11762,2478,57,26456,0,0,0,0,482,2079,2561
2018-03-15,23,3678,4522,2287,11296,11001,2234,54,24585,0,0,0,0,440,2002,2442
2018-03-15,24,3481,4332,2124,10474,10183,2022,52,22730,0,0,0,0,411,1950,2361
2018-03-16,1,3329,4332,2072,9690,9737,1930,53,21410,0,0,0,0,449,1908,2357
2018-03-16,2,3242,4288,2026,9328,9346,1842,53,20569,0,0,0,0,418,1803,2221
2018-03-16,3,3193,4290,2016,9108,9131,1794,55,20088,0,0,0,0,383,1699,2082
2018-03-16,4,3186,4361,2046,9055,9064,1774,56,19949,0,0,0,0,351,1543,1894
2018-03-16,5,3247,4561,2147,9283,9304,1813,60,20460,0,0,0,0,342,1382,1724
2018-03-16,6,3409,4917,2393,9890,9933,1937,67,21828,0,0,0,0,311,1203,1514
2018-03-16,7,3626,5231,2743,11030,10993,2178,75,24276,0,2,0,2,307,1031,1338
2018-03-16,8,3635,5272,2940,12020,11374,2271,77,25742,28,531,41,600,301,903,1204
2018-03-16,9,3619,5245,2912,12034,11336,2236,71,25677,253,2850,324,3427,347,814,1161
2018-03-16,10,3593,5191,2839,12106,11168,2155,65,25495,460,4549,587,5596,392,803,1195
2018-03-16,11,3566,5125,2758,11945,11097,2044,61,25148,551,5330,722,6603,424,840,1264
2018-03-16,12,3531,5047,2635,11856,11027,1956,58,24896,581,5691,803,7075,523,956,1479
2018-03-16,13,3496,5012,2549,11575,10849,1901,56,24381,620,5716,817,7153,592,1114,1706
2018-03-16,14,3477,4977,2475,11434,10738,1898,54,24124,610,5574,771,6955,653,1316,1969
2018-03-16,15,3478,4926,2403,11009,10612,1935,53,23609,611,5264,698,6573,661,1506,2167
2018-03-16,16,3504,4878,2357,10702,10571,1992,53,23318,584,4699,664,5947,700,1680,2380
2018-03-16,17,3563,4828,2350,10703,10767,2082,54,23606,537,3852,571,4960,735,1756,2491
2018-03-16,18,3595,4778,2349,10990,10995,2208,55,24249,362,2261,346,2969,706,1722,2428
2018-03-16,19,3694,4887,2397,11404,11117,2360,56,24937,85,364,90,539,631,1675,2306
2018-03-16,20,3918,5045,2509,12158,12036,2531,59,26784,0,0,0,0,573,1571,2144
2018-03-16,21,3903,4981,2533,12329,12086,2506,59,26981,0,0,0,0,556,1608,2164
2018-03-16,22,3821,4797,2420,11886,11669,2405,58,26017,0,0,0,0,555,1662,2217
2018-03-16,23,3722,4562,2275,11182,11026,2242,55,24505,0,0,0,0,548,1728,2276
2018-03-16,24,3543,4358,2128,10407,10276,2054,53,22790,0,0,0,0,497,1844,2341
2018-03-17,1,3381,4278,2030,10116,9683,1959,52,21810,0,0,0,0,412,2094,2506
2018-03-17,2,3281,4216,1978,9687,9240,1851,52,20830,0,0,0,0,366,2164,2530
2018-03-17,3,3208,4196,1964,9406,8983,1782,53,20224,0,0,0,0,321,2160,2481
2018-03-17,4,3177,4217,1980,9288,8843,1759,53,19944,0,0,0,0,281,2105,2386
2018-03-17,5,3196,4295,2030,9352,8900,1791,56,20099,0,0,0,0,244,2036,2280
2018-03-17,6,3276,4437,2152,9619,9122,1837,59,20636,0,0,0,0,208,1945,2153
2018-03-17,7,3347,4610,2308,10137,9509,1961,65,21671,0,2,0,2,179,1837,2016
2018-03-17,8,3326,4740,2493,10606,9646,2029,69,22349,57,580,61,698,157,1713,1870
2018-03-17,9,3371,4815,2624,10696,9655,2080,66,22498,468,2987,542,3997,123,1635,1758
2018-03-17,10,3416,4822,2631,10490,9645,2049,64,22248,775,4759,936,6470,100,1544,1644
2018-03-17,11,3427,4807,2568,10082,9538,1965,61,21645,816,5412,1078,7306,81,1517,1598
2018-03-17,12,3398,4781,2459,9739,9438,1865,58,21099,814,5701,1196,7711,70,1653,1723
2018-03-17,13,3359,4761,2356,9485,9251,1793,56,20584,787,5675,1201,7663,67,1791,1858
2018-03-17,14,3335,4747,2261,9458,9035,1744,55,20292,793,5568,1168,7529,67,1984,2051
2018-03-17,15,3345,4739,2194,9495,8934,1739,55,20223,801,5390,1078,7269,67,2134,2201
2018-03-17,16,3399,4759,2166,9485,9004,1801,56,20346,766,4899,997,6662,68,2260,2328
2018-03-17,17,3465,4777,2158,9768,9355,1934,57,21114,674,3854,826,5354,83,2396,2479
2018-03-17,18,3546,4764,2202,10301,9606,2058,59,22023,449,2266,512,3227,82,2469,2551
2018-03-17,19,3640,4885,2249,10984,9936,2210,59,23189,100,399,120,619,82,2555,2637
2018-03-17,20,3847,5056,2370,11457,11029,2480,64,25030,0,0,0,0,83,2518,2601
2018-03-17,21,3846,4996,2398,11808,11159,2463,65,25495,0,0,0,0,81,2598,2679
2018-03-17,22,3757,4816,2311,11544,10907,2347,64,24862,0,0,0,0,79,2592,2671
2018-03-17,23,3677,4599,2186,11040,10460,2180,61,23741,0,0,0,0,85,2516,2601
2018-03-17,24,3527,4413,2061,10332,9864,2005,58,22259,0,0,0,0,89,2530,2619
2018-03-18,1,3401,4324,1967,9600,9423,1828,57,20908,0,0,0,0,58,2432,2490
2018-03-18,2,3310,4277,1919,9270,9186,1741,56,20253,0,0,0,0,56,2370,2426
2018-03-18,3,3267,4265,1913,9067,8910,1694,57,19727,0,0,0,0,58,2322,2380
2018-03-18,4,3245,4289,1934,9004,8758,1687,58,19507,0,0,0,0,66,2236,2302
2018-03-18,5,3248,4352,1989,9059,8745,1699,60,19563,0,0,0,0,78,2117,2195
2018-03-18,6,3293,4446,2089,9197,8997,1789,64,20047,0,0,0,0,71,1920,1991
2018-03-18,7,3394,4599,2244,9683,9271,1898,71,20922,0,2,0,2,64,1590,1654
2018-03-18,8,3338,4711,2430,10156,9387,1948,75,21566,69,688,81,838,72,1143,1215
2018-03-18,9,3343,4727,2565,10066,8984,1968,74,21092,567,3538,650,4755,49,732,781
2018-03-18,10,3361,4716,2575,9846,8751,1850,68,20515,990,5389,1103,7482,37,438,475
2018-03-18,11,3342,4673,2504,9265,8666,1700,65,19696,1107,6027,1253,8387,25,281,306
2018-03-18,12,3314,4680,2390,8764,8506,1612,60,18942,1119,6372,1347,8838,23,216,239
2018-03-18,13,3290,4643,2303,8431,8294,1541,57,18323,1081,6385,1421,8887,27,194,221
2018-03-18,14,3260,4650,2221,8316,8245,1494,56,18111,1033,6261,1365,8659,33,187,220
2018-03-18,15,3269,4663,2151,8295,8275,1504,55,18129,987,6024,1348,8359,37,191,228
2018-03-18,16,3322,4725,2113,8560,8583,1589,56,18788,889,5492,1293,7674,42,232,274
2018-03-18,17,3386,4766,2129,8829,8938,1743,58,19567,801,4535,1094,6430,57,305,362
2018-03-18,18,3412,4752,2196,9557,9305,1928,59,20848,481,2769,678,3928,55,371,426
2018-03-18,19,3509,4917,2254,10427,10082,2175,59,22742,105,449,142,696,56,466,522
2018-03-18,20,3828,5113,2409,11432,11278,2504,63,25277,0,0,0,0,53,516,569
2018-03-18,21,3863,5028,2460,11617,11436,2505,64,25622,0,0,0,0,42,501,543
2018-03-18,22,3758,4801,2342,11188,11266,2380,63,24897,0,0,0,0,41,453,494
2018-03-18,23,3678,4561,2176,10476,10990,2222,59,23747,0,0,0,0,53,332,385
2018-03-18,24,3500,4397,2023,9685,10367,2051,56,22159,0,0,0,0,70,261,331
2018-03-19,1,3363,4323,1923,9702,9115,1794,55,20665,0,0,0,0,59,112,171
2018-03-19,2,3279,4305,1891,9250,8802,1718,55,19825,0,0,0,0,56,102,158
2018-03-19,3,3245,4323,1899,9129,8655,1681,57,19522,0,0,0,0,45,101,146
2018-03-19,4,3252,4417,1943,9131,8663,1677,59,19531,0,0,0,0,43,112,155
2018-03-19,5,3314,4644,2065,9405,8987,1739,64,20196,0,0,0,0,45,108,153
2018-03-19,6,3485,5037,2334,10038,9721,1910,72,21741,0,0,0,0,48,94,142
2018-03-19,7,3714,5381,2722,11296,10828,2204,78,24406,0,4,0,4,51,94,145
2018-03-19,8,3713,5439,2948,11672,11163,2276,80,25191,91,805,113,1009,52,107,159
2018-03-19,9,3693,5407,2907,11678,10975,2205,75,24933,657,3819,854,5330,50,132,182
2018-03-19,10,3673,5366,2820,11292,10725,2074,69,24161,1104,5769,1371,8244,57,160,217
2018-03-19,11,3652,5311,2732,10695,10613,1960,65,23334,1204,6445,1566,9215,56,214,270
2018-03-19,12,3614,5250,2614,10205,10458,1861,62,22587,1224,6750,1603,9577,48,239,287
2018-03-19,13,3579,5230,2537,9876,10398,1830,60,22164,1201,6796,1584,9581,45,235,280
2018-03-19,14,3538,5197,2466,9735,10493,1844,59,22131,1180,6727,1559,9466,46,213,259
2018-03-19,15,3510,5162,2392,9749,10672,1896,58,22375,1134,6578,1506,9218,50,181,231
2018-03-19,16,3515,5149,2340,9922,10835,1975,58,22789,1021,6122,1432,8575,54,162,216
2018-03-19,17,3541,5137,2330,10254,11130,2095,59,23537,910,5141,1206,7257,67,141,208
2018-03-19,18,3595,5112,2372,10715,11303,2212,60,24290,496,3045,733,4274,48,125,173
2018-03-19,19,3741,5224,2426,11362,11546,2338,61,25307,104,472,157,733,33,117,150
2018-03-19,20,3999,5384,2558,12272,12409,2601,64,27346,0,0,0,0,24,107,131
2018-03-19,21,3975,5263,2598,12385,12353,2564,63,27365,0,0,0,0,28,95,123
2018-03-19,22,3835,4978,2459,11954,11814,2406,61,26234,0,0,0,0,36,84,120
2018-03-19,23,3694,4691,2271,11258,10973,2163,56,24450,0,0,0,0,47,111,158
2018-03-19,24,3499,4497,2101,10454,10138,1954,54,22599,0,0,0,0,45,97,142
2018-03-20,1,3318,4380,1966,9670,9510,1891,53,21124,0,0,0,0,41,95,136
2018-03-20,2,3227,4340,1919,9322,9144,1816,54,20335,0,0,0,0,45,118,163
2018-03-20,3,3181,4346,1911,9103,8936,1768,55,19862,0,0,0,0,38,122,160
2018-03-20,4,3177,4429,1936,9068,8884,1757,57,19766,0,0,0,0,29,133,162
2018-03-20,5,3241,4650,2039,9280,9010,1805,61,20156,0,0,0,0,33,122,155
2018-03-20,6,3409,5029,2295,9913,9651,1975,70,21609,0,0,0,0,33,102,135
2018-03-20,7,3609,5350,2676,11137,10729,2248,75,24189,0,4,0,4,42,95,137
2018-03-20,8,3599,5380,2880,12031,11295,2324,76,25726,51,703,63,817,38,137,175
2018-03-20,9,3575,5336,2825,12072,11303,2229,72,25676,277,2777,292,3346,39,166,205
2018-03-20,10,3555,5284,2739,11991,11276,2116,66,25450,422,3955,500,4877,42,119,161
2018-03-20,11,3539,5228,2638,11835,11314,2009,63,25221,459,4448,636,5543,52,113,165
2018-03-20,12,3510,5166,2537,11635,11176,1918,60,24790,467,4786,657,5910,47,154,201
2018-03-20,13,3478,5150,2467,11357,11113,1895,59,24424,353,4455,510,5318,64,181,245
2018-03-20,14,3466,5126,2401,11171,11102,1920,57,24250,337,4248,460,5045,98,267,365
2018-03-20,15,3471,5095,2334,11004,11131,1970,56,24161,307,3946,365,4618,133,358,491
2018-03-20,16,3503,5083,2286,10944,11093,2036,56,24129,239,3478,288,4005,180,448,628
2018-03-20,17,3544,5052,2283,11037,11106,2141,55,24340,216,2781,280,3277,242,619,861
2018-03-20,18,3626,5042,2317,11385,11218,2259,57,24919,136,1513,127,1776,248,633,881
2018-03-20,19,3722,5143,2368,11705,11443,2426,59,25633,34,253,40,327,232,540,772
2018-03-20,20,3934,5311,2485,12390,12389,2597,62,27438,0,0,0,0,220,471,691
2018-03-20,21,3921,5197,2519,12513,12374,2572,61,27521,0,0,0,0,205,525,730
2018-03-20,22,3757,4917,2384,11877,11833,2420,58,26187,0,0,0,0,187,582,769
2018-03-20,23,3600,4630,2199,10950,11006,2186,54,24195,0,0,0,0,158,583,741
2018-03-20,24,3400,4424,2032,10082,10161,1980,50,22273,0,0,0,0,147,675,822
2018-03-21,1,3241,4263,1920,9438,9390,1829,46,20704,0,0,0,0,225,754,979
2018-03-21,2,3143,4220,1870,9070,8993,1748,46,19857,0,0,0,0,214,818,1032
2018-03-21,3,3093,4231,1854,8862,8752,1696,46,19356,0,0,0,0,232,796,1028
2018-03-21,4,3071,4293,1878,8823,8669,1680,47,19219,0,0,0,0,250,811,1061
2018-03-21,5,3120,4497,1978,8991,8815,1728,50,19584,0,0,0,0,252,826,1078
2018-03-21,6,3260,4872,2225,9603,9443,1881,55,20983,0,0,0,0,242,821,1063
2018-03-21,7,3453,5186,2587,10852,10558,2137,62,23609,0,4,0,4,249,815,1064
2018-03-21,8,3462,5225,2771,11944,11095,2212,65,25316,43,588,38,669,253,719,972
2018-03-21,9,3462,5199,2737,12178,11278,2210,63,25728,241,2088,168,2497,233,613,846
2018-03-21,10,3468,5161,2665,12168,11336,2176,60,25740,370,3114,324,3808,215,574,789
2018-03-21,11,3489,5122,2589,12051,11400,2136,58,25644,409,3564,419,4392,198,545,743
2018-03-21,12,3505,5073,2501,11929,11487,2118,57,25591,417,3785,484,4686,211,579,790
2018-03-21,13,3545,5063,2443,11735,11455,2103,56,25349,371,3817,453,4641,224,625,849
2018-03-21,14,3592,5042,2384,11630,11549,2118,54,25351,346,3726,422,4494,256,725,981
2018-03-21,15,3641,5022,2337,11506,11583,2152,53,25294,327,3484,347,4158,284,756,1040
2018-03-21,16,3730,5010,2300,11398,11550,2208,54,25210,280,3173,306,3759,331,764,1095
2018-03-21,17,3755,4973,2293,11435,11654,2275,52,25416,267,2608,282,3157,366,751,1117
2018-03-21,18,3783,4957,2321,11483,11616,2345,53,25498,146,1419,146,1711,365,672,1037
2018-03-21,19,3839,5046,2360,11667,11776,2440,54,25936,39,222,50,311,365,628,993
2018-03-21,20,4045,5192,2446,12247,12563,2653,58,27520,0,1,0,1,383,586,969
2018-03-21,21,4021,5070,2466,12363,12526,2604,57,27549,0,0,0,0,405,584,989
2018-03-21,22,3834,4799,2334,11802,11934,2416,54,26205,0,0,0,0,408,569,977
2018-03-21,23,3563,4514,2150,10888,11030,2178,50,24145,0,0,0,0,416,567,983
2018-03-21,24,3339,4306,1984,10040,10143,1972,46,22201,0,0,0,0,431,631,1062
2018-03-22,1,3181,4197,1909,9624,9472,1875,44,21014,0,0,0,0,381,616,997
2018-03-22,2,3077,4156,1853,9274,9159,1796,43,20273,0,0,0,0,374,656,1030
2018-03-22,3,3016,4137,1829,9062,8904,1733,43,19743,0,0,0,0,369,698,1067
2018-03-22,4,2998,4202,1840,8996,8808,1709,44,19557,0,0,0,0,362,824,1186
2018-03-22,5,3042,4398,1926,9133,9009,1754,47,19943,0,0,0,0,351,865,1216
2018-03-22,6,3168,4765,2155,9563,9633,1908,52,21156,0,0,0,0,387,906,1293
2018-03-22,7,3361,5080,2496,10703,10549,2205,58,23516,0,3,0,3,443,882,1325
2018-03-22,8,3394,5140,2687,11794,11033,2350,60,25237,34,430,44,508,502,936,1438
2018-03-22,9,3427,5145,2683,11973,11172,2392,60,25597,181,1319,192,1692,511,1006,1517
2018-03-22,10,3468,5132,2648,11981,11242,2399,58,25680,332,2052,365,2749,603,1084,1687
2018-03-22,11,3527,5115,2605,11938,11388,2360,55,25742,380,2374,494,3248,703,1151,1854
2018-03-22,12,3557,5091,2556,11890,11420,2311,54,25675,388,2741,559,3688,701,1225,1926
2018-03-22,13,3560,5109,2529,11780,11450,2272,53,25555,477,3016,703,4196,712,1322,2034
2018-03-22,14,3563,5111,2494,11697,11445,2236,51,25429,529,2960,679,4168,738,1397,2135
2018-03-22,15,3585,5100,2449,11638,11437,2218,50,25343,533,2819,621,3973,742,1478,2220
2018-03-22,16,3607,5088,2421,11553,11394,2208,49,25205,559,2867,650,4076,741,1506,2247
2018-03-22,17,3609,5032,2411,11567,11492,2246,48,25353,478,2398,567,3443,745,1477,2222
2018-03-22,18,3638,4996,2422,11729,11521,2334,49,25633,294,1450,323,2067,811,1432,2243
2018-03-22,19,3684,5072,2468,11882,11683,2479,50,26094,85,272,87,444,842,1335,2177
2018-03-22,20,3891,5207,2558,12320,12484,2613,54,27471,0,2,0,2,898,1230,2128
2018-03-22,21,3873,5072,2581,12414,12481,2558,54,27507,0,0,0,0,893,1206,2099
2018-03-22,22,3710,4796,2452,11866,11954,2403,51,26275,0,0,0,0,860,1290,2150
2018-03-22,23,3571,4505,2269,10963,11064,2180,48,24255,0,0,0,0,833,1363,2196
2018-03-22,24,3359,4293,2105,10119,10162,1980,45,22305,0,0,0,0,754,1420,2174
2018-03-23,1,3239,4151,2040,9761,9510,1863,45,21179,0,0,0,0,788,1562,2350
2018-03-23,2,3142,4095,1995,9399,9167,1778,44,20388,0,0,0,0,726,1601,2327
2018-03-23,3,3082,4086,1979,9198,8980,1726,45,19948,0,0,0,0,613,1657,2270
2018-03-23,4,3064,4152,1999,9116,8902,1706,46,19770,0,0,0,0,498,1740,2238
2018-03-23,5,3117,4346,2098,9365,9109,1753,50,20276,0,0,0,0,406,1803,2209
2018-03-23,6,3274,4696,2326,10007,9705,1891,56,21658,0,0,0,0,308,1865,2173
2018-03-23,7,3469,5008,2675,11138,10693,2138,64,24033,0,12,0,12,201,1902,2103
2018-03-23,8,3504,5098,2882,11873,10850,2234,64,25020,112,1085,129,1326,165,1886,2051
2018-03-23,9,3532,5108,2880,11787,10891,2221,61,24960,629,3803,705,5137,153,1742,1895
2018-03-23,10,3551,5094,2813,11446,10899,2162,58,24565,1016,5585,1161,7762,174,1477,1651
2018-03-23,11,3559,5069,2734,11084,10897,2085,55,24121,1101,6269,1365,8735,204,1220,1424
2018-03-23,12,3549,5019,2633,10810,10906,2012,53,23781,1129,6531,1453,9113,266,1089,1355
2018-03-23,13,3541,5004,2553,10571,10817,1964,52,23405,1080,6627,1473,9180,333,1055,1388
2018-03-23,14,3546,4982,2485,10392,10818,1970,51,23231,1070,6586,1491,9147,444,1131,1575
2018-03-23,15,3580,4952,2421,10180,10848,2000,51,23078,1051,6379,1459,8889,520,1302,1822
2018-03-23,16,3617,4914,2403,10124,10876,2065,51,23116,983,5885,1390,8258,589,1439,2028
2018-03-23,17,3658,4837,2396,10262,10846,2147,50,23305,868,4920,1142,6930,632,1600,2232
2018-03-23,18,3733,4787,2423,10639,10883,2240,51,23812,503,2957,707,4167,575,1659,2234
2018-03-23,19,3740,4854,2450,11035,11223,2310,51,24619,124,493,173,790,504,1717,2221
2018-03-23,20,3929,4982,2522,11731,12006,2531,54,26323,0,2,1,3,443,1758,2201
2018-03-23,21,3889,4908,2541,12007,12011,2517,54,26589,0,0,0,0,435,1861,2296
2018-03-23,22,3769,4723,2433,11641,11658,2403,52,25753,0,0,0,0,436,1919,2355
2018-03-23,23,3640,4492,2289,10974,11012,2215,49,24250,0,0,0,0,431,1980,2411
2018-03-23,24,3451,4285,2146,10276,10197,2025,46,22544,0,0,0,0,404,2084,2488
2018-03-24,1,3301,4176,2072,9717,9462,1907,46,21132,0,0,0,0,393,2195,2588
2018-03-24,2,3196,4124,2023,9404,9107,1817,46,20374,0,0,0,0,357,2242,2599
2018-03-24,3,3125,4110,2012,9185,8976,1760,47,19968,0,0,0,0,293,2330,2623
2018-03-24,4,3091,4132,2027,9076,8890,1729,49,19744,0,0,0,0,219,2407,2626
2018-03-24,5,3105,4213,2088,9127,8938,1736,51,19852,0,0,0,0,161,2406,2567
2018-03-24,6,3170,4357,2210,9374,9066,1770,55,20265,0,0,0,0,151,2397,2548
2018-03-24,7,3233,4506,2387,9917,9425,1865,62,21269,0,10,0,10,154,2360,2514
2018-03-24,8,3233,4645,2576,10331,9502,1935,62,21830,91,939,132,1162,160,2317,2477
2018-03-24,9,3313,4718,2704,10498,9532,1986,60,22075,478,3427,680,4585,171,2306,2477
2018-03-24,10,3386,4730,2693,10330,9519,1986,57,21892,792,5068,1090,6950,204,2280,2484
2018-03-24,11,3401,4716,2629,9961,9387,1929,54,21331,895,5733,1249,7877,234,2258,2492
2018-03-24,12,3387,4687,2522,9748,9175,1823,53,20798,907,6134,1277,8318,273,2409,2682
2018-03-24,13,3363,4659,2420,9586,9003,1746,52,20387,866,6278,1151,8295,338,2502,2840
2018-03-24,14,3374,4643,2326,9455,8825,1698,51,20029,897,6289,1102,8288,423,2588,3011
2018-03-24,15,3401,4634,2257,9267,8798,1709,50,19824,865,6195,1042,8102,491,2674,3165
2018-03-24,16,3463,4655,2224,9285,8953,1783,51,20073,733,5745,982,7460,606,2714,3320
2018-03-24,17,3510,4664,2241,9622,9220,1878,53,20773,631,4883,807,6321,752,2723,3475
2018-03-24,18,3577,4670,2283,9948,9489,2043,55,21534,353,3076,510,3939,665,2663,3328
2018-03-24,19,3626,4769,2334,10325,9816,2275,55,22471,106,601,141,848,612,2504,3116
2018-03-24,20,3817,4940,2417,11117,10755,2410,57,24340,1,1,1,3,570,2475,3045
2018-03-24,21,3804,4883,2460,11430,10936,2405,56,24828,0,0,0,0,525,2484,3009
2018-03-24,22,3703,4706,2369,11157,10639,2306,54,24157,0,0,0,0,475,2545,3020
2018-03-24,23,3608,4493,2241,10635,10162,2163,51,23010,0,0,0,0,406,2559,2965
2018-03-24,24,3450,4313,2114,10035,9562,2006,50,21653,0,0,0,0,393,2602,2995
2018-03-25,1,3294,4198,2054,9475,9232,1820,51,20578,0,0,0,0,321,2598,2919
2018-03-25,2,3195,4151,2009,9137,8876,1728,50,19791,0,0,0,0,287,2590,2877
2018-03-25,3,3140,4133,2005,8942,8750,1673,51,19416,0,0,0,0,253,2616,2869
2018-03-25,4,3114,4153,2023,8903,8643,1660,52,19258,0,0,0,0,244,2631,2875
2018-03-25,5,3112,4213,2084,8944,8644,1667,54,19308,0,0,0,0,243,2605,2848
2018-03-25,6,3156,4310,2191,9112,8753,1703,57,19625,0,0,0,0,225,2596,2821
2018-03-25,7,3228,4438,2345,9624,9047,1788,64,20522,0,14,0,14,214,2553,2767
2018-03-25,8,3197,4565,2524,9935,9030,1823,67,20855,114,1138,126,1378,206,2527,2733
2018-03-25,9,3249,4599,2667,9849,8816,1843,67,20575,581,3866,650,5097,179,2620,2799
2018-03-25,10,3310,4609,2665,9616,8720,1806,64,20206,958,5551,1061,7570,178,2645,2823
2018-03-25,11,3330,4586,2592,9232,8671,1732,61,19696,1059,6206,1223,8488,173,2682,2855
2018-03-25,12,3312,4610,2489,8969,8548,1638,58,19213,1091,6521,1364,8976,159,2764,2923
2018-03-25,13,3305,4577,2410,8790,8362,1559,56,18767,1072,6670,1361,9103,157,2832,2989
2018-03-25,14,3298,4590,2338,8680,8248,1534,56,18517,1119,6702,1389,9210,174,2921,3095
2018-03-25,15,3319,4605,2277,8656,8211,1539,55,18462,1107,6591,1371,9069,175,3011,3186
2018-03-25,16,3368,4671,2254,8886,8399,1619,56,18959,940,6222,1309,8471,179,3100,3279
2018-03-25,17,3418,4706,2255,9421,8672,1774,58,19923,835,5448,1097,7380,184,3144,3328
2018-03-25,18,3451,4715,2336,9929,9115,1952,59,21054,577,3546,682,4805,175,3221,3396
2018-03-25,19,3524,4830,2406,10331,9450,2100,59,21939,163,760,170,1093,179,3157,3336
2018-03-25,20,3820,5017,2524,11182,10632,2424,63,24301,1,4,1,6,211,3102,3313
2018-03-25,21,3846,4936,2571,11699,10928,2437,64,25128,0,0,0,0,213,3081,3294
2018-03-25,22,3722,4711,2448,11334,10647,2303,62,24345,0,0,0,0,207,3053,3260
2018-03-25,23,3628,4474,2276,10587,10186,2107,60,22940,0,0,0,0,212,3031,3243
2018-03-25,24,3445,4323,2123,9892,9550,1930,57,21429,0,0,0,0,220,3012,3232
2018-03-26,1,3263,4261,1987,9354,9093,1821,54,20322,0,0,0,0,202,2883,3085
2018-03-26,2,3178,4249,1956,9040,8939,1750,55,19783,0,0,0,0,237,2708,2945
2018-03-26,3,3141,4269,1964,8911,8802,1710,56,19479,0,0,0,0,257,2592,2849
2018-03-26,4,3144,4365,2011,8951,8808,1700,58,19517,0,0,0,0,280,2434,2714
2018-03-26,5,3208,4595,2138,9274,9137,1748,62,20220,0,0,0,0,306,2248,2554
2018-03-26,6,3381,5001,2416,9948,9892,1907,70,21816,0,0,0,0,321,2013,2334
2018-03-26,7,3597,5312,2805,11224,10923,2193,78,24419,0,16,0,16,337,1787,2124
2018-03-26,8,3603,5367,3016,12048,11302,2318,79,25747,126,1223,154,1503,344,1513,1857
2018-03-26,9,3610,5350,2982,11801,11184,2280,74,25340,642,4142,758,5542,323,1082,1405
2018-03-26,10,3608,5312,2891,11273,10911,2135,69,24388,982,5818,1186,7986,375,710,1085
2018-03-26,11,3610,5264,2797,10691,10644,2026,65,23426,1072,6396,1364,8832,396,617,1013
2018-03-26,12,3585,5207,2680,10224,10474,1932,62,22691,1101,6656,1483,9240,408,640,1048
2018-03-26,13,3562,5192,2605,9954,10300,1877,59,22191,1143,6757,1519,9419,422,740,1162
2018-03-26,14,3543,5157,2536,9886,10202,1873,58,22019,1144,6738,1548,9430,430,858,1288
2018-03-26,15,3537,5131,2471,9910,10302,1919,57,22188,1121,6613,1537,9271,412,1079,1491
2018-03-26,16,3551,5124,2424,10052,10449,1988,57,22546,1023,6246,1442,8711,390,1391,1781
2018-03-26,17,3583,5110,2410,10422,10695,2106,58,23280,914,5433,1229,7576,367,1742,2109
2018-03-26,18,3628,5104,2473,10785,10965,2237,60,24048,602,3456,808,4866,322,2023,2345
2018-03-26,19,3722,5193,2542,11358,11271,2387,61,25076,203,733,231,1167,263,2115,2378
2018-03-26,20,3970,5352,2622,12075,12157,2633,64,26929,2,3,5,10,251,2156,2407
2018-03-26,21,3953,5227,2651,12279,12184,2607,64,27134,0,0,0,0,287,2105,2392
2018-03-26,22,3801,4929,2507,11768,11756,2444,61,26029,0,0,0,0,324,1990,2314
2018-03-26,23,3644,4649,2313,10918,10896,2200,57,24071,0,0,0,0,361,1812,2173
2018-03-26,24,3446,4468,2134,10106,10086,1990,55,22236,0,0,0,0,409,1584,1993
2018-03-27,1,3288,4415,2004,9535,9597,1854,55,21041,0,0,0,0,553,1353,1906
2018-03-27,2,3206,4380,1959,9188,9252,1777,55,20272,0,0,0,0,615,1144,1759
2018-03-27,3,3166,4393,1953,8987,9075,1733,57,19852,0,0,0,0,615,879,1494
2018-03-27,4,3163,4480,1981,8982,9046,1735,59,19822,0,0,0,0,590,695,1285
2018-03-27,5,3228,4704,2091,9246,9320,1794,63,20423,0,0,0,0,573,573,1146
2018-03-27,6,3398,5102,2350,9907,10003,1980,70,21960,0,0,0,0,485,516,1001
2018-03-27,7,3568,5404,2718,11090,10969,2245,80,24384,0,24,0,24,397,498,895
2018-03-27,8,3574,5433,2909,11771,11252,2298,78,25399,197,1355,212,1764,326,498,824
2018-03-27,9,3560,5371,2860,11526,11095,2182,73,24876,876,4558,943,6377,298,497,795
2018-03-27,10,3545,5305,2758,11166,10896,2038,68,24168,1171,6211,1401,8783,296,563,859
2018-03-27,11,3532,5236,2644,10846,10762,1936,63,23607,1239,6760,1544,9543,299,667,966
2018-03-27,12,3499,5165,2544,10539,10678,1855,61,23133,1295,6937,1593,9825,274,673,947
2018-03-27,13,3468,5140,2475,10325,10641,1831,59,22856,1295,6974,1602,9871,245,644,889
2018-03-27,14,3464,5116,2424,10270,10752,1849,57,22929,1299,6966,1601,9866,217,619,836
2018-03-27,15,3471,5093,2377,10265,10897,1910,56,23128,1285,6899,1607,9791,177,569,746
2018-03-27,16,3501,5090,2340,10485,11045,1995,56,23580,1193,6606,1539,9338,142,529,671
2018-03-27,17,3531,5058,2342,10878,11190,2112,56,24236,1013,5854,1326,8193,123,573,696
2018-03-27,18,3585,5088,2384,11361,11401,2262,57,25081,844,3942,958,5744,92,657,749
2018-03-27,19,3662,5163,2427,11774,11612,2385,59,25829,287,893,293,1473,62,724,786
2018-03-27,20,3876,5329,2484,12268,12321,2590,62,27241,10,9,4,23,72,798,870
2018-03-27,21,3870,5209,2520,12485,12276,2569,62,27392,0,0,0,0,85,864,949
2018-03-27,22,3722,4923,2395,11947,11760,2412,59,26178,0,0,0,0,106,906,1012
2018-03-27,23,3572,4633,2211,11000,10978,2178,55,24211,0,0,0,0,150,925,1075
2018-03-27,24,3367,4439,2044,10124,10183,1971,51,22329,0,0,0,0,169,800,969
2018-03-28,1,3210,4298,1927,9539,9648,1849,49,21085,0,0,0,0,178,792,970
2018-03-28,2,3118,4265,1875,9177,9309,1773,48,20307,0,0,0,0,200,658,858
2018-03-28,3,3071,4259,1857,8976,9086,1725,49,19836,0,0,0,0,180,514,694
2018-03-28,4,3067,4337,1880,8956,9024,1715,51,19746,0,0,0,0,160,401,561
2018-03-28,5,3122,4545,1979,9187,9265,1770,55,20277,0,0,0,0,137,319,456
2018-03-28,6,3269,4925,2227,9810,9932,1945,62,21749,0,0,0,0,127,273,400
2018-03-28,7,3447,5220,2593,10951,10859,2188,71,24068,0,31,0,31,134,242,376
2018-03-28,8,3452,5258,2790,11546,11156,2239,70,25011,227,1484,229,1940,131,222,353
2018-03-28,9,3446,5225,2754,11269,11034,2137,66,24506,911,4767,965,6643,127,200,327
2018-03-28,10,3447,5176,2671,10906,10905,2020,62,23893,1197,6355,1415,8967,159,215,374
2018-03-28,11,3460,5124,2587,10631,10884,1934,59,23509,1249,6913,1570,9732,177,253,430
2018-03-28,12,3459,5068,2500,10358,10938,1886,58,23240,1305,7048,1613,9966,151,249,400
2018-03-28,13,3471,5056,2450,10289,11043,1881,57,23270,1318,7056,1619,9993,129,235,364
2018-03-28,14,3511,5042,2408,10436,11258,1917,56,23667,1324,7047,1618,9989,117,230,347
2018-03-28,15,3561,5028,2370,10613,11471,1982,55,24121,1310,6994,1620,9924,94,223,317
2018-03-28,16,3618,5017,2335,10897,11694,2056,54,24701,1223,6762,1586,9571,79,297,376
2018-03-28,17,3667,4980,2329,11305,11798,2169,54,25325,1063,6088,1358,8509,64,509,573
2018-03-28,18,3716,4984,2362,11807,11951,2299,55,26111,887,4244,1021,6152,46,759,805
2018-03-28,19,3763,5050,2399,12211,12108,2392,56,26767,302,991,322,1615,34,1045,1079
2018-03-28,20,3966,5219,2447,12636,12707,2573,59,27974,12,16,9,37,43,1312,1355
2018-03-28,21,3955,5114,2482,12695,12626,2554,58,27933,0,0,0,0,57,1389,1446
2018-03-28,22,3748,4832,2367,11980,12061,2398,55,26493,0,0,0,0,91,1419,1510
2018-03-28,23,3500,4553,2187,10986,11146,2168,51,24351,0,0,0,0,165,1411,1576
2018-03-28,24,3287,4356,2018,10143,10291,1968,47,22449,0,0,0,0,177,1235,1412
2018-03-29,1,3153,4239,1892,9663,9725,1859,45,21291,0,0,0,0,141,968,1109
2018-03-29,2,3059,4200,1847,9279,9384,1777,44,20484,0,0,0,0,149,758,907
2018-03-29,3,3005,4212,1831,9073,9143,1734,45,19994,0,0,0,0,147,604,751
2018-03-29,4,2992,4293,1854,9018,9068,1716,46,19848,0,0,0,0,141,478,619
2018-03-29,5,3047,4512,1953,9227,9306,1767,49,20348,0,0,0,0,147,419,566
2018-03-29,6,3179,4896,2202,9785,9922,1909,54,21670,0,0,0,0,132,353,485
2018-03-29,7,3367,5181,2568,10776,10804,2148,61,23789,0,34,1,35,125,287,412
2018-03-29,8,3385,5226,2767,11265,11090,2227,62,24644,234,1533,259,2026,116,233,349
2018-03-29,9,3411,5184,2717,11110,10982,2153,61,24306,898,4775,986,6659,106,150,256
2018-03-29,10,3447,5138,2635,10834,10907,2056,59,23856,1148,6317,1393,8858,114,130,244
2018-03-29,11,3493,5086,2545,10530,10959,1976,57,23522,1225,6875,1530,9630,121,156,277
2018-03-29,12,3511,5019,2446,10304,11051,1940,56,23352,1275,7020,1579,9874,94,147,241
2018-03-29,13,3540,5003,2391,10253,11174,1915,56,23398,1267,7036,1588,9891,70,134,204
2018-03-29,14,3586,4985,2348,10396,11420,1947,55,23818,1268,7024,1589,9881,54,121,175
2018-03-29,15,3621,4965,2299,10590,11647,1997,54,24288,1248,6950,1585,9783,35,119,154
2018-03-29,16,3661,4952,2265,10846,11743,2044,54,24687,1214,6683,1550,9447,24,150,174
2018-03-29,17,3687,4907,2278,11379,12030,2141,55,25605,1013,5980,1364,8357,17,240,257
2018-03-29,18,3727,4911,2287,11920,12396,2280,55,26651,821,4153,975,5949,15,356,371
2018-03-29,19,3743,4977,2308,12358,12666,2443,56,27524,278,1010,290,1578,18,492,510
2018-03-29,20,3915,5153,2359,12818,13235,2620,58,28731,12,13,5,30,48,606,654
2018-03-29,21,3900,5047,2382,12911,13122,2593,57,28683,0,0,0,0,65,627,692
2018-03-29,22,3720,4780,2275,12207,12515,2435,54,27210,0,0,0,0,79,629,708
2018-03-29,23,3471,4509,2108,11208,11523,2203,49,24983,0,0,0,0,106,588,694
2018-03-29,24,3256,4318,1946,10301,10561,2004,46,22912,0,0,0,0,111,546,657
2018-03-30,1,3129,4206,1791,9782,9912,1876,44,21613,0,0,0,0,59,379,438
2018-03-30,2,3020,4166,1753,9421,9439,1790,43,20692,0,0,0,0,59,309,368
2018-03-30,3,2953,4154,1740,9166,9156,1749,43,20114,0,0,0,0,52,281,333
2018-03-30,4,2932,4222,1763,9000,9021,1727,44,19792,0,0,0,0,45,244,289
2018-03-30,5,2972,4401,1863,9097,9161,1772,46,20076,0,0,0,0,45,200,245
2018-03-30,6,3061,4712,2111,9627,9761,1904,52,21344,0,0,0,0,39,167,206
2018-03-30,7,3194,4942,2448,10475,10580,2137,57,23248,1,53,3,57,38,128,166
2018-03-30,8,3211,5051,2615,10950,10890,2191,57,24088,221,1581,270,2072,37,110,147
2018-03-30,9,3294,5051,2578,11060,10849,2140,57,24105,828,4668,986,6482,28,75,103
2018-03-30,10,3398,4995,2469,10881,10791,2070,54,23796,1068,6161,1420,8649,25,72,97
2018-03-30,11,3495,4932,2368,10527,10882,1989,52,23450,1113,6723,1556,9392,19,70,89
2018-03-30,12,3554,4849,2250,10313,10945,1939,52,23249,1133,6913,1614,9660,14,85,99
2018-03-30,13,3590,4836,2181,10299,11078,1912,54,23343,1084,6905,1595,9584,14,108,122
2018-03-30,14,3645,4811,2133,10337,11333,1952,54,23676,1061,6861,1593,9515,14,145,159
2018-03-30,15,3724,4795,2079,10465,11595,2000,55,24115,1069,6765,1586,9420,14,198,212
2018-03-30,16,3795,4770,2054,10729,11869,2074,56,24728,1046,6378,1493,8917,15,300,315
2018-03-30,17,3870,4736,2045,11119,12107,2181,57,25463,928,5561,1280,7769,17,510,527
2018-03-30,18,3864,4740,2037,11522,12286,2293,59,26160,663,3643,831,5137,19,700,719
2018-03-30,19,3840,4739,2034,11843,12409,2441,57,26750,223,777,231,1231,21,929,950
2018-03-30,20,3994,4902,2073,12472,12852,2598,57,27979,16,13,4,33,27,1200,1227
2018-03-30,21,3956,4819,2103,12594,12716,2568,56,27933,0,0,0,0,31,1254,1285
2018-03-30,22,3817,4624,2029,12008,12253,2431,52,26745,0,0,0,0,42,1255,1297
2018-03-30,23,3532,4403,1895,11173,11560,2225,49,25007,0,0,0,0,64,1199,1263
2018-03-30,24,3300,4204,1779,10340,10692,2033,45,23110,0,0,0,0,69,1116,1185
2018-03-31,1,3153,4100,1754,9668,9878,1878,43,21467,0,0,0,0,72,595,667
2018-03-31,2,3040,4055,1709,9205,9336,1778,41,20360,0,0,0,0,79,523,602
2018-03-31,3,2968,4049,1686,8944,9000,1716,41,19701,0,0,0,0,77,473,550
2018-03-31,4,2936,4078,1692,8801,8823,1685,41,19350,0,0,0,0,74,450,524
2018-03-31,5,2946,4166,1738,8797,8834,1695,43,19369,0,0,0,0,70,454,524
2018-03-31,6,2989,4311,1847,8983,9055,1742,45,19825,0,0,0,0,72,463,535
2018-03-31,7,3018,4430,1999,9381,9292,1833,49,20556,2,44,2,48,70,461,531
2018-03-31,8,3025,4566,2163,9596,9330,1871,52,20849,171,1354,232,1757,67,477,544
2018-03-31,9,3142,4623,2264,9734,9431,1892,52,21109,657,3833,792,5282,56,430,486
2018-03-31,10,3324,4621,2256,9680,9609,1878,50,21218,897,5105,1206,7208,46,345,391
2018-03-31,11,3443,4591,2197,9502,9745,1818,50,21114,957,5596,1361,7914,33,288,321
2018-03-31,12,3496,4541,2109,9296,9801,1752,51,20900,1000,5969,1431,8400,29,374,403
2018-03-31,13,3544,4505,2029,9195,9903,1737,52,20886,1023,6110,1470,8603,36,501,537
2018-03-31,14,3598,4483,1966,9266,10024,1726,53,21069,1016,6033,1466,8515,42,688,730
2018-03-31,15,3670,4481,1916,9429,10260,1752,55,21496,1033,5803,1456,8292,57,984,1041
2018-03-31,16,3731,4510,1894,9703,10513,1824,55,22095,1000,5331,1377,7708,79,1348,1427
2018-03-31,17,3772,4517,1913,10045,10700,1947,57,22750,887,4393,1209,6489,118,1773,1891
2018-03-31,18,3790,4571,1915,10520,10860,2112,57,23549,652,2770,785,4207,168,1903,2071
2018-03-31,19,3811,4620,1949,10961,10994,2249,57,24260,241,673,227,1141,217,1943,2160
2018-03-31,20,3940,4792,2003,11427,11518,2452,56,25453,21,23,7,51,285,2018,2303
2018-03-31,21,3914,4723,2044,11679,11573,2440,55,25747,0,0,0,0,324,2154,2478
2018-03-31,22,3778,4545,1979,11311,11229,2321,52,24912,0,0,0,0,344,2243,2587
2018-03-31,23,3566,4331,1865,10655,10638,2151,48,23492,0,0,0,0,367,2295,2662
2018-03-31,24,3348,4141,1743,9826,9925,1979,45,21775,0,0,0,0,408,2367,2775
2018-04-01,1,3224,4040,1631,9393,9201,1827,43,20464,0,0,0,0,415,2598,3013
2018-04-01,2,3076,3981,1575,8950,8798,1733,41,19521,0,0,0,0,437,2637,3074
2018-04-01,3,2984,3960,1564,8651,8495,1666,40,18852,0,0,0,0,425,2608,3033
2018-04-01,4,2915,3979,1590,8487,8305,1630,40,18463,0,0,0,0,382,2531,2913
2018-04-01,5,2899,4045,1653,8486,8280,1641,41,18449,0,0,0,0,329,2446,2775
2018-04-01,6,2959,4136,1757,8631,8415,1684,44,18774,0,0,0,0,300,2299,2599
2018-04-01,7,2957,4208,1923,8883,8541,1726,47,19197,1,47,1,49,275,2136,2411
2018-04-01,8,2957,4357,2095,8874,8315,1715,50,18954,211,1374,230,1815,250,1977,2227
2018-04-01,9,3110,4419,2220,9067,8553,1710,53,19383,791,3892,846,5529,226,1744,1970
2018-04-01,10,3245,4413,2217,9056,8544,1664,53,19317,1068,5127,1268,7463,186,1474,1660
2018-04-01,11,3356,4369,2127,8930,8483,1622,54,19088,1132,5672,1458,8262,157,1168,1325
2018-04-01,12,3425,4387,2032,8777,8470,1547,54,18848,1162,5878,1522,8562,130,1154,1284
2018-04-01,13,3507,4353,1950,8808,8505,1519,55,18887,1166,5928,1571,8665,128,1240,1368
2018-04-01,14,3618,4349,1868,8942,8609,1503,56,19110,1162,5829,1570,8561,141,1456,1597
2018-04-01,15,3709,4367,1810,9182,8777,1542,57,19557,1156,5691,1542,8389,211,1910,2121
2018-04-01,16,3774,4394,1777,9501,9101,1624,58,20284,1114,5301,1439,7854,323,2333,2656
2018-04-01,17,3841,4391,1792,9890,9430,1756,60,21136,1009,4538,1261,6808,499,2705,3204
2018-04-01,18,3789,4410,1817,10283,9632,1948,58,21921,766,2902,832,4500,636,2773,3409
2018-04-01,19,3760,4479,1872,10694,9852,2120,57,22723,306,771,261,1338,729,2817,3546
2018-04-01,20,3915,4728,2002,11221,10657,2378,57,24313,23,32,9,64,841,2805,3646
2018-04-01,21,3929,4723,2119,11534,10979,2392,56,24961,0,0,0,0,871,2845,3716
2018-04-01,22,3789,4514,2041,11113,10657,2265,53,24087,0,0,0,0,912,2870,3782
2018-04-01,23,3536,4268,1878,10384,9993,2072,48,22497,0,0,0,0,951,2872,3823
2018-04-01,24,3298,4106,1739,9620,9326,1893,45,20883,0,0,0,0,957,2901,3858
2018-04-02,1,3210,3989,1739,8920,8992,1767,42,19720,0,0,0,0,697,3043,3740
2018-04-02,2,3090,3958,1715,8599,8734,1700,41,19073,0,0,0,0,619,3053,3672
2018-04-02,3,3001,3965,1717,8422,8559,1661,41,18682,0,0,0,0,567,3041,3608
2018-04-02,4,2962,4045,1759,8412,8530,1645,41,18629,0,0,0,0,530,2998,3528
2018-04-02,5,3005,4256,1881,8679,8803,1692,43,19218,0,0,0,0,492,2982,3474
2018-04-02,6,3154,4630,2133,9314,9495,1840,48,20697,0,0,0,0,458,2993,3451
2018-04-02,7,3323,4894,2511,10370,10468,2077,52,22966,1,59,3,63,342,2996,3338
2018-04-02,8,3382,4995,2732,10996,10851,2171,55,24072,228,1565,263,2056,312,2955,3267
2018-04-02,9,3495,5047,2714,10981,10661,2163,56,23860,820,4476,961,6257,278,3040,3318
2018-04-02,10,3600,5055,2639,10756,10556,2103,55,23470,1006,5882,1344,8232,282,3039,3321
2018-04-02,11,3700,5048,2564,10462,10540,2025,55,23083,1054,6463,1493,9010,329,3020,3349
2018-04-02,12,3759,5036,2475,10215,10507,1958,56,22736,1067,6702,1525,9294,311,3155,3466
2018-04-02,13,3805,5047,2421,10155,10542,1922,57,22676,1061,6783,1526,9370,291,3263,3554
2018-04-02,14,3858,5024,2364,10243,10689,1927,58,22916,1013,6724,1487,9224,276,3363,3639
2018-04-02,15,3903,5010,2294,10461,10885,1968,59,23373,1024,6469,1448,8941,246,3463,3709
2018-04-02,16,3929,5017,2265,10683,11029,2023,60,23794,986,5908,1347,8241,222,3481,3703
2018-04-02,17,3992,5016,2252,11021,11259,2122,61,24463,900,4978,1150,7028,195,3441,3636
2018-04-02,18,3934,4969,2282,11332,11380,2201,60,24973,679,3143,789,4611,150,3372,3522
2018-04-02,19,3926,5020,2340,11646,11625,2287,58,25615,257,803,252,1312,106,3312,3418
2018-04-02,20,4135,5204,2432,12029,12195,2531,58,26814,20,31,9,60,93,3263,3356
2018-04-02,21,4131,5094,2510,12245,12292,2553,58,27147,0,0,0,0,100,3235,3335
2018-04-02,22,3945,4803,2390,11678,11778,2379,54,25889,0,0,0,0,113,3180,3293
2018-04-02,23,3650,4519,2197,10785,10834,2142,48,23809,0,0,0,0,142,3122,3264
2018-04-02,24,3369,4343,2020,10031,10088,1936,45,22099,0,0,0,0,160,3026,3186
2018-04-03,1,3268,4235,1925,9336,9278,1856,44,20515,0,0,0,0,195,2912,3107
2018-04-03,2,3148,4200,1885,8930,8932,1777,43,19682,0,0,0,0,201,2688,2889
2018-04-03,3,3078,4211,1881,8717,8720,1734,43,19213,0,0,0,0,191,2367,2558
2018-04-03,4,3056,4298,1920,8676,8653,1718,43,19090,0,0,0,0,188,1980,2168
2018-04-03,5,3101,4534,2034,8912,8888,1760,45,19606,0,0,0,0,188,1617,1805
2018-04-03,6,3224,4907,2312,9558,9549,1898,50,21055,0,0,0,0,154,1157,1311
2018-04-03,7,3375,5142,2710,10665,10408,2132,54,23260,2,58,2,62,116,701,817
2018-04-03,8,3422,5181,2886,11366,10867,2216,57,24506,247,1602,262,2111,93,405,498
2018-04-03,9,3458,5147,2819,11189,10775,2169,58,24191,843,4486,935,6264,77,269,346
2018-04-03,10,3494,5091,2697,10781,10658,2066,58,23563,1089,5821,1360,8270,65,230,295
2018-04-03,11,3523,5030,2562,10436,10590,1951,57,23034,1143,6418,1518,9079,53,205,258
2018-04-03,12,3513,4964,2441,10165,10556,1879,57,22657,1168,6620,1577,9365,48,178,226
2018-04-03,13,3507,4930,2367,10092,10463,1857,57,22470,1173,6625,1603,9401,54,155,209
2018-04-03,14,3535,4870,2293,10111,10702,1870,58,22741,1162,6463,1592,9217,66,134,200
2018-04-03,15,3568,4828,2235,10251,10878,1916,58,23102,1148,6413,1592,9153,91,149,240
2018-04-03,16,3619,4823,2203,10527,11082,1986,59,23653,1098,6056,1524,8678,124,221,345
2018-04-03,17,3669,4825,2216,10905,11305,2104,60,24375,972,4946,1309,7227,179,420,599
2018-04-03,18,3702,4802,2252,11343,11403,2246,59,25051,745,3204,916,4865,216,616,832
2018-04-03,19,3689,4882,2293,11688,11762,2403,58,25911,270,889,294,1453,267,826,1093
2018-04-03,20,3909,5108,2356,12148,12242,2583,59,27032,23,40,9,72,333,1065,1398
2018-04-03,21,3943,5026,2443,12366,12216,2594,60,27235,0,0,0,0,373,1100,1473
2018-04-03,22,3769,4740,2331,11819,11596,2429,56,25899,0,0,0,0,411,1111,1522
2018-04-03,23,3552,4461,2141,10851,10693,2200,50,23795,0,0,0,0,430,1089,1519
2018-04-03,24,3336,4278,1974,9994,9863,1997,46,21901,0,0,0,0,433,1136,1569
2018-04-04,1,3177,4236,1886,9512,9471,1860,44,20886,0,0,0,0,418,1052,1470
2018-04-04,2,3072,4192,1839,9092,9085,1778,43,19998,0,0,0,0,402,1062,1464
2018-04-04,3,3009,4198,1824,8886,8851,1737,42,19516,0,0,0,0,377,1042,1419
2018-04-04,4,2987,4266,1847,8837,8780,1715,43,19374,0,0,0,0,362,1027,1389
2018-04-04,5,3034,4475,1945,9038,8995,1756,45,19834,0,0,0,0,342,1026,1368
2018-04-04,6,3180,4851,2200,9636,9623,1885,50,21194,0,0,0,0,328,908,1236
2018-04-04,7,3315,5074,2547,10683,10491,2116,55,23345,1,60,1,62,305,778,1083
2018-04-04,8,3352,5116,2726,11235,10795,2229,58,24317,185,1566,256,2007,278,682,960
2018-04-04,9,3391,5112,2678,11232,10685,2204,58,24179,648,4181,870,5699,260,537,797
2018-04-04,10,3432,5063,2586,10986,10566,2076,57,23686,895,5392,1297,7584,225,382,607
2018-04-04,11,3488,5008,2495,10738,10625,1979,57,23399,970,5880,1474,8324,180,286,466
2018-04-04,12,3524,4956,2408,10569,10717,1920,58,23264,1003,6301,1516,8820,155,384,539
2018-04-04,13,3590,4942,2359,10515,10846,1904,59,23325,1012,6358,1567,8937,158,533,691
2018-04-04,14,3697,4920,2318,10637,11101,1943,61,23742,993,6286,1527,8806,178,731,909
2018-04-04,15,3791,4908,2278,10820,11296,1987,62,24165,983,6101,1519,8603,254,1027,1281
2018-04-04,16,3890,4914,2251,11076,11547,2054,63,24739,938,5647,1443,8028,328,1410,1738
2018-04-04,17,4000,4903,2253,11327,11835,2160,65,25387,812,4703,1250,6765,425,1828,2253
2018-04-04,18,3981,4876,2277,11596,11985,2287,63,25932,579,3053,841,4473,433,1960,2393
2018-04-04,19,3974,4920,2309,11847,12051,2353,62,26312,209,796,271,1276,439,2066,2505
2018-04-04,20,4162,5108,2356,12214,12502,2549,62,27327,19,25,12,56,467,2133,2600
2018-04-04,21,4160,5033,2409,12482,12557,2525,61,27624,0,0,0,0,444,2211,2655
2018-04-04,22,3956,4755,2299,11940,11943,2410,56,26350,0,0,0,0,422,2250,2672
2018-04-04,23,3637,4461,2105,11001,10967,2196,50,24215,0,0,0,0,398,2304,2702
2018-04-04,24,3369,4262,1922,10117,10087,1994,46,22244,0,0,0,0,446,2349,2795
2018-04-05,1,3229,4150,1805,9669,9596,1869,45,21179,0,0,0,0,556,2327,2883
2018-04-05,2,3125,4097,1747,9268,9255,1789,43,20356,0,0,0,0,564,2309,2873
2018-04-05,3,3056,4098,1723,9068,9032,1748,43,19890,0,0,0,0,592,2367,2959
2018-04-05,4,3030,4160,1740,9017,8907,1731,43,19698,0,0,0,0,591,2389,2980
2018-04-05,5,3071,4367,1828,9250,9104,1774,45,20173,0,0,0,0,578,2397,2975
2018-04-05,6,3184,4725,2062,9839,9795,1904,50,21588,0,0,0,0,560,2337,2897
2018-04-05,7,3317,4953,2420,10877,10643,2133,55,23707,3,81,5,89,533,2266,2799
2018-04-05,8,3392,5037,2594,11469,10898,2225,57,24650,204,1543,294,2041,509,2165,2674
2018-04-05,9,3500,5054,2573,11536,11052,2183,58,24829,655,4119,902,5676,407,2075,2482
2018-04-05,10,3610,5045,2517,11426,11215,2100,58,24800,860,5360,1261,7481,306,1970,2276
2018-04-05,11,3708,5028,2451,11184,11162,2008,60,24413,917,5925,1399,8241,221,1897,2118
2018-04-05,12,3776,5008,2391,10975,10937,1895,61,23868,918,6226,1463,8607,168,2051,2219
2018-04-05,13,3827,5017,2360,10884,10892,1852,63,23691,885,6289,1459,8633,152,2220,2372
2018-04-05,14,3915,5000,2318,10854,11053,1854,64,23825,848,6217,1436,8501,144,2369,2513
2018-04-05,15,3992,4991,2274,10912,11243,1884,65,24105,839,6098,1364,8301,156,2615,2771
2018-04-05,16,4079,4989,2244,11014,11301,1932,66,24314,757,5640,1258,7655,160,2859,3019
2018-04-05,17,4176,4956,2240,11272,11441,2031,67,24811,639,4675,989,6303,202,3038,3240
2018-04-05,18,4137,4912,2250,11401,11596,2197,65,25259,465,2775,672,3912,203,3096,3299
2018-04-05,19,4117,4942,2280,11611,11805,2365,63,25844,176,669,212,1057,190,3051,3241
2018-04-05,20,4280,5120,2338,12070,12455,2564,63,27152,10,20,4,34,180,3022,3202
2018-04-05,21,4273,5023,2403,12378,12606,2556,62,27603,0,0,0,0,116,3039,3155
2018-04-05,22,4083,4752,2293,11896,12113,2408,58,26475,0,0,0,0,78,3034,3112
2018-04-05,23,3771,4461,2103,11029,11199,2188,52,24468,0,0,0,0,57,3032,3089
2018-04-05,24,3513,4256,1919,10231,10310,1993,48,22582,0,0,0,0,59,3054,3113
2018-04-06,1,3337,4156,1770,9707,9674,1846,45,21272,0,0,0,0,73,3000,3073
2018-04-06,2,3204,4099,1714,9312,9271,1759,43,20385,0,0,0,0,68,2977,3045
2018-04-06,3,3121,4088,1690,9087,9069,1707,43,19906,0,0,0,0,73,2957,3030
2018-04-06,4,3073,4144,1707,9022,8990,1687,43,19742,0,0,0,0,85,2922,3007
2018-04-06,5,3083,4330,1798,9215,9191,1724,44,20174,0,0,0,0,113,2866,2979
2018-04-06,6,3214,4656,2021,9818,9805,1862,48,21534,0,0,0,0,144,2779,2923
2018-04-06,7,3354,4888,2349,10885,10672,2079,52,23688,1,83,5,89,187,2629,2816
2018-04-06,8,3457,5001,2533,11680,11113,2176,55,25023,94,1367,205,1666,241,2563,2804
2018-04-06,9,3584,5051,2528,11947,11250,2182,55,25434,280,3460,572,4312,257,2479,2736
2018-04-06,10,3718,5054,2473,11954,11357,2131,56,25498,440,4409,877,5726,249,2472,2721
2018-04-06,11,3832,5047,2396,11864,11425,2065,58,25412,479,4944,992,6415,253,2482,2735
2018-04-06,12,3928,5021,2316,11667,11515,1998,59,25238,509,5327,1004,6840,263,2700,2963
2018-04-06,13,4008,5014,2261,11439,11528,1973,60,25001,485,5342,859,6686,264,2872,3136
2018-04-06,14,4096,4986,2216,11324,11652,1995,62,25033,477,5278,828,6583,275,3017,3292
2018-04-06,15,4180,4963,2162,11177,11710,2031,63,24981,482,4962,741,6185,257,3107,3364
2018-04-06,16,4257,4933,2131,11114,11668,2083,64,24928,428,4351,630,5409,260,3140,3400
2018-04-06,17,4312,4872,2126,11295,11722,2163,63,25243,357,3518,523,4398,305,3126,3431
2018-04-06,18,4303,4801,2128,11432,11706,2239,63,25440,231,2083,278,2592,300,3117,3417
2018-04-06,19,4242,4812,2138,11507,11678,2284,61,25530,81,494,89,664,287,3089,3376
2018-04-06,20,4386,4977,2166,11860,12174,2465,61,26560,2,11,1,14,286,3052,3338
2018-04-06,21,4359,4935,2217,12134,12337,2484,60,27015,0,0,0,0,305,3008,3313
2018-04-06,22,4185,4733,2128,11752,11810,2357,56,25974,0,0,0,0,308,2959,3267
2018-04-06,23,3920,4479,1983,11065,11112,2174,51,24401,0,0,0,0,320,2929,3249
2018-04-06,24,3683,4263,1824,10303,10312,1991,47,22653,0,0,0,0,338,2900,3238
2018-04-07,1,3590,4089,1754,9610,9674,1854,45,21184,0,0,0,0,334,2928,3262
2018-04-07,2,3432,4027,1691,9175,9179,1755,43,20153,0,0,0,0,352,2895,3247
2018-04-07,3,3325,4013,1655,8906,8847,1699,43,19495,0,0,0,0,381,2854,3235
2018-04-07,4,3251,4026,1650,8724,8701,1668,43,19136,0,0,0,0,498,2824,3322
2018-04-07,5,3212,4106,1687,8773,8729,1682,43,19227,0,0,0,0,644,2722,3366
2018-04-07,6,3246,4233,1777,9010,8922,1733,46,19712,0,0,0,0,669,2626,3295
2018-04-07,7,3253,4297,1912,9535,9137,1841,49,20562,2,111,6,119,703,2560,3263
2018-04-07,8,3322,4460,2062,10145,9475,1915,51,21585,80,1414,124,1618,726,2500,3226
2018-04-07,9,3530,4578,2189,10543,9713,1980,53,22289,258,3595,355,4208,684,2539,3223
2018-04-07,10,3737,4596,2224,10582,9867,2001,55,22505,516,4738,587,5841,603,2640,3243
2018-04-07,11,3915,4582,2196,10400,9951,1974,57,22381,634,5256,674,6564,524,2692,3216
2018-04-07,12,4048,4556,2151,10177,9943,1924,58,22102,752,5442,764,6958,545,2921,3466
2018-04-07,13,4164,4527,2112,9992,9988,1895,60,21935,948,5581,962,7491,564,3098,3662
2018-04-07,14,4259,4504,2065,9707,10071,1867,62,21707,975,5492,1001,7468,594,3221,3815
2018-04-07,15,4393,4504,2027,9498,10169,1870,63,21600,991,5422,1054,7467,614,3300,3914
2018-04-07,16,4509,4542,2015,9366,10349,1928,63,21706,1020,5124,1057,7201,629,3333,3962
2018-04-07,17,4562,4569,2028,9462,10481,2021,63,22028,829,4326,928,6083,638,3311,3949
2018-04-07,18,4542,4558,2035,9748,10514,2136,62,22460,606,2845,618,4069,618,3247,3865
2018-04-07,19,4482,4598,2052,10212,10656,2235,58,23161,254,720,194,1168,560,3155,3715
2018-04-07,20,4567,4799,2099,10783,11125,2412,56,24376,6,22,3,31,525,3029,3554
2018-04-07,21,4506,4767,2182,11111,11401,2430,56,24998,0,0,0,0,487,2986,3473
2018-04-07,22,4303,4581,2107,10846,10970,2309,53,24178,0,0,0,0,447,2929,3376
2018-04-07,23,4047,4353,1963,10345,10416,2132,49,22943,0,0,0,0,439,2869,3308
2018-04-07,24,3796,4157,1809,9763,9771,1963,45,21543,0,0,0,0,461,2870,3331
2018-04-08,1,3604,4063,1676,9077,9073,1836,43,20030,0,0,0,0,408,2797,3205
2018-04-08,2,3448,4006,1622,8689,8679,1738,42,19148,0,0,0,0,451,2798,3249
2018-04-08,3,3328,3988,1601,8454,8386,1680,41,18562,0,0,0,0,426,2762,3188
2018-04-08,4,3248,4002,1609,8373,8214,1655,41,18283,0,0,0,0,379,2697,3076
2018-04-08,5,3195,4053,1655,8430,8183,1651,42,18305,0,0,0,0,317,2645,2962
2018-04-08,6,3234,4131,1741,8593,8310,1685,43,18631,0,0,0,0,283,2623,2906
2018-04-08,7,3175,4176,1874,8887,8343,1734,47,19011,9,157,15,181,258,2501,2759
2018-04-08,8,3218,4329,2018,9005,8243,1748,48,19044,295,2016,318,2629,232,2372,2604
2018-04-08,9,3365,4411,2151,9068,8355,1753,50,19226,842,4942,918,6702,224,2083,2307
2018-04-08,10,3501,4451,2186,8849,8343,1739,51,18982,1171,6213,1308,8692,195,1651,1846
2018-04-08,11,3600,4449,2149,8600,8402,1661,51,18714,1270,6744,1460,9474,173,1171,1344
2018-04-08,12,3639,4499,2090,8403,8479,1603,51,18536,1315,6959,1553,9827,143,1100,1243
2018-04-08,13,3661,4484,2045,8236,8592,1542,50,18420,1310,6973,1609,9892,125,1096,1221
2018-04-08,14,3671,4492,1995,8179,8756,1534,49,18518,1302,6964,1615,9881,112,1147,1259
2018-04-08,15,3671,4517,1957,8260,9113,1565,49,18987,1297,6872,1613,9782,101,1475,1576
2018-04-08,16,3688,4589,1947,8516,9495,1631,50,19692,1234,6462,1553,9249,93,1748,1841
2018-04-08,17,3723,4632,1973,8961,9971,1806,51,20790,1084,5619,1362,8065,97,1972,2069
2018-04-08,18,3726,4605,2021,9476,10288,2025,53,21841,838,3764,944,5546,98,2113,2211
2018-04-08,19,3765,4651,2055,10033,10506,2224,52,22814,329,964,295,1588,131,2218,2349
2018-04-08,20,3934,4883,2133,10624,11051,2418,52,24145,10,31,9,50,168,2252,2420
2018-04-08,21,3986,4843,2237,11154,11265,2450,53,24921,0,0,0,0,178,2131,2309
2018-04-08,22,3812,4608,2143,10819,10778,2300,50,23946,0,0,0,0,180,1986,2166
2018-04-08,23,3558,4353,1968,10098,9991,2093,44,22226,0,0,0,0,189,1831,2020
2018-04-08,24,3354,4191,1804,9400,9241,1959,41,20641,0,0,0,0,183,1581,1764
2018-04-09,1,3156,4094,1704,8925,9051,1786,42,19804,0,0,0,0,228,1446,1674
2018-04-09,2,3059,4066,1671,8643,8714,1713,41,19111,0,0,0,0,266,1053,1319
2018-04-09,3,2995,4079,1671,8506,8529,1672,41,18747,0,0,0,0,214,760,974
2018-04-09,4,2974,4174,1715,8546,8496,1656,42,18741,0,0,0,0,191,531,722
2018-04-09,5,3018,4400,1837,8833,8751,1701,44,19330,0,0,0,0,193,389,582
2018-04-09,6,3151,4786,2106,9500,9423,1843,49,20815,0,0,0,0,190,289,479
2018-04-09,7,3273,5035,2485,10563,10259,2051,54,22927,8,154,12,174,175,273,448
2018-04-09,8,3345,5117,2672,11176,10690,2136,57,24059,289,2034,352,2675,168,287,455
2018-04-09,9,3432,5147,2636,11033,10794,2117,58,24001,803,4968,1026,6797,149,303,452
2018-04-09,10,3547,5153,2549,10782,11096,2075,57,24010,1114,6213,1388,8715,133,417,550
2018-04-09,11,3637,5141,2459,10574,11431,2071,58,24134,1189,6738,1550,9477,110,492,602
2018-04-09,12,3686,5119,2363,10373,11800,2094,59,24326,1240,6949,1605,9794,76,489,565
2018-04-09,13,3740,5117,2319,10325,12189,2132,60,24706,1241,6999,1604,9844,53,461,514
2018-04-09,14,3817,5082,2275,10489,12717,2205,61,25473,1235,6990,1598,9823,39,411,450
2018-04-09,15,3896,5059,2229,10702,13069,2299,62,26133,1229,6907,1591,9727,33,348,381
2018-04-09,16,3966,5055,2219,11070,13517,2405,63,27056,1177,6534,1503,9214,32,280,312
2018-04-09,17,4019,5036,2240,11513,13751,2510,64,27837,1018,5790,1336,8144,44,224,268
2018-04-09,18,4090,5001,2282,11990,13753,2590,64,28398,741,3849,889,5479,46,165,211
2018-04-09,19,4073,5004,2300,12326,13519,2617,63,28525,302,923,265,1490,49,131,180
2018-04-09,20,4203,5181,2323,12693,13752,2757,63,29265,8,18,9,35,76,109,185
2018-04-09,21,4180,5093,2354,12852,13822,2731,62,29467,0,0,0,0,104,118,222
2018-04-09,22,3958,4800,2225,12178,13032,2518,57,27785,0,0,0,0,168,118,286
2018-04-09,23,3663,4505,2028,11097,11895,2234,52,25277,0,0,0,0,221,117,338
2018-04-09,24,3395,4316,1861,10218,10823,1993,47,23081,0,0,0,0,256,117,373
2018-04-10,1,3225,4182,1780,9755,10124,1927,44,21850,0,0,0,0,325,88,413
2018-04-10,2,3111,4137,1724,9335,9682,1843,43,20903,0,0,0,0,459,86,545
2018-04-10,3,3036,4138,1698,9096,9353,1793,42,20285,0,0,0,0,463,80,543
2018-04-10,4,3005,4211,1702,9024,9228,1764,43,20059,0,0,0,0,493,78,571
2018-04-10,5,3038,4426,1785,9203,9277,1797,46,20323,0,0,0,0,548,82,630
2018-04-10,6,3145,4811,1999,9745,9833,1923,51,21551,0,0,0,0,602,66,668
2018-04-10,7,3264,5030,2329,10789,10434,2137,56,23415,5,130,6,141,636,57,693
2018-04-10,8,3353,5102,2506,11523,10958,2206,58,24744,236,1853,316,2405,660,52,712
2018-04-10,9,3452,5112,2491,11673,11250,2182,58,25163,635,4452,914,6001,581,48,629
2018-04-10,10,3582,5106,2451,11530,11608,2195,57,25389,945,5707,1317,7969,504,61,565
2018-04-10,11,3685,5089,2395,11488,12074,2186,58,25806,1019,6275,1505,8799,401,109,510
2018-04-10,12,3777,5077,2375,11421,12515,2185,59,26180,1084,6653,1571,9308,385,250,635
2018-04-10,13,3871,5093,2363,11288,12983,2208,61,26540,1095,6706,1560,9361,394,481,875
2018-04-10,14,3983,5112,2333,11262,13491,2262,64,27079,1088,6639,1559,9286,374,873,1247
2018-04-10,15,4100,5150,2292,11142,13934,2328,66,27470,1050,6558,1536,9144,331,1114,1445
2018-04-10,16,4215,5192,2263,11022,14279,2403,68,27771,947,6163,1439,8549,292,1469,1761
2018-04-10,17,4300,5198,2261,11204,14516,2523,70,28313,801,5379,1235,7415,273,1835,2108
2018-04-10,18,4315,5190,2279,11451,14437,2665,69,28622,507,3556,854,4917,271,2023,2294
2018-04-10,19,4273,5115,2314,11680,14105,2764,67,28616,185,918,277,1380,269,2121,2390
2018-04-10,20,4404,5253,2354,11986,13943,2846,66,28842,6,27,15,48,282,2252,2534
2018-04-10,21,4394,5086,2430,12343,14065,2771,64,29242,0,0,0,0,328,2298,2626
2018-04-10,22,4175,4769,2318,11833,13262,2572,58,27726,0,0,0,0,412,2320,2732
2018-04-10,23,3886,4465,2124,10928,12131,2318,52,25429,0,0,0,0,500,2278,2778
2018-04-10,24,3604,4254,1938,10136,10973,2088,48,23244,0,0,0,0,563,2239,2802
2018-04-11,1,3466,4117,1834,9675,10052,1905,44,21677,0,0,0,0,618,2370,2988
2018-04-11,2,3327,4054,1785,9294,9573,1815,43,20725,0,0,0,0,635,2380,3015
2018-04-11,3,3238,4041,1762,9079,9227,1765,42,20113,0,0,0,0,667,2383,3050
2018-04-11,4,3194,4095,1779,9006,9072,1740,42,19861,0,0,0,0,685,2319,3004
2018-04-11,5,3222,4285,1873,9215,9228,1779,45,20267,0,0,0,0,681,2266,2947
2018-04-11,6,3375,4637,2118,9808,9755,1911,50,21524,0,0,0,0,633,2241,2874
2018-04-11,7,3486,4880,2477,10766,10543,2130,54,23493,10,169,13,192,591,2136,2727
2018-04-11,8,3550,4986,2664,11481,11049,2223,56,24809,289,2025,292,2606,551,2090,2641
2018-04-11,9,3690,5027,2638,11568,11392,2203,57,25219,730,4888,844,6462,495,1984,2479
2018-04-11,10,3817,5047,2574,11328,11522,2148,58,25056,1013,6132,1168,8313,417,1904,2321
2018-04-11,11,3934,5055,2504,10999,11702,2086,60,24848,1073,6647,1321,9041,373,1821,2194
2018-04-11,12,4031,5048,2434,10735,11930,2043,62,24769,1102,6887,1399,9388,396,1995,2391
2018-04-11,13,4093,5067,2398,10577,12080,2017,63,24737,1083,6929,1455,9467,470,2243,2713
2018-04-11,14,4176,5074,2352,10571,12313,2036,65,24985,1032,6863,1460,9355,570,2456,3026
2018-04-11,15,4243,5080,2327,10662,12509,2064,66,25301,992,6714,1444,9150,644,2549,3193
2018-04-11,16,4322,5110,2312,10790,12584,2117,67,25559,841,6248,1341,8430,682,2585,3267
2018-04-11,17,4398,5133,2317,11029,12610,2224,66,25929,683,5372,1162,7217,718,2596,3314
2018-04-11,18,4349,5033,2350,11294,12482,2353,64,26193,418,3584,753,4755,707,2607,3314
2018-04-11,19,4307,5007,2407,11549,12239,2436,62,26285,181,984,224,1389,678,2646,3324
2018-04-11,20,4424,5141,2460,12019,12581,2594,61,27255,6,26,4,36,748,2700,3448
2018-04-11,21,4408,5055,2530,12376,12666,2582,60,27684,0,0,0,0,740,2881,3621
2018-04-11,22,4209,4763,2409,11899,12016,2419,56,26390,0,0,0,0,784,2950,3734
2018-04-11,23,3910,4456,2202,11081,11171,2192,51,24494,0,0,0,0,848,2955,3803
2018-04-11,24,3632,4241,2021,10243,10277,1988,47,22555,0,0,0,0,823,2960,3783
2018-04-12,1,3452,4093,1922,9487,9500,1882,46,20915,0,0,0,0,749,2953,3702
2018-04-12,2,3308,4034,1882,9107,9136,1798,45,20087,0,0,0,0,734,2972,3706
2018-04-12,3,3221,4022,1865,8908,8861,1742,45,19556,0,0,0,0,700,2929,3629
2018-04-12,4,3165,4079,1886,8866,8747,1719,45,19377,0,0,0,0,664,3003,3667
2018-04-12,5,3183,4273,1988,9110,8937,1759,47,19853,0,0,0,0,620,3043,3663
2018-04-12,6,3308,4629,2247,9789,9480,1894,51,21214,0,0,0,0,542,2964,3506
2018-04-12,7,3388,4882,2592,10866,10263,2100,54,23283,11,166,10,187,458,2854,3312
2018-04-12,8,3431,4988,2783,11478,10683,2224,57,24442,337,2046,323,2706,387,2766,3153
2018-04-12,9,3490,5028,2743,11221,10711,2212,60,24204,867,4671,952,6490,332,2961,3293
2018-04-12,10,3534,5049,2668,10836,10718,2158,61,23773,1175,5944,1317,8436,292,2982,3274
2018-04-12,11,3571,5063,2596,10513,10678,2089,60,23340,1224,6509,1512,9245,257,3040,3297
2018-04-12,12,3553,5059,2509,10246,10569,2006,58,22879,1221,6742,1578,9541,279,3082,3361
2018-04-12,13,3515,5075,2452,9970,10479,1959,56,22464,1190,6803,1602,9595,347,3063,3410
2018-04-12,14,3501,5059,2399,9826,10541,1931,54,22353,1135,6809,1612,9556,414,3076,3490
2018-04-12,15,3479,5062,2346,9766,10561,1932,53,22312,1131,6736,1610,9477,476,3060,3536
2018-04-12,16,3473,5075,2292,9829,10703,1959,52,22544,1104,6416,1507,9027,542,3127,3669
2018-04-12,17,3466,5061,2315,10119,10883,2044,53,23100,981,5719,1313,8013,571,3058,3629
2018-04-12,18,3489,5019,2344,10490,11015,2187,53,23746,798,4041,962,5801,600,2938,3538
2018-04-12,19,3512,5033,2391,10849,11178,2316,53,24397,319,1232,347,1898,558,2884,3442
2018-04-12,20,3716,5198,2446,11434,11792,2517,56,25800,23,41,17,81,553,2805,3358
2018-04-12,21,3791,5108,2533,11998,12066,2557,58,26679,0,0,0,0,519,2887,3406
2018-04-12,22,3669,4816,2420,11618,11579,2409,55,25661,0,0,0,0,472,2933,3405
2018-04-12,23,3566,4524,2227,10848,10779,2185,52,23864,0,0,0,0,428,2842,3270
2018-04-12,24,3381,4324,2049,10078,9942,1978,51,22049,0,0,0,0,312,2679,2991
2018-04-13,1,3289,4237,1936,9526,9251,1828,50,20655,0,0,0,0,259,2158,2417
2018-04-13,2,3192,4201,1888,9163,8905,1744,51,19862,0,0,0,0,174,1944,2118
2018-04-13,3,3133,4202,1876,8984,8743,1701,51,19480,0,0,0,0,154,1766,1920
2018-04-13,4,3117,4282,1903,8970,8680,1689,53,19392,0,0,0,0,139,1569,1708
2018-04-13,5,3175,4483,2003,9218,8910,1733,57,19919,0,0,0,0,133,1298,1431
2018-04-13,6,3319,4824,2249,9883,9489,1890,64,21326,0,0,0,0,153,929,1082
2018-04-13,7,3442,5053,2596,10893,10251,2088,69,23301,16,194,14,224,188,620,808
2018-04-13,8,3483,5125,2763,11395,10575,2140,69,24180,399,2226,403,3028,201,390,591
2018-04-13,9,3516,5111,2724,11231,10433,2081,65,23810,984,5024,1081,7089,198,254,452
2018-04-13,10,3528,5063,2637,10682,10361,1981,62,23087,1199,6203,1445,8847,195,215,410
2018-04-13,11,3522,4998,2540,10230,10333,1919,59,22541,1280,6690,1621,9591,183,214,397
2018-04-13,12,3488,4925,2424,9895,10339,1871,57,22161,1322,6856,1652,9830,151,212,363
2018-04-13,13,3457,4884,2347,9552,10396,1862,56,21865,1329,6872,1651,9852,138,202,340
2018-04-13,14,3452,4837,2279,9490,10559,1898,55,22002,1327,6872,1654,9853,130,202,332
2018-04-13,15,3459,4798,2210,9532,10774,1964,54,22323,1322,6812,1647,9781,116,212,328
2018-04-13,16,3488,4776,2173,9682,11059,2060,55,22856,1309,6511,1599,9419,103,265,368
2018-04-13,17,3523,4750,2176,10025,11244,2179,55,23503,1217,5844,1442,8503,96,408,504
2018-04-13,18,3583,4708,2195,10442,11374,2318,57,24190,974,4129,1074,6177,124,614,738
2018-04-13,19,3623,4716,2204,10855,11361,2429,57,24702,373,1212,372,1957,193,861,1054
2018-04-13,20,3800,4928,2222,11328,11795,2593,59,25774,24,42,15,81,240,1128,1368
2018-04-13,21,3851,4913,2314,11630,11939,2563,59,26191,0,0,0,0,257,1073,1330
2018-04-13,22,3725,4719,2241,11279,11415,2424,56,25174,0,0,0,0,278,980,1258
2018-04-13,23,3596,4483,2091,10705,10608,2223,52,23588,0,0,0,0,312,870,1182
2018-04-13,24,3424,4304,1941,10035,9877,2028,49,21989,0,0,0,0,296,559,855
2018-04-14,1,3260,4211,1824,9406,9258,1861,45,20570,0,0,0,0,222,402,624
2018-04-14,2,3162,4167,1764,9016,8845,1761,45,19666,0,0,0,0,197,292,489
2018-04-14,3,3096,4163,1737,8780,8569,1706,46,19100,0,0,0,0,201,225,426
2018-04-14,4,3064,4193,1739,8665,8414,1675,48,18803,0,0,0,0,198,194,392
2018-04-14,5,3073,4275,1786,8736,8461,1689,51,18937,0,0,0,0,186,175,361
2018-04-14,6,3132,4402,1895,8990,8670,1729,55,19443,0,0,0,0,154,154,308
2018-04-14,7,3119,4468,2044,9257,8705,1758,61,19781,24,255,30,309,131,145,276
2018-04-14,8,3131,4622,2182,9409,8623,1769,59,19860,467,2367,490,3324,112,144,256
2018-04-14,9,3216,4700,2290,9492,8735,1768,58,20053,1014,5185,1160,7359,93,133,226
2018-04-14,10,3283,4697,2296,9351,8840,1738,56,19986,1232,6248,1485,8965,72,135,207
2018-04-14,11,3298,4650,2246,8945,8981,1709,55,19690,1309,6733,1642,9684,58,132,190
2018-04-14,12,3288,4582,2169,8669,9063,1681,54,19467,1356,6876,1664,9896,68,122,190
2018-04-14,13,3279,4506,2117,8528,9173,1678,53,19432,1352,6878,1658,9888,80,116,196
2018-04-14,14,3320,4460,2065,8486,9278,1699,53,19515,1348,6882,1652,9882,99,130,229
2018-04-14,15,3389,4435,2022,8616,9529,1761,53,19958,1330,6832,1649,9811,140,195,335
2018-04-14,16,3473,4473,2008,8880,9813,1861,53,20607,1237,6508,1575,9320,201,361,562
2018-04-14,17,3555,4506,2023,9396,10100,2010,54,21559,1089,5834,1402,8325,278,662,940
2018-04-14,18,3629,4528,2041,10055,10492,2161,56,22764,812,4111,1024,5947,369,823,1192
2018-04-14,19,3646,4581,2057,10524,11078,2288,56,23945,284,1121,307,1712,455,959,1414
2018-04-14,20,3757,4787,2083,10955,11466,2445,57,24923,15,45,15,75,562,1159,1721
2018-04-14,21,3808,4785,2155,11325,11613,2467,58,25463,0,0,0,0,599,1246,1845
2018-04-14,22,3688,4611,2097,11007,11171,2335,54,24568,0,0,0,0,628,1302,1930
2018-04-14,23,3506,4380,1967,10359,10446,2131,50,22987,0,0,0,0,658,1354,2012
2018-04-14,24,3327,4194,1829,9646,9485,1962,47,21140,0,0,0,0,669,1382,2051
2018-04-15,1,3183,4117,1729,9201,8994,1849,44,20088,0,0,0,0,710,1375,2085
2018-04-15,2,3069,4060,1675,8815,8572,1752,43,19182,0,0,0,0,669,1368,2037
2018-04-15,3,2999,4033,1653,8562,8282,1689,43,18575,0,0,0,0,639,1356,1995
2018-04-15,4,2961,4047,1655,8432,8106,1656,43,18237,0,0,0,0,602,1314,1916
2018-04-15,5,2958,4103,1698,8430,8081,1656,44,18212,0,0,0,0,573,1278,1851
2018-04-15,6,2991,4164,1779,8596,8201,1689,47,18533,0,0,0,0,534,1203,1737
2018-04-15,7,2929,4213,1896,8798,8181,1703,49,18732,10,201,14,225,503,1110,1613
2018-04-15,8,2956,4365,2033,8903,8096,1707,51,18757,282,2025,366,2673,460,992,1452
2018-04-15,9,3052,4427,2162,9028,8149,1694,52,18923,635,4204,768,5607,435,842,1277
2018-04-15,10,3158,4463,2210,8938,8259,1670,51,18919,910,5122,1091,7123,410,707,1117
2018-04-15,11,3258,4447,2194,8784,8466,1634,51,18935,1029,5572,1275,7876,395,602,997
2018-04-15,12,3335,4504,2155,8565,8592,1601,51,18809,1149,5844,1401,8394,526,725,1251
2018-04-15,13,3385,4497,2132,8345,8666,1584,52,18647,1198,5845,1442,8485,689,945,1634
2018-04-15,14,3461,4517,2098,8269,8731,1623,53,18677,1225,5647,1473,8345,855,1159,2014
2018-04-15,15,3555,4558,2063,8387,8946,1673,54,19060,1216,5549,1507,8272,963,1312,2275
2018-04-15,16,3687,4661,2057,8680,9313,1761,55,19809,1118,5081,1442,7641,1020,1398,2418
2018-04-15,17,3785,4744,2081,9141,9654,1893,57,20746,940,4410,1280,6630,1026,1506,2532
2018-04-15,18,3862,4737,2146,9779,10001,2046,57,21883,693,3058,916,4667,982,1489,2471
2018-04-15,19,3866,4731,2173,10173,10218,2187,57,22634,302,878,321,1501,925,1453,2378
2018-04-15,20,3997,4886,2226,10703,10771,2371,57,23903,21,26,18,65,822,1415,2237
2018-04-15,21,4026,4824,2319,11247,11049,2404,57,24756,0,0,0,0,772,1452,2224
2018-04-15,22,3881,4583,2217,10958,10572,2264,53,23846,0,0,0,0,690,1572,2262
2018-04-15,23,3617,4317,2038,10205,9888,2068,48,22208,0,0,0,0,601,1655,2256
2018-04-15,24,3364,4135,1874,9467,9195,1889,44,20595,0,0,0,0,590,1713,2303
2018-04-16,1,3159,4038,1783,9139,8797,1846,43,19825,0,0,0,0,544,1969,2513
2018-04-16,2,3038,3995,1756,8862,8487,1772,43,19164,0,0,0,0,432,1952,2384
2018-04-16,3,2973,3991,1751,8717,8303,1725,43,18788,0,0,0,0,365,1880,2245
2018-04-16,4,2949,4061,1788,8710,8273,1702,43,18728,0,0,0,0,339,1810,2149
2018-04-16,5,2997,4263,1899,9001,8531,1745,46,19322,0,0,0,0,318,1784,2102
2018-04-16,6,3135,4618,2155,9829,9195,1903,50,20977,0,0,0,0,286,1802,2088
2018-04-16,7,3231,4884,2524,10927,10188,2123,54,23292,14,167,16,197,241,1816,2057
2018-04-16,8,3294,5012,2716,11770,10806,2251,57,24883,321,1886,354,2561,223,1844,2067
2018-04-16,9,3377,5090,2704,11705,10745,2266,59,24774,679,4069,892,5640,219,1960,2179
2018-04-16,10,3457,5137,2641,11466,10579,2209,59,24312,821,5104,1150,7075,210,1988,2198
2018-04-16,11,3531,5158,2585,11340,10421,2094,58,23912,833,5700,1265,7798,219,2028,2247
2018-04-16,12,3590,5169,2508,11251,10288,2007,57,23602,827,5969,1303,8099,280,2087,2367
2018-04-16,13,3590,5207,2464,10941,10186,1957,56,23141,785,6132,1186,8103,332,2189,2521
2018-04-16,14,3603,5205,2413,10768,10072,1925,55,22820,747,6045,1142,7934,401,2281,2682
2018-04-16,15,3600,5191,2364,10591,10025,1931,55,22602,727,5836,1079,7642,426,2492,2918
2018-04-16,16,3617,5176,2324,10552,10112,1970,54,22688,699,5354,1013,7066,512,2660,3172
2018-04-16,17,3667,5115,2345,10816,10339,2057,55,23266,612,4645,905,6162,565,2784,3349
2018-04-16,18,3678,5062,2384,11187,10678,2163,56,24084,467,3221,632,4320,549,2852,3401
2018-04-16,19,3666,5055,2432,11706,11068,2268,56,25098,229,1028,271,1528,469,2813,3282
2018-04-16,20,3797,5200,2484,12309,11697,2473,58,26537,14,43,14,71,406,2752,3158
2018-04-16,21,3811,5135,2564,12527,11970,2517,59,27073,0,0,0,0,423,2703,3126
2018-04-16,22,3641,4851,2440,11931,11476,2364,57,25828,0,0,0,0,421,2702,3123
2018-04-16,23,3530,4548,2234,11080,10677,2136,54,23947,0,0,0,0,450,2665,3115
2018-04-16,24,3325,4356,2052,10252,9881,1937,52,22122,0,0,0,0,361,2712,3073
2018-04-17,1,3197,4177,1965,9481,9243,1814,51,20588,0,0,0,0,243,2729,2972
2018-04-17,2,3104,4138,1917,9113,8893,1736,51,19793,0,0,0,0,209,2623,2832
2018-04-17,3,3055,4143,1905,8953,8707,1693,52,19406,0,0,0,0,168,2687,2855
2018-04-17,4,3049,4217,1930,8941,8677,1689,54,19361,0,0,0,0,130,2751,2881
2018-04-17,5,3111,4431,2034,9271,8940,1737,59,20008,0,0,0,0,102,2733,2835
2018-04-17,6,3273,4793,2293,9961,9652,1898,66,21577,0,0,0,0,89,2515,2604
2018-04-17,7,3377,5037,2659,11015,10478,2100,74,23667,19,270,22,311,79,2107,2186
2018-04-17,8,3428,5133,2825,11550,10777,2165,73,24566,413,2465,409,3287,71,1429,1500
2018-04-17,9,3456,5130,2780,11247,10606,2112,69,24033,914,5145,1020,7079,63,838,901
2018-04-17,10,3445,5130,2690,10818,10461,2024,64,23368,1190,6211,1375,8776,58,437,495
2018-04-17,11,3435,5122,2595,10411,10323,1931,61,22725,1274,6696,1550,9520,46,280,326
2018-04-17,12,3407,5095,2514,10072,10178,1843,57,22150,1335,6835,1635,9805,37,198,235
2018-04-17,13,3379,5088,2463,9741,10027,1808,55,21632,1346,6881,1660,9887,36,165,201
2018-04-17,14,3388,5055,2414,9638,10181,1833,54,21706,1345,6875,1663,9883,41,157,198
2018-04-17,15,3408,5038,2360,9626,10380,1884,53,21943,1345,6831,1662,9838,49,156,205
2018-04-17,16,3453,5042,2314,9790,10632,1962,54,22438,1302,6561,1626,9489,65,176,241
2018-04-17,17,3510,5026,2327,10182,10877,2084,55,23198,1181,5901,1463,8545,99,262,361
2018-04-17,18,3598,5007,2369,10629,11079,2192,56,23956,951,4274,1116,6341,146,423,569
2018-04-17,19,3635,5012,2417,11086,11192,2273,57,24607,385,1391,460,2236,221,665,886
2018-04-17,20,3805,5195,2472,11619,11673,2464,58,25814,26,69,50,145,323,902,1225
2018-04-17,21,3853,5130,2562,12188,11958,2523,59,26728,0,0,0,0,342,889,1231
2018-04-17,22,3715,4849,2449,11818,11488,2381,57,25743,0,0,0,0,337,808,1145
2018-04-17,23,3576,4555,2248,10969,10700,2157,53,23878,0,0,0,0,348,721,1069
2018-04-17,24,3374,4371,2066,10164,9873,1952,51,22041,0,0,0,0,375,523,898
2018-04-18,1,3249,4226,1942,9608,9297,1855,53,20813,0,0,0,0,377,186,563
2018-04-18,2,3149,4197,1894,9238,8918,1774,53,19983,0,0,0,0,380,111,491
2018-04-18,3,3097,4208,1876,9087,8725,1733,53,19598,0,0,0,0,391,83,474
2018-04-18,4,3083,4290,1899,9062,8673,1720,56,19511,0,0,0,0,396,75,471
2018-04-18,5,3140,4505,1999,9270,8905,1761,60,19996,0,0,0,0,395,76,471
2018-04-18,6,3278,4872,2257,9893,9591,1912,67,21463,0,0,0,0,360,72,432
2018-04-18,7,3362,5113,2607,11002,10296,2109,70,23477,17,268,22,307,332,74,406
2018-04-18,8,3397,5146,2777,11734,10593,2170,70,24566,344,2437,459,3240,309,76,385
2018-04-18,9,3423,5102,2734,11649,10487,2122,67,24324,708,5033,996,6737,307,74,381
2018-04-18,10,3424,5045,2652,11302,10369,2030,64,23765,941,6046,1288,8275,310,83,393
2018-04-18,11,3435,4972,2580,10861,10314,1953,61,23190,1017,6550,1415,8982,285,110,395
2018-04-18,12,3432,4899,2496,10595,10304,1896,60,22855,1084,6695,1455,9234,226,146,372
2018-04-18,13,3432,4865,2448,10306,10258,1878,59,22500,1096,6696,1512,9304,223,282,505
2018-04-18,14,3486,4826,2402,10178,10418,1901,58,22555,1080,6536,1495,9111,234,561,795
2018-04-18,15,3552,4801,2356,10144,10600,1946,58,22747,1083,6459,1480,9022,277,781,1058
2018-04-18,16,3644,4803,2320,10180,10748,2012,57,22997,1011,6053,1423,8487,355,1081,1436
2018-04-18,17,3743,4796,2322,10354,10825,2115,57,23351,890,5304,1283,7477,394,1408,1802
2018-04-18,18,3825,4793,2365,10768,10947,2246,58,24019,614,3728,940,5282,398,1466,1864
2018-04-18,19,3840,4820,2390,11204,11071,2368,58,24701,277,1215,394,1886,401,1491,1892
2018-04-18,20,3984,5008,2434,11756,11593,2543,60,25953,22,60,31,113,461,1481,1942
2018-04-18,21,4021,4965,2522,12218,11881,2576,60,26735,0,0,0,0,461,1538,1999
2018-04-18,22,3844,4697,2415,11755,11417,2429,57,25658,0,0,0,0,467,1740,2207
2018-04-18,23,3597,4407,2213,10977,10621,2203,52,23854,0,0,0,0,444,1809,2253
2018-04-18,24,3386,4217,2034,10190,9832,1991,49,22062,0,0,0,0,373,1870,2243
2018-04-19,1,3208,4144,1901,9619,9388,1856,48,20911,0,0,0,0,424,1814,2238
2018-04-19,2,3103,4104,1853,9255,9004,1776,48,20083,0,0,0,0,386,1852,2238
2018-04-19,3,3047,4105,1837,9040,8748,1730,48,19566,0,0,0,0,327,1924,2251
2018-04-19,4,3027,4177,1861,8976,8659,1709,49,19393,0,0,0,0,257,2031,2288
2018-04-19,5,3079,4375,1963,9220,8831,1750,52,19853,0,0,0,0,207,2049,2256
2018-04-19,6,3224,4722,2222,9850,9293,1889,57,21089,0,0,0,0,221,2160,2381
2018-04-19,7,3303,4957,2571,10835,10158,2108,63,23164,25,240,18,283,243,2223,2466
2018-04-19,8,3354,5038,2727,11530,10698,2224,64,24516,412,2178,331,2921,245,2326,2571
2018-04-19,9,3396,5029,2674,11186,10514,2245,63,24008,874,4520,827,6221,229,2406,2635
2018-04-19,10,3406,5016,2588,10786,10372,2204,62,23424,1170,5626,1184,7980,218,2515,2733
2018-04-19,11,3411,4984,2499,10428,10246,2131,60,22866,1242,6198,1356,8796,210,2735,2945
2018-04-19,12,3396,4946,2407,10201,10304,2047,59,22611,1291,6477,1464,9232,224,2936,3160
2018-04-19,13,3383,4947,2356,9884,9994,1987,57,21922,1292,6510,1481,9283,260,3113,3373
2018-04-19,14,3402,4932,2315,9768,10021,1954,56,21799,1275,6419,1455,9149,316,3193,3509
2018-04-19,15,3430,4919,2270,9751,10047,1924,55,21777,1265,6284,1439,8988,345,3245,3590
2018-04-19,16,3473,4939,2236,9845,10128,1928,55,21956,1199,5899,1338,8436,357,3265,3622
2018-04-19,17,3509,4882,2236,10203,10290,1994,56,22543,1045,5195,1210,7450,380,3222,3602
2018-04-19,18,3522,4849,2259,10611,10479,2120,56,23266,818,3736,894,5448,417,3205,3622
2018-04-19,19,3566,4861,2287,11218,10767,2233,57,24274,384,1338,344,2066,475,3158,3633
2018-04-19,20,3729,5028,2309,11647,11600,2438,59,25744,27,76,25,128,528,3090,3618
2018-04-19,21,3815,4974,2388,12156,11891,2504,60,26611,0,0,0,0,547,3081,3628
2018-04-19,22,3694,4702,2304,11773,11507,2365,57,25702,0,0,0,0,603,3057,3660
2018-04-19,23,3566,4404,2123,10923,10711,2149,54,23837,0,0,0,0,692,3031,3723
2018-04-19,24,3358,4202,1956,10174,9971,1949,52,22146,0,0,0,0,636,3003,3639
2018-04-20,1,3182,4101,1822,9585,9360,1850,49,20844,0,0,0,0,550,2877,3427
2018-04-20,2,3079,4055,1769,9209,8998,1764,49,20019,0,0,0,0,492,2771,3263
2018-04-20,3,3031,4050,1749,8991,8780,1721,49,19541,0,0,0,0,409,2676,3085
2018-04-20,4,3018,4110,1768,8895,8748,1706,51,19400,0,0,0,0,341,2536,2877
2018-04-20,5,3072,4293,1858,9117,8909,1747,54,19827,0,0,0,0,289,2371,2660
2018-04-20,6,3225,4606,2089,9698,9487,1889,61,21135,0,0,0,0,246,2106,2352
2018-04-20,7,3294,4846,2426,10669,10207,2085,64,23025,40,358,53,451,209,1819,2028
2018-04-20,8,3358,4958,2574,11163,10419,2151,64,23798,547,2774,560,3881,180,1456,1636
2018-04-20,9,3405,4977,2541,10951,10267,2082,62,23362,1047,5430,1189,7666,160,1181,1341
2018-04-20,10,3435,4974,2467,10605,10174,1969,60,22808,1252,6475,1482,9209,131,947,1078
2018-04-20,11,3456,4946,2386,10303,10099,1884,59,22345,1325,6948,1632,9905,104,766,870
2018-04-20,12,3480,4896,2310,10209,10225,1813,57,22304,1361,7088,1662,10111,96,703,799
2018-04-20,13,3527,4877,2265,10108,10377,1793,56,22335,1366,7092,1664,10122,100,697,797
2018-04-20,14,3586,4848,2225,10184,10522,1807,56,22569,1366,7080,1664,10110,123,731,854
2018-04-20,15,3651,4816,2182,10320,10653,1847,55,22876,1361,7014,1662,10037,157,870,1027
2018-04-20,16,3724,4786,2167,10473,10743,1914,55,23185,1328,6699,1626,9653,226,1000,1226
2018-04-20,17,3805,4730,2187,10820,10994,2032,55,23900,1165,6036,1472,8673,349,1167,1516
2018-04-20,18,3842,4674,2183,11108,11162,2171,56,24497,1027,4586,1165,6778,442,1328,1770
2018-04-20,19,3854,4677,2164,11336,11319,2266,57,24977,491,1590,508,2589,525,1475,2000
2018-04-20,20,3940,4828,2139,11571,11754,2422,58,25805,39,77,63,179,620,1568,2188
2018-04-20,21,3954,4822,2201,11875,11954,2467,59,26355,0,0,0,0,633,1515,2148
2018-04-20,22,3811,4632,2118,11547,11506,2356,56,25465,0,0,0,0,654,1378,2032
2018-04-20,23,3574,4382,1964,10784,10762,2178,51,23775,0,0,0,0,655,1219,1874
2018-04-20,24,3380,4185,1822,10117,10035,1990,48,22190,0,0,0,0,626,897,1523
2018-04-21,1,3277,4079,1733,9694,9372,1873,44,20982,0,0,0,0,661,1197,1858
2018-04-21,2,3150,4027,1678,9312,8959,1769,43,20082,0,0,0,0,600,998,1598
2018-04-21,3,3069,4014,1647,9055,8676,1714,43,19487,0,0,0,0,540,726,1266
2018-04-21,4,3016,4037,1648,8892,8458,1688,43,19080,0,0,0,0,451,513,964
2018-04-21,5,3011,4117,1690,8891,8505,1695,44,19135,0,0,0,0,376,321,697
2018-04-21,6,3037,4235,1794,9082,8685,1758,47,19573,0,0,0,0,311,205,516
2018-04-21,7,2981,4313,1942,9397,8736,1788,51,19972,39,389,50,478,249,136,385
2018-04-21,8,3034,4476,2063,9554,8652,1799,52,20057,557,2811,569,3937,206,101,307
2018-04-21,9,3176,4565,2167,9608,8756,1815,53,20232,1057,5378,1198,7633,154,82,236
2018-04-21,10,3339,4591,2175,9537,8808,1763,53,20161,1252,6296,1474,9022,130,100,230
2018-04-21,11,3459,4575,2139,9395,8981,1722,52,20149,1329,6752,1627,9708,114,120,234
2018-04-21,12,3541,4544,2079,9276,9082,1697,52,20107,1364,6889,1663,9916,89,123,212
2018-04-21,13,3621,4507,2025,9215,9245,1701,52,20214,1362,6880,1657,9899,67,114,181
2018-04-21,14,3724,4490,1972,9287,9497,1719,54,20557,1358,6836,1656,9850,55,98,153
2018-04-21,15,3835,4506,1929,9535,9772,1784,55,21146,1355,6733,1651,9739,45,90,135
2018-04-21,16,3951,4581,1911,9904,10191,1882,56,22033,1316,6320,1585,9221,50,95,145
2018-04-21,17,4047,4639,1926,10477,10552,2031,58,23118,1143,5626,1415,8184,74,141,215
2018-04-21,18,4125,4610,1939,10984,10837,2181,60,24061,983,4141,1082,6206,114,327,441
2018-04-21,19,4142,4604,1956,11448,11124,2293,59,24924,473,1371,462,2306,179,698,877
2018-04-21,20,4189,4754,1973,11713,11454,2409,58,25634,41,60,53,154,271,1147,1418
2018-04-21,21,4171,4730,2071,12021,11644,2446,58,26168,0,0,0,0,298,1246,1544
2018-04-21,22,3985,4554,2030,11583,11208,2329,53,25173,0,0,0,0,338,1271,1609
2018-04-21,23,3760,4315,1900,10896,10576,2150,49,23671,0,0,0,0,382,1272,1654
2018-04-21,24,3518,4121,1775,10076,9772,1976,45,21870,0,0,0,0,372,1186,1558
2018-04-22,1,3289,4036,1677,9469,9309,1855,43,20676,0,0,0,0,423,1347,1770
2018-04-22,2,3151,3978,1637,9025,8859,1755,41,19680,0,0,0,0,390,1290,1680
2018-04-22,3,3037,3956,1624,8685,8476,1695,41,18897,0,0,0,0,365,1199,1564
2018-04-22,4,2969,3970,1640,8518,8272,1664,41,18496,0,0,0,0,340,1091,1431
2018-04-22,5,2945,4021,1694,8506,8172,1654,43,18375,0,0,0,0,307,963,1270
2018-04-22,6,3001,4088,1790,8597,8199,1688,46,18529,0,0,0,0,266,764,1030
2018-04-22,7,2897,4136,1914,8731,8090,1698,48,18567,43,334,46,423,236,585,821
2018-04-22,8,3008,4295,2039,8784,8062,1698,50,18594,535,2580,559,3674,205,449,654
2018-04-22,9,3187,4364,2147,8882,8213,1692,50,18838,1002,5017,1173,7192,170,303,473
2018-04-22,10,3364,4420,2155,8786,8355,1679,51,18870,1244,6039,1468,8751,135,195,330
2018-04-22,11,3513,4428,2101,8716,8584,1657,53,19010,1323,6559,1629,9511,98,148,246
2018-04-22,12,3667,4475,2035,8769,8928,1652,56,19404,1362,6787,1663,9812,62,195,257
2018-04-22,13,3805,4476,1993,8862,9223,1648,58,19791,1365,6875,1666,9906,40,291,331
2018-04-22,14,3948,4536,1949,9012,9580,1706,60,20358,1363,6877,1660,9900,35,419,454
2018-04-22,15,4084,4620,1911,9216,9901,1759,62,20937,1355,6811,1654,9820,52,677,729
2018-04-22,16,4203,4748,1898,9666,10407,1862,63,21998,1312,6493,1600,9405,85,1057,1142
2018-04-22,17,4343,4843,1929,10263,10853,2017,65,23198,1120,5846,1429,8395,125,1553,1678
2018-04-22,18,4373,4803,1982,10947,11279,2178,67,24472,945,4390,1099,6434,175,1699,1874
2018-04-22,19,4352,4786,2011,11436,11486,2312,66,25300,472,1528,475,2475,245,1769,2014
2018-04-22,20,4393,4906,2050,11738,11553,2456,65,25812,40,79,52,171,327,1849,2176
2018-04-22,21,4377,4846,2151,12181,11817,2486,63,26547,0,0,0,0,328,1908,2236
2018-04-22,22,4181,4556,2082,11705,11366,2323,57,25452,0,0,0,0,349,1933,2282
2018-04-22,23,3887,4266,1913,10809,10488,2108,51,23456,0,0,0,0,373,1945,2318
2018-04-22,24,3601,4086,1766,9915,9606,1923,46,21491,0,0,0,0,360,1934,2294
2018-04-23,1,3425,3975,1690,9376,9114,1821,44,20355,0,0,0,0,341,2080,2421
2018-04-23,2,3275,3940,1660,8997,8763,1742,42,19545,0,0,0,0,304,2073,2377
2018-04-23,3,3170,3938,1661,8722,8495,1698,41,18957,0,0,0,0,264,1992,2256
2018-04-23,4,3118,4009,1699,8673,8433,1680,41,18828,0,0,0,0,237,1871,2108
2018-04-23,5,3146,4207,1817,8892,8620,1717,44,19273,0,0,0,0,214,1701,1915
2018-04-23,6,3294,4545,2077,9429,9229,1856,49,20562,0,1,0,1,201,1499,1700
2018-04-23,7,3370,4816,2433,10320,9779,2032,52,22184,48,404,60,512,187,1253,1440
2018-04-23,8,3516,4947,2592,11064,10334,2119,55,23572,571,2860,605,4036,176,991,1167
2018-04-23,9,3688,5003,2543,11187,10686,2108,56,24036,1054,5349,1213,7616,176,700,876
2018-04-23,10,3840,5036,2462,11127,10955,2060,57,24200,1233,6244,1489,8966,158,465,623
2018-04-23,11,4000,5031,2389,11176,11352,2041,61,24629,1302,6715,1642,9659,147,301,448
2018-04-23,12,4158,5003,2333,11284,11663,2043,64,25054,1342,6838,1664,9844,105,320,425
2018-04-23,13,4303,4994,2305,11465,12012,2068,66,25611,1341,6836,1665,9842,74,396,470
2018-04-23,14,4455,4955,2276,11827,12431,2112,68,26439,1340,6807,1660,9807,60,536,596
2018-04-23,15,4595,4920,2245,12169,12861,2171,70,27271,1337,6715,1653,9705,50,746,796
2018-04-23,16,4686,4907,2232,12584,13222,2254,71,28132,1287,6334,1613,9234,45,985,1030
2018-04-23,17,4770,4883,2249,13006,13442,2362,72,28882,1094,5676,1433,8203,46,1252,1298
2018-04-23,18,4731,4852,2269,13338,13472,2451,71,29332,925,4160,1077,6162,56,1348,1404
2018-04-23,19,4684,4871,2286,13483,13280,2495,69,29327,429,1414,446,2289,90,1403,1493
2018-04-23,20,4706,5024,2278,13543,13244,2608,67,29462,38,65,37,140,158,1468,1626
2018-04-23,21,4657,4976,2331,13650,13359,2610,65,29684,0,0,0,0,220,1558,1778
2018-04-23,22,4393,4697,2217,12861,12618,2435,59,27973,0,0,0,0,315,1624,1939
2018-04-23,23,4084,4404,2020,11682,11516,2197,53,25449,0,0,0,0,465,1670,2135
2018-04-23,24,3781,4215,1860,10711,10400,1990,49,23150,0,0,0,0,489,1626,2115
2018-04-24,1,3555,4098,1786,10036,9703,1871,49,21659,0,0,0,0,701,1860,2561
2018-04-24,2,3388,4055,1740,9581,9215,1784,47,20627,0,0,0,0,700,1819,2519
2018-04-24,3,3269,4059,1721,9254,8923,1730,46,19952,0,0,0,0,660,1713,2373
2018-04-24,4,3210,4141,1737,9150,8828,1710,45,19733,0,0,0,0,621,1542,2163
2018-04-24,5,3214,4354,1830,9311,8964,1745,47,20067,0,0,0,0,583,1349,1932
2018-04-24,6,3343,4712,2077,9815,9534,1879,51,21279,0,0,0,0,550,1041,1591
2018-04-24,7,3399,4950,2412,10670,10212,2057,54,22994,50,365,46,461,512,713,1225
2018-04-24,8,3539,5033,2569,11286,10622,2142,57,24107,551,2573,543,3667,438,468,906
2018-04-24,9,3708,5025,2503,11382,10857,2130,59,24429,1016,4867,1111,6994,341,266,607
2018-04-24,10,3874,5013,2429,11246,11042,2080,62,24430,1239,5840,1414,8493,257,145,402
2018-04-24,11,4023,4984,2377,11293,11265,2050,65,24673,1299,6308,1580,9187,181,106,287
2018-04-24,12,4172,4942,2342,11357,11544,2026,67,24994,1339,6582,1629,9550,119,122,241
2018-04-24,13,4319,4938,2328,11537,11812,2034,70,25453,1338,6639,1635,9612,79,157,236
2018-04-24,14,4472,4914,2315,11904,12233,2076,72,26285,1314,6616,1630,9560,66,228,294
2018-04-24,15,4607,4893,2305,12204,12603,2126,73,27006,1310,6504,1620,9434,94,392,486
2018-04-24,16,4720,4894,2300,12614,12957,2205,74,27850,1275,6046,1559,8880,136,634,770
2018-04-24,17,4790,4898,2320,13079,13005,2317,76,28476,1062,5355,1388,7805,183,971,1154
2018-04-24,18,4754,4855,2338,13359,12931,2411,74,28775,867,3922,1038,5827,252,1199,1451
2018-04-24,19,4733,4870,2346,13465,12818,2453,72,28808,426,1374,442,2242,341,1453,1794
2018-04-24,20,4755,5022,2345,13508,12989,2563,70,29130,37,75,38,150,472,1674,2146
2018-04-24,21,4700,4978,2381,13642,13188,2590,69,29488,0,0,0,0,519,1682,2201
2018-04-24,22,4445,4699,2224,12892,12478,2436,63,27869,0,0,0,0,582,1637,2219
2018-04-24,23,4104,4397,2010,11783,11430,2201,57,25472,0,0,0,0,644,1549,2193
2018-04-24,24,3775,4212,1831,10777,10390,1991,53,23210,0,0,0,0,657,1427,2084
2018-04-25,1,3544,4152,1780,10061,9509,1879,48,21497,0,0,0,0,745,1719,2464
2018-04-25,2,3358,4111,1732,9596,9148,1795,46,20586,0,0,0,0,753,1667,2420
2018-04-25,3,3237,4109,1704,9281,8881,1752,45,19958,0,0,0,0,714,1587,2301
2018-04-25,4,3171,4181,1708,9185,8791,1733,45,19754,0,0,0,0,661,1490,2151
2018-04-25,5,3180,4384,1791,9354,8932,1774,47,20107,0,0,0,0,614,1396,2010
2018-04-25,6,3289,4715,2024,9848,9504,1900,51,21303,0,0,0,0,563,1185,1748
2018-04-25,7,3367,4973,2342,10546,10168,2106,54,22875,54,406,56,516,511,976,1487
2018-04-25,8,3495,5050,2496,11141,10572,2181,57,23950,571,2752,559,3882,471,748,1219
2018-04-25,9,3666,5052,2451,11114,10668,2120,58,23960,1082,5167,1151,7400,424,474,898
2018-04-25,10,3832,5047,2418,10962,10768,2033,60,23823,1255,6128,1385,8768,366,256,622
2018-04-25,11,4007,5028,2388,10876,10895,1963,63,23797,1324,6630,1528,9482,310,136,446
2018-04-25,12,4193,5007,2353,10873,11133,1922,65,23993,1349,6772,1584,9705,307,131,438
2018-04-25,13,4352,5017,2358,10965,11337,1912,68,24281,1349,6804,1634,9787,322,161,483
2018-04-25,14,4543,5042,2360,11237,11680,1938,70,24925,1333,6808,1631,9772,367,226,593
2018-04-25,15,4715,5094,2379,11494,12029,1992,71,25586,1315,6694,1619,9628,474,395,869
2018-04-25,16,4866,5144,2399,11855,12336,2068,72,26332,1293,6357,1562,9212,594,647,1241
2018-04-25,17,4941,5165,2439,12306,12407,2180,74,26967,1106,5714,1401,8221,713,964,1677
2018-04-25,18,4920,5098,2460,12763,12438,2316,72,27589,952,4274,1084,6310,770,1202,1972
2018-04-25,19,4896,5067,2438,13035,12359,2409,70,27873,459,1500,475,2434,824,1482,2306
2018-04-25,20,4900,5166,2403,13132,12568,2556,69,28324,42,84,43,169,892,1798,2690
2018-04-25,21,4817,5069,2438,13329,12754,2575,66,28724,0,0,0,0,914,1913,2827
2018-04-25,22,4548,4741,2283,12702,12087,2422,61,27272,0,0,0,0,936,1987,2923
2018-04-25,23,4180,4434,2047,11677,11095,2199,55,25026,0,0,0,0,957,2015,2972
2018-04-25,24,3849,4226,1857,10721,10158,1995,51,22924,0,0,0,0,973,1965,2938
2018-04-26,1,3557,4124,1781,9816,9517,1866,48,21246,0,0,0,0,994,1862,2856
2018-04-26,2,3373,4070,1723,9382,9146,1778,45,20351,0,0,0,0,995,1779,2774
2018-04-26,3,3254,4059,1682,9079,8883,1725,44,19730,0,0,0,0,984,1687,2671
2018-04-26,4,3183,4127,1679,9012,8797,1702,44,19555,0,0,0,0,968,1586,2554
2018-04-26,5,3179,4327,1752,9214,8998,1738,46,19996,0,0,0,0,948,1489,2437
2018-04-26,6,3270,4650,1967,9771,9609,1873,50,21303,0,0,0,0,935,1378,2313
2018-04-26,7,3397,4906,2272,10696,10255,2097,53,23102,55,417,56,528,912,1252,2164
2018-04-26,8,3539,5008,2426,11219,10564,2195,55,24033,554,2726,558,3838,888,1117,2005
2018-04-26,9,3735,5035,2416,11210,10645,2212,57,24125,1043,5219,1168,7430,844,901,1745
2018-04-26,10,3931,5056,2414,10970,10728,2072,60,23831,1232,6134,1448,8814,810,672,1482
2018-04-26,11,4133,5057,2398,10743,10912,1986,63,23704,1309,6597,1610,9516,748,505,1253
2018-04-26,12,4363,5039,2371,10563,11063,1945,66,23637,1348,6791,1638,9777,730,530,1260
2018-04-26,13,4545,5075,2389,10472,11216,1888,68,23644,1354,6812,1646,9812,749,620,1369
2018-04-26,14,4760,5109,2415,10600,11533,1908,71,24113,1346,6764,1647,9757,762,781,1543
2018-04-26,15,4953,5157,2437,10804,11830,1964,72,24669,1335,6668,1636,9639,820,1027,1847
2018-04-26,16,5106,5202,2455,11130,12032,2036,73,25271,1288,6348,1544,9180,872,1301,2173
2018-04-26,17,5163,5213,2505,11489,12260,2136,74,25960,1094,5689,1376,8159,915,1616,2531
2018-04-26,18,5127,5134,2469,11801,12152,2315,72,26340,927,4296,1072,6295,988,1810,2798
2018-04-26,19,5066,5083,2453,12082,12135,2372,70,26660,446,1644,462,2552,1043,1957,3000
2018-04-26,20,5046,5185,2423,12344,12371,2500,68,27283,41,121,38,200,1083,2053,3136
2018-04-26,21,4943,5101,2442,12691,12567,2562,66,27886,0,0,0,0,1127,2149,3276
2018-04-26,22,4680,4762,2304,12154,11945,2422,61,26582,0,0,0,0,1154,2216,3370
2018-04-26,23,4314,4448,2069,11277,11096,2199,55,24627,0,0,0,0,1152,2277,3429
2018-04-26,24,3985,4244,1864,10394,10202,1995,50,22641,0,0,0,0,1122,2289,3411
2018-04-27,1,3822,4210,1723,9824,9532,1869,46,21272,0,0,0,0,1077,2355,3432
2018-04-27,2,3627,4149,1655,9416,9156,1782,45,20398,0,0,0,0,1009,2356,3365
2018-04-27,3,3492,4122,1612,9160,8867,1736,43,19806,0,0,0,0,944,2372,3316
2018-04-27,4,3425,4177,1601,9091,8774,1717,43,19625,0,0,0,0,871,2395,3266
2018-04-27,5,3435,4355,1663,9291,8881,1752,45,19968,0,0,0,0,801,2445,3246
2018-04-27,6,3524,4651,1855,9856,9464,1881,48,21250,0,0,0,0,698,2454,3152
2018-04-27,7,3614,4886,2120,10747,10162,2064,51,23024,60,473,66,599,595,2417,3012
2018-04-27,8,3773,5033,2274,11294,10483,2129,53,23959,585,2992,614,4191,544,2331,2875
2018-04-27,9,3942,5105,2307,11265,10588,2093,54,24001,1098,5608,1221,7927,519,2250,2769
2018-04-27,10,4138,5154,2310,11004,10609,2012,56,23682,1261,6470,1487,9218,475,2173,2648
2018-04-27,11,4314,5172,2298,10764,10581,1935,58,23338,1329,6931,1634,9894,443,2112,2555
2018-04-27,12,4471,5190,2258,10502,10534,1864,60,22961,1363,7059,1655,10077,426,2268,2694
2018-04-27,13,4614,5256,2243,10294,10600,1829,61,22784,1367,7084,1657,10108,424,2473,2897
2018-04-27,14,4737,5326,2228,10332,10729,1844,61,22966,1365,7080,1656,10101,455,2675,3130
2018-04-27,15,4848,5394,2195,10330,10887,1871,62,23150,1360,7014,1651,10025,523,2859,3382
2018-04-27,16,4915,5424,2151,10453,11044,1943,62,23502,1318,6725,1608,9651,598,3006,3604
2018-04-27,17,4915,5423,2134,10744,11201,2042,62,24050,1117,6137,1435,8689,667,3106,3773
2018-04-27,18,4829,5363,2104,11027,11286,2169,61,24543,941,4699,1112,6752,687,3119,3806
2018-04-27,19,4753,5265,2073,11282,11325,2260,60,24926,471,1874,489,2834,680,3106,3786
2018-04-27,20,4764,5293,2064,11532,11706,2421,58,25717,43,168,44,255,674,3020,3694
2018-04-27,21,4745,5208,2137,12005,11924,2473,58,26459,0,0,0,0,633,2973,3606
2018-04-27,22,4557,4909,2097,11652,11532,2366,54,25604,0,0,0,0,604,2924,3528
2018-04-27,23,4286,4575,1959,11006,10822,2190,50,24068,0,0,0,0,574,2875,3449
2018-04-27,24,3986,4320,1805,10293,10051,2000,47,22390,0,0,0,0,489,2886,3375
2018-04-28,1,3719,4230,1691,9686,9431,1886,45,21047,0,0,0,0,445,2892,3337
2018-04-28,2,3532,4153,1635,9279,9003,1792,43,20117,0,0,0,0,365,2892,3257
2018-04-28,3,3403,4106,1604,8968,8687,1738,43,19436,0,0,0,0,307,2871,3178
2018-04-28,4,3320,4112,1603,8818,8523,1707,43,19091,0,0,0,0,233,2824,3057
2018-04-28,5,3277,4167,1644,8872,8552,1713,44,19180,0,0,0,0,203,2806,3009
2018-04-28,6,3284,4239,1744,9112,8774,1749,46,19681,0,0,0,0,210,2797,3007
2018-04-28,7,3233,4334,1891,9410,8873,1796,48,20126,53,517,49,619,215,2770,2985
2018-04-28,8,3305,4529,2021,9673,8929,1832,50,20484,549,3022,478,4049,214,2722,2936
2018-04-28,9,3495,4693,2116,9779,9003,1866,52,20700,1043,5549,1008,7600,247,2766,3013
2018-04-28,10,3686,4778,2139,9692,9041,1798,53,20584,1214,6403,1387,9004,256,2754,3010
2018-04-28,11,3833,4803,2116,9543,9054,1718,54,20369,1284,6867,1570,9721,297,2745,3042
2018-04-28,12,3917,4845,2057,9323,9039,1655,55,20072,1319,7022,1630,9971,338,2880,3218
2018-04-28,13,3983,4896,2000,9120,9072,1619,55,19866,1329,7039,1621,9989,380,3038,3418
2018-04-28,14,4052,4958,1946,9002,9159,1609,56,19826,1321,7017,1624,9962,435,3146,3581
2018-04-28,15,4148,5036,1903,8926,9338,1629,57,19951,1306,6955,1613,9874,490,3211,3701
2018-04-28,16,4230,5106,1883,9091,9618,1695,59,20462,1260,6664,1541,9465,553,3273,3826
2018-04-28,17,4277,5114,1896,9403,9958,1814,59,21233,1050,6048,1382,8480,600,3266,3866
2018-04-28,18,4305,5074,1915,9867,10278,1992,58,22195,873,4598,1082,6553,616,3239,3855
2018-04-28,19,4282,5011,1934,10318,10573,2167,57,23115,458,1809,478,2745,604,3195,3799
2018-04-28,20,4314,5079,1952,10722,10919,2351,56,24048,43,138,43,224,595,3125,3720
2018-04-28,21,4319,5048,2050,11323,11217,2400,57,24997,0,0,0,0,613,3043,3656
2018-04-28,22,4166,4807,2027,11106,10832,2306,54,24298,0,0,0,0,642,2970,3612
2018-04-28,23,3922,4522,1896,10575,10238,2146,51,23009,0,0,0,0,644,2940,3584
2018-04-28,24,3688,4262,1765,9938,9590,1970,47,21546,0,0,0,0,633,2967,3600
2018-04-29,1,3578,4041,1698,9399,8836,1846,44,20125,0,0,0,0,609,2945,3554
2018-04-29,2,3418,3954,1647,8965,8407,1753,42,19168,0,0,0,0,562,2937,3499
2018-04-29,3,3289,3926,1631,8718,8101,1703,42,18563,0,0,0,0,529,2950,3479
2018-04-29,4,3201,3920,1639,8628,7929,1679,42,18278,0,0,0,0,473,2917,3390
2018-04-29,5,3151,3944,1682,8652,7914,1672,43,18281,0,0,0,0,435,2913,3348
2018-04-29,6,3170,3977,1762,8758,7986,1692,44,18481,0,1,0,1,423,2911,3334
2018-04-29,7,3075,4047,1869,8932,8008,1761,46,18748,55,503,45,603,409,2899,3308
2018-04-29,8,3170,4214,1994,9034,8015,1820,48,18917,544,2926,445,3915,406,2858,3264
2018-04-29,9,3330,4326,2089,9084,8175,1867,50,19176,1028,5332,997,7357,403,2872,3275
2018-04-29,10,3495,4418,2117,9014,8220,1829,50,19112,1131,6254,1304,8689,341,2862,3203
2018-04-29,11,3626,4444,2095,8621,8269,1729,50,18668,1164,6738,1499,9401,307,2869,3176
2018-04-29,12,3734,4496,2043,8388,8257,1626,50,18321,1189,6892,1574,9655,262,3004,3266
2018-04-29,13,3803,4471,2016,8154,8268,1566,50,18038,1157,6902,1570,9629,234,3112,3346
2018-04-29,14,3867,4484,1983,8064,8326,1556,51,17997,1106,6843,1574,9523,230,3176,3406
2018-04-29,15,3949,4519,1949,8064,8354,1570,52,18040,1074,6760,1524,9358,300,3213,3513
2018-04-29,16,4061,4600,1936,8254,8567,1638,53,18512,1026,6386,1398,8810,398,3251,3649
2018-04-29,17,4166,4650,1959,8838,9038,1761,54,19691,877,5688,1200,7765,501,3229,3730
2018-04-29,18,4213,4572,2015,9627,9545,1956,54,21182,747,4290,883,5920,522,3161,3683
2018-04-29,19,4226,4570,2039,10313,9946,2170,53,22483,405,1703,374,2482,524,3041,3565
2018-04-29,20,4271,4743,2076,10918,10473,2377,53,23821,39,134,22,195,530,2948,3478
2018-04-29,21,4306,4781,2185,11567,10852,2419,54,24892,0,0,0,0,551,2927,3478
2018-04-29,22,4129,4577,2135,11224,10469,2300,51,24044,0,0,0,0,532,2900,3432
2018-04-29,23,3840,4316,1957,10507,9745,2110,47,22409,0,0,0,0,540,2875,3415
2018-04-29,24,3582,4146,1798,9774,9116,1920,43,20853,0,0,0,0,523,2949,3472
2018-04-30,1,3381,4029,1688,9082,8834,1792,43,19751,0,0,0,0,650,3055,3705
2018-04-30,2,3251,3996,1652,8780,8552,1725,42,19099,0,0,0,0,617,3079,3696
2018-04-30,3,3158,4003,1646,8639,8377,1689,42,18747,0,0,0,0,534,3031,3565
2018-04-30,4,3117,4088,1677,8677,8367,1674,42,18761,0,0,0,0,453,2875,3328
2018-04-30,5,3143,4300,1784,8965,8633,1714,45,19356,0,0,0,0,393,2655,3048
2018-04-30,6,3238,4622,2029,9622,9311,1857,49,20839,0,1,0,1,389,2471,2860
2018-04-30,7,3342,4896,2375,10618,9987,2064,53,22722,59,505,45,609,383,2291,2674
2018-04-30,8,3467,5040,2561,11158,10361,2194,55,23769,515,2924,420,3859,374,2027,2401
2018-04-30,9,3583,5075,2519,11071,10539,2213,56,23879,983,5254,944,7181,329,1852,2181
2018-04-30,10,3695,5109,2455,10854,10627,2155,57,23692,1118,6119,1223,8460,271,1682,1953
2018-04-30,11,3790,5114,2411,10652,10704,2107,56,23520,1193,6483,1355,9031,227,1521,1748
2018-04-30,12,3852,5095,2345,10438,10656,2045,57,23196,1275,6658,1502,9435,214,1733,1947
2018-04-30,13,3895,5095,2313,10253,10646,2000,57,22956,1300,6650,1520,9470,233,2032,2265
2018-04-30,14,3968,5065,2284,10291,10706,2000,57,23054,1148,6445,1522,9115,272,2354,2626
2018-04-30,15,4038,5042,2239,10368,10744,2024,58,23193,1138,6355,1497,8990,323,2642,2965
2018-04-30,16,4112,5031,2204,10530,10824,2084,58,23496,1099,5875,1427,8401,393,2833,3226
2018-04-30,17,4158,5012,2197,10894,11044,2162,59,24159,999,5149,1249,7397,466,2941,3407
2018-04-30,18,4225,4986,2232,11320,11188,2252,59,24820,848,3898,950,5696,514,2930,3444
2018-04-30,19,4243,4980,2261,11642,11275,2372,59,25348,439,1546,414,2399,551,2854,3405
2018-04-30,20,4319,5104,2281,11918,11835,2559,60,26371,47,122,37,206,586,2674,3260
2018-04-30,21,4352,5087,2362,12408,12166,2587,60,27220,0,0,0,0,614,2626,3240
2018-04-30,22,4159,4818,2295,11963,11612,2433,55,26063,0,0,0,0,655,2614,3269
2018-04-30,23,3831,4515,2104,11112,10709,2199,51,24071,0,0,0,0,706,2632,3338
2018-04-30,24,3576,4315,1933,10290,9894,1988,47,22219,0,0,0,0,709,2732,3441
2018-05-01,1,3380,4173,1834,9515,9498,1847,44,20904,0,0,0,0,674,2663,3337
2018-05-01,2,3258,4125,1783,9160,9098,1762,43,20063,0,0,0,0,652,2687,3339
2018-05-01,3,3189,4134,1763,8918,8860,1718,43,19539,0,0,0,0,611,2676,3287
2018-05-01,4,3155,4217,1784,8895,8771,1704,43,19413,0,0,0,0,594,2596,3190
2018-05-01,5,3191,4415,1876,9147,8984,1745,45,19921,0,0,0,0,591,2466,3057
2018-05-01,6,3301,4745,2121,9939,9592,1886,48,21466,0,1,0,1,568,2377,2945
2018-05-01,7,3372,5015,2439,10894,10281,2074,52,23301,50,408,29,487,562,2330,2892
2018-05-01,8,3458,5079,2609,11507,10845,2181,55,24587,430,2493,317,3240,495,2255,2750
2018-05-01,9,3510,5070,2557,11256,11031,2179,56,24522,751,4504,659,5914,399,2196,2595
2018-05-01,10,3552,5055,2486,10953,11163,2142,57,24314,829,5223,879,6931,344,2164,2508
2018-05-01,11,3579,5026,2411,10742,11183,2079,57,24060,874,5653,999,7526,311,2188,2499
2018-05-01,12,3575,4988,2368,10496,11161,1993,56,23707,935,5863,1121,7919,296,2236,2532
2018-05-01,13,3573,4979,2349,10299,11102,1927,56,23384,938,5761,1191,7890,273,2298,2571
2018-05-01,14,3630,4967,2315,10380,11117,1906,56,23458,928,5682,1173,7783,280,2350,2630
2018-05-01,15,3693,4949,2291,10564,11111,1917,56,23648,896,5573,1075,7544,293,2354,2647
2018-05-01,16,3746,4968,2270,10865,11198,1971,56,24090,863,5139,954,6956,351,2366,2717
2018-05-01,17,3786,4976,2281,11332,11391,2084,57,24864,747,4487,760,5994,434,2394,2828
2018-05-01,18,3813,4966,2318,11730,11566,2200,58,25554,621,3295,520,4436,492,2311,2803
2018-05-01,19,3824,4951,2329,12075,11590,2280,58,26003,332,1276,232,1840,581,2201,2782
2018-05-01,20,3904,5062,2324,12250,12003,2437,58,26748,34,101,17,152,709,2042,2751
2018-05-01,21,4012,5060,2367,12646,12407,2534,59,27646,0,0,0,0,795,1992,2787
2018-05-01,22,3858,4777,2314,12185,11910,2371,55,26521,0,0,0,0,920,1883,2803
2018-05-01,23,3716,4467,2116,11023,10989,2144,51,24207,0,0,0,0,986,1792,2778
2018-05-01,24,3483,4261,1942,10182,10148,1945,47,22322,0,0,0,0,973,1790,2763
2018-05-02,1,3269,4168,1846,9826,9419,1847,45,21137,0,0,0,0,907,1854,2761
2018-05-02,2,3156,4111,1790,9467,9046,1763,44,20320,0,0,0,0,784,1763,2547
2018-05-02,3,3101,4121,1768,9201,8824,1720,44,19789,0,0,0,0,664,1744,2408
2018-05-02,4,3085,4193,1786,9153,8759,1706,45,19663,0,0,0,0,550,1675,2225
2018-05-02,5,3136,4383,1872,9368,8997,1748,48,20161,0,0,0,0,420,1582,2002
2018-05-02,6,3265,4695,2108,9995,9620,1892,52,21560,0,1,0,1,381,1539,1920
2018-05-02,7,3344,4967,2418,10997,10303,2074,56,23430,67,421,46,534,351,1475,1826
2018-05-02,8,3414,5043,2581,11574,10809,2183,60,24626,546,2412,441,3399,333,1404,1737
2018-05-02,9,3445,5050,2529,11422,10882,2167,57,24528,1004,4248,983,6235,277,1215,1492
2018-05-02,10,3464,5057,2460,11185,10944,2111,56,24296,1128,5033,1293,7454,197,1119,1316
2018-05-02,11,3473,5050,2415,10828,10945,2044,56,23872,1179,5366,1465,8010,141,1055,1196
2018-05-02,12,3442,5025,2389,10558,10898,1963,55,23474,1204,5529,1545,8278,123,1053,1176
2018-05-02,13,3428,5024,2378,10400,10828,1911,55,23193,1202,5510,1552,8264,114,1059,1173
2018-05-02,14,3466,5017,2362,10584,10859,1909,54,23407,1189,5405,1578,8172,124,1043,1167
2018-05-02,15,3526,5007,2373,10820,10905,1942,55,23722,1184,5279,1543,8006,219,1153,1372
2018-05-02,16,3608,5023,2381,11183,11040,2013,56,24291,1165,5022,1450,7637,375,1444,1819
2018-05-02,17,3688,5026,2401,11618,11151,2123,56,24947,1091,4518,1257,6866,600,1700,2300
2018-05-02,18,3742,5003,2427,12051,11228,2234,56,25569,935,3553,986,5474,755,1758,2513
2018-05-02,19,3776,4980,2444,12324,11376,2318,56,26073,505,1442,442,2389,862,1761,2623
2018-05-02,20,3809,5080,2417,12527,11826,2469,56,26878,54,115,36,205,927,1736,2663
2018-05-02,21,3909,5097,2419,12878,12273,2563,57,27770,0,0,0,0,909,1769,2678
2018-05-02,22,3772,4826,2318,12432,11794,2405,53,26684,0,0,0,0,901,1792,2693
2018-05-02,23,3624,4516,2105,11427,10912,2179,49,24566,0,0,0,0,879,1865,2744
2018-05-02,24,3409,4303,1913,10531,10050,1971,45,22597,0,0,0,0,891,1874,2765
2018-05-03,1,3203,4150,1834,10209,9422,1850,44,21525,0,0,0,0,922,1978,2900
2018-05-03,2,3096,4096,1775,9819,9036,1783,43,20681,0,0,0,0,912,1796,2708
2018-05-03,3,3041,4102,1745,9545,8854,1743,43,20185,0,0,0,0,885,1687,2572
2018-05-03,4,3024,4174,1750,9506,8788,1720,43,20056,0,0,0,0,844,1518,2362
2018-05-03,5,3076,4365,1823,9750,9001,1761,46,20558,0,0,0,0,806,1373,2179
2018-05-03,6,3188,4677,2036,10341,9576,1882,50,21849,0,2,0,2,754,1098,1852
2018-05-03,7,3273,4943,2338,11375,10232,2090,55,23752,84,631,77,792,711,811,1522
2018-05-03,8,3358,5014,2493,12005,10624,2202,56,24887,618,3326,619,4563,650,566,1216
2018-05-03,9,3396,5018,2458,11859,10699,2212,56,24826,1072,5739,1228,8039,610,286,896
2018-05-03,10,3442,5020,2441,11430,10703,2185,56,24374,1159,6536,1490,9185,550,144,694
2018-05-03,11,3489,5002,2424,10847,10726,2115,55,23743,1201,6996,1640,9837,485,125,610
2018-05-03,12,3534,4973,2407,10581,10756,1984,56,23377,1216,7107,1658,9981,453,121,574
2018-05-03,13,3608,4975,2419,10454,10860,1911,57,23282,1216,7111,1660,9987,454,114,568
2018-05-03,14,3732,4967,2422,10635,11133,1909,58,23734,1219,7107,1662,9988,471,112,583
2018-05-03,15,3836,4953,2446,10837,11388,1942,58,24226,1212,7050,1659,9921,472,140,612
2018-05-03,16,3972,4998,2468,11186,11669,2013,59,24928,1196,6757,1614,9567,490,241,731
2018-05-03,17,4096,5022,2509,11636,11927,2123,60,25745,1161,6179,1470,8810,509,411,920
2018-05-03,18,4161,5039,2520,12098,12000,2234,60,26391,1031,4813,1162,7006,555,674,1229
2018-05-03,19,4128,4959,2514,12810,11950,2318,59,27137,549,2064,534,3147,586,901,1487
2018-05-03,20,4141,5031,2473,13015,12217,2469,58,27759,62,204,56,322,634,1112,1746
2018-05-03,21,4189,5022,2476,13377,12568,2563,59,28567,0,0,0,0,708,1132,1840
2018-05-03,22,3997,4751,2374,12928,11997,2405,55,27385,0,0,0,0,774,1084,1858
2018-05-03,23,3694,4443,2129,11893,11046,2179,49,25168,0,0,0,0,829,1005,1834
2018-05-03,24,3436,4233,1929,10955,10194,1971,45,23166,0,0,0,0,813,933,1746
2018-05-04,1,3196,4173,1834,9890,9614,1861,44,21409,0,0,0,0,857,965,1822
2018-05-04,2,3070,4117,1760,9491,9191,1773,42,20498,0,0,0,0,818,848,1666
2018-05-04,3,2999,4116,1712,9265,8913,1732,42,19951,0,0,0,0,756,723,1479
2018-05-04,4,2963,4173,1702,9205,8804,1714,42,19766,0,0,0,0,666,623,1289
2018-05-04,5,2992,4351,1758,9398,8999,1758,44,20199,0,0,0,0,579,519,1098
2018-05-04,6,3063,4628,1935,9984,9574,1875,48,21481,0,1,0,1,469,359,828
2018-05-04,7,3168,4875,2192,10809,10134,2033,51,23027,91,655,78,824,348,229,577
2018-05-04,8,3304,4994,2367,11400,10578,2129,53,24160,646,3367,635,4648,251,154,405
2018-05-04,9,3459,5039,2393,11314,10782,2111,53,24260,1051,5786,1234,8071,230,85,315
2018-05-04,10,3601,5065,2413,11078,10984,2070,53,24184,1135,6558,1486,9179,192,89,281
2018-05-04,11,3736,5069,2408,10959,11348,2042,54,24402,1177,6995,1640,9812,162,109,271
2018-05-04,12,3897,5053,2401,10587,11688,2003,56,24335,1185,7113,1656,9954,116,115,231
2018-05-04,13,4038,5079,2406,10515,11995,1971,58,24540,1166,7113,1650,9929,95,117,212
2018-05-04,14,4206,5125,2406,10648,12491,1990,61,25190,1138,7100,1641,9879,84,123,207
2018-05-04,15,4362,5150,2422,10869,12892,2044,63,25868,1146,7055,1618,9819,98,109,207
2018-05-04,16,4521,5184,2447,11182,13206,2130,65,26583,1117,6776,1540,9433,128,99,227
2018-05-04,17,4659,5159,2446,11648,13480,2242,66,27437,1068,6197,1346,8611,168,112,280
2018-05-04,18,4645,5096,2456,12059,13486,2342,66,27952,943,4822,1039,6804,233,174,407
2018-05-04,19,4565,5049,2407,12489,13224,2483,64,28260,493,2071,470,3034,315,381,696
2018-05-04,20,4517,5045,2350,12784,13180,2545,62,28571,51,212,46,309,429,650,1079
2018-05-04,21,4491,5049,2355,12976,13316,2581,61,28934,0,0,0,0,503,801,1304
2018-05-04,22,4274,4773,2284,12458,12722,2430,56,27666,0,0,0,0,581,944,1525
2018-05-04,23,3981,4478,2098,11540,11771,2218,51,25580,0,0,0,0,639,1067,1706
2018-05-04,24,3713,4260,1917,10673,10789,2024,47,23533,0,0,0,0,638,922,1560
2018-05-05,1,3523,4169,1748,10110,10214,1952,45,22320,0,0,0,0,623,648,1271
2018-05-05,2,3332,4097,1672,9599,9638,1843,43,21123,0,0,0,0,631,515,1146
2018-05-05,3,3207,4063,1614,9271,9182,1781,42,20276,0,0,0,0,625,352,977
2018-05-05,4,3122,4068,1588,9097,8955,1747,42,19841,0,0,0,0,617,250,867
2018-05-05,5,3093,4126,1605,9128,8918,1748,42,19837,0,0,0,0,616,198,814
2018-05-05,6,3087,4188,1681,9317,9054,1791,44,20207,0,2,0,2,551,158,709
2018-05-05,7,3086,4306,1789,9541,9057,1810,46,20454,72,666,77,815,466,123,589
2018-05-05,8,3229,4485,1930,9910,9290,1835,48,21083,546,3273,580,4399,370,113,483
2018-05-05,9,3458,4630,2052,10140,9740,1870,49,21798,866,5543,1086,7495,330,92,422
2018-05-05,10,3688,4706,2119,10037,10079,1881,51,22047,989,6390,1336,8715,291,110,401
2018-05-05,11,3915,4733,2124,9979,10551,1879,55,22463,1035,6843,1485,9363,233,149,382
2018-05-05,12,4140,4757,2121,9884,10976,1891,58,22809,1046,6956,1518,9520,190,174,364
2018-05-05,13,4316,4797,2107,9903,11469,1918,62,23352,1039,6938,1523,9500,171,184,355
2018-05-05,14,4502,4854,2087,9976,11930,1962,66,23935,1011,6884,1511,9406,159,187,346
2018-05-05,15,4677,4942,2094,10209,12393,2049,70,24721,1007,6789,1494,9290,198,173,371
2018-05-05,16,4837,5057,2115,10596,12875,2172,73,25716,971,6344,1408,8723,311,173,484
2018-05-05,17,4942,5168,2170,11055,13212,2309,74,26650,927,5651,1233,7811,494,255,749
2018-05-05,18,4937,5094,2169,11513,13308,2445,74,27340,705,4261,903,5869,584,345,929
2018-05-05,19,4858,5020,2151,11922,13249,2523,72,27766,377,1661,393,2431,733,474,1207
2018-05-05,20,4771,5053,2135,12055,13126,2612,68,27860,36,117,29,182,870,681,1551
2018-05-05,21,4736,5063,2157,12378,13257,2619,65,28320,0,0,0,0,912,693,1605
2018-05-05,22,4510,4804,2106,12052,12621,2482,60,27214,0,0,0,0,961,796,1757
2018-05-05,23,4245,4509,1936,11306,11749,2283,54,25392,0,0,0,0,996,894,1890
2018-05-05,24,3995,4264,1771,10474,10794,2083,49,23400,0,0,0,0,1035,900,1935
2018-05-06,1,3722,4140,1656,9869,10291,1934,47,22141,0,0,0,0,1091,926,2017
2018-05-06,2,3523,4055,1584,9373,9717,1822,44,20956,0,0,0,0,1111,919,2030
2018-05-06,3,3385,4022,1537,9100,9284,1748,43,20176,0,0,0,0,1082,849,1931
2018-05-06,4,3294,4015,1520,8936,9027,1713,42,19718,0,0,0,0,1053,779,1832
2018-05-06,5,3243,4036,1536,8941,8927,1705,43,19616,0,0,0,0,1025,739,1764
2018-05-06,6,3207,4049,1596,9053,8848,1727,43,19672,0,3,0,3,962,673,1635
2018-05-06,7,3151,4132,1667,9035,8550,1722,45,19352,85,550,77,712,907,574,1481
2018-05-06,8,3280,4320,1793,9146,8688,1740,48,19622,606,2829,551,3986,848,475,1323
2018-05-06,9,3516,4447,1928,9197,8913,1777,51,19938,1000,4909,1028,6937,811,327,1138
2018-05-06,10,3759,4524,1999,9008,9267,1785,55,20114,1090,5869,1276,8235,714,224,938
2018-05-06,11,4018,4544,2000,8873,9783,1775,59,20491,1139,6384,1448,8971,590,214,804
2018-05-06,12,4269,4678,1993,8764,10308,1762,64,20898,1174,6437,1507,9118,539,277,816
2018-05-06,13,4484,4764,1988,8770,10784,1785,68,21407,1185,6349,1592,9126,519,390,909
2018-05-06,14,4682,4890,1983,8890,11344,1855,72,22161,1195,6193,1591,8979,509,540,1049
2018-05-06,15,4851,5025,1995,9156,11979,1929,75,23139,1178,6140,1575,8893,567,671,1238
2018-05-06,16,4998,5180,2027,9570,12464,2045,78,24157,1124,5671,1503,8298,626,846,1472
2018-05-06,17,5114,5342,2059,10086,12859,2175,81,25201,1037,5048,1329,7414,693,1038,1731
2018-05-06,18,5088,5292,2115,10632,13115,2306,79,26131,889,3762,1007,5658,757,1208,1965
2018-05-06,19,4980,5237,2144,11098,13109,2401,75,26683,465,1481,464,2410,789,1412,2201
2018-05-06,20,4914,5247,2152,11355,12957,2489,71,26872,47,102,50,199,818,1638,2456
2018-05-06,21,4888,5209,2181,11825,13072,2533,68,27498,0,0,0,0,833,1753,2586
2018-05-06,22,4656,4893,2111,11627,12568,2371,62,26628,0,0,0,0,828,1816,2644
2018-05-06,23,4364,4511,1919,10796,11563,2148,55,24561,0,0,0,0,833,1840,2673
2018-05-06,24,4030,4271,1746,9945,10537,1961,50,22493,0,0,0,0,819,1881,2700
2018-05-07,1,3745,4248,1665,9834,9692,1870,47,21444,0,0,0,0,807,2001,2808
2018-05-07,2,3556,4188,1608,9417,9215,1794,45,20472,0,0,0,0,774,2025,2799
2018-05-07,3,3435,4163,1581,9125,8970,1745,44,19883,0,0,0,0,723,1956,2679
2018-05-07,4,3353,4218,1590,9065,8841,1730,43,19680,0,0,0,0,668,1901,2569
2018-05-07,5,3359,4400,1671,9280,9043,1774,44,20142,0,0,0,0,597,1813,2410
2018-05-07,6,3442,4671,1873,9844,9634,1900,47,21425,0,4,0,4,545,1702,2247
2018-05-07,7,3523,4968,2175,10731,10284,2070,49,23134,94,613,90,797,490,1535,2025
2018-05-07,8,3707,5178,2363,11442,10825,2156,53,24476,660,3072,618,4350,414,1342,1756
2018-05-07,9,3916,5351,2385,11446,11084,2157,57,24744,1084,5307,1203,7594,315,1161,1476
2018-05-07,10,4144,5482,2397,11209,11392,2125,62,24788,1177,6194,1474,8845,206,947,1153
2018-05-07,11,4378,5570,2399,11007,11739,2091,66,24903,1215,6691,1636,9542,130,806,936
2018-05-07,12,4627,5646,2395,10906,12130,2073,70,25179,1226,6839,1651,9716,103,875,978
2018-05-07,13,4871,5740,2416,10908,12536,2080,73,25597,1231,6907,1655,9793,102,1000,1102
2018-05-07,14,5130,5828,2429,11154,13077,2118,76,26425,1227,6903,1654,9784,124,1212,1336
2018-05-07,15,5374,5885,2453,11417,13578,2173,79,27247,1228,6839,1650,9717,217,1566,1783
2018-05-07,16,5547,5909,2481,11784,13968,2265,81,28098,1219,6521,1633,9373,337,1898,2235
2018-05-07,17,5655,5902,2512,12308,14137,2372,82,28900,1179,5925,1471,8575,494,2197,2691
2018-05-07,18,5605,5843,2551,12807,14184,2479,80,29550,1056,4652,1153,6861,543,2296,2839
2018-05-07,19,5483,5656,2527,13149,13868,2551,78,29645,569,1967,551,3087,650,2380,3030
2018-05-07,20,5364,5644,2499,13303,13750,2648,74,29775,67,165,50,282,745,2406,3151
2018-05-07,21,5286,5602,2489,13549,13915,2656,71,30192,0,0,0,0,729,2393,3122
2018-05-07,22,4970,5220,2380,12953,13087,2477,65,28583,0,0,0,0,703,2356,3059
2018-05-07,23,4574,4816,2137,11747,11862,2228,58,25896,0,0,0,0,693,2282,2975
2018-05-07,24,4208,4538,1927,10806,10774,2017,53,23649,0,0,0,0,781,2244,3025
2018-05-08,1,3829,4369,1813,10094,10089,1930,50,22164,0,0,0,0,912,2346,3258
2018-05-08,2,3616,4276,1741,9604,9549,1843,48,21044,0,0,0,0,907,2257,3164
2018-05-08,3,3481,4234,1693,9302,9101,1794,46,20243,0,0,0,0,897,2086,2983
2018-05-08,4,3405,4267,1677,9220,8981,1774,45,20021,0,0,0,0,861,1895,2756
2018-05-08,5,3393,4438,1734,9415,9172,1812,47,20445,0,0,0,0,811,1700,2511
2018-05-08,6,3464,4706,1927,9954,9767,1920,50,21692,0,8,0,8,779,1470,2249
2018-05-08,7,3542,4992,2202,10750,10340,2112,53,23255,99,763,102,964,738,1189,1927
2018-05-08,8,3780,5171,2375,11395,10805,2177,57,24433,674,3456,658,4788,693,916,1609
2018-05-08,9,4011,5300,2413,11517,11198,2147,60,24923,1074,5683,1215,7972,692,617,1309
2018-05-08,10,4264,5411,2420,11311,11479,2049,64,24903,1147,6452,1454,9053,667,341,1008
2018-05-08,11,4539,5487,2412,11254,11823,2020,69,25165,1167,6900,1595,9662,627,209,836
2018-05-08,12,4821,5551,2428,11276,12219,2010,74,25579,1158,7021,1617,9796,591,260,851
2018-05-08,13,5069,5636,2481,11290,12652,1997,78,26018,1128,6953,1589,9670,591,376,967
2018-05-08,14,5354,5728,2525,11440,13226,2028,82,26776,1090,6899,1548,9537,603,593,1196
2018-05-08,15,5604,5813,2545,11712,13752,2097,86,27647,1069,6816,1513,9398,689,1263,1952
2018-05-08,16,5807,5870,2581,12038,14224,2167,88,28517,1001,6369,1411,8781,780,1955,2735
2018-05-08,17,5871,5915,2585,12535,14573,2303,90,29502,918,5684,1206,7808,865,2453,3318
2018-05-08,18,5819,5780,2556,13032,14628,2451,89,30201,788,4296,915,5999,947,2609,3556
2018-05-08,19,5709,5685,2557,13439,14343,2576,86,30445,417,1649,414,2480,1004,2709,3713
2018-05-08,20,5574,5668,2512,13556,14183,2695,82,30516,46,103,34,183,1057,2757,3814
2018-05-08,21,5477,5641,2488,13729,14344,2698,78,30848,1,0,0,1,1086,2728,3814
2018-05-08,22,5154,5253,2391,13162,13659,2532,71,29424,0,0,0,0,1098,2721,3819
2018-05-08,23,4745,4846,2161,12000,12456,2284,63,26804,0,0,0,0,1094,2654,3748
2018-05-08,24,4344,4563,1948,10965,11280,2060,57,24361,0,0,0,0,1048,2638,3686
2018-05-09,1,4062,4370,1785,10341,10223,1935,52,22551,0,0,0,0,1091,2722,3813
2018-05-09,2,3840,4280,1707,9942,9666,1847,50,21504,0,0,0,0,1043,2650,3693
2018-05-09,3,3683,4244,1654,9684,9330,1802,48,20863,0,0,0,0,983,2593,3576
2018-05-09,4,3590,4278,1637,9563,9168,1775,47,20553,0,0,0,0,914,2453,3367
2018-05-09,5,3566,4447,1688,9661,9348,1813,49,20871,0,0,0,0,867,2339,3206
2018-05-09,6,3622,4703,1864,10119,9910,1922,53,22003,0,6,0,6,879,2264,3143
2018-05-09,7,3717,4988,2132,10890,10505,2073,56,23523,121,755,113,989,884,2159,3043
2018-05-09,8,3947,5170,2320,11534,11011,2143,60,24747,721,3430,689,4840,892,1989,2881
2018-05-09,9,4185,5304,2365,11550,11318,2149,63,25080,1083,5616,1224,7923,874,1814,2688
2018-05-09,10,4468,5415,2378,11311,11640,2088,67,25107,1174,6416,1467,9057,827,1672,2499
2018-05-09,11,4763,5502,2386,11144,12014,2066,73,25297,1210,6847,1617,9674,755,1532,2287
2018-05-09,12,5059,5583,2386,11094,12426,2050,78,25647,1218,7003,1644,9865,720,1588,2308
2018-05-09,13,5334,5695,2392,11058,12867,2048,83,26057,1229,7047,1649,9925,722,1719,2441
2018-05-09,14,5622,5810,2385,11241,13436,2071,88,26837,1227,7034,1649,9910,740,1894,2634
2018-05-09,15,5879,5918,2381,11434,13939,2134,91,27598,1225,6973,1648,9846,801,2092,2893
2018-05-09,16,6071,6000,2373,11781,14426,2212,94,28513,1214,6711,1595,9520,880,2287,3167
2018-05-09,17,6134,6027,2364,12226,14749,2334,95,29404,1181,6148,1451,8780,968,2482,3450
2018-05-09,18,6051,5997,2378,12644,14788,2477,94,30003,1071,4877,1178,7126,1024,2546,3570
2018-05-09,19,5917,5848,2383,12966,14458,2590,89,30103,614,2170,571,3355,1057,2574,3631
2018-05-09,20,5765,5792,2351,13079,14246,2696,84,30105,90,209,64,363,1076,2558,3634
2018-05-09,21,5673,5755,2348,13299,14349,2718,79,30445,1,0,0,1,1062,2593,3655
2018-05-09,22,5345,5338,2312,12857,13603,2558,72,29090,0,0,0,0,1036,2601,3637
2018-05-09,23,4947,4901,2118,11831,12413,2310,64,26618,0,0,0,0,1031,2596,3627
2018-05-09,24,4541,4591,1926,10851,11252,2088,58,24249,0,0,0,0,1030,2642,3672
2018-05-10,1,4210,4395,1774,10169,10196,1909,52,22326,0,0,0,0,1112,2504,3616
2018-05-10,2,3988,4294,1705,9795,9674,1823,50,21342,0,0,0,0,1091,2532,3623
2018-05-10,3,3830,4254,1670,9572,9320,1774,48,20714,0,0,0,0,1038,2488,3526
2018-05-10,4,3742,4289,1671,9556,9161,1750,47,20514,0,0,0,0,972,2396,3368
2018-05-10,5,3723,4457,1738,9610,9332,1787,48,20777,0,0,0,0,869,2311,3180
2018-05-10,6,3779,4707,1942,10076,9804,1906,52,21837,0,5,0,5,750,2212,2962
2018-05-10,7,3862,4977,2249,10829,10456,2063,54,23403,129,799,123,1051,616,2080,2696
2018-05-10,8,4040,5174,2425,11442,10948,2163,58,24610,753,3471,711,4935,506,1853,2359
2018-05-10,9,4251,5330,2407,11411,11228,2164,62,24864,1111,5628,1246,7985,413,1681,2094
2018-05-10,10,4483,5456,2393,11173,11400,2103,67,24743,1176,6418,1482,9076,334,1546,1880
2018-05-10,11,4716,5542,2382,10961,11679,2042,71,24754,1207,6866,1624,9697,264,1499,1763
2018-05-10,12,4957,5593,2369,10846,11984,2007,76,24913,1213,7027,1653,9893,245,1666,1911
2018-05-10,13,5171,5659,2362,10812,12335,2020,80,25247,1194,7028,1651,9873,253,1864,2117
2018-05-10,14,5379,5732,2343,11036,12801,2040,83,25960,1170,6999,1641,9810,312,2072,2384
2018-05-10,15,5558,5784,2316,11254,13235,2097,85,26671,1152,6918,1625,9695,407,2403,2810
2018-05-10,16,5688,5820,2306,11600,13572,2198,87,27457,1089,6580,1553,9222,530,2656,3186
2018-05-10,17,5723,5761,2299,12072,13860,2322,88,28342,1016,5949,1398,8363,669,2852,3521
2018-05-10,18,5623,5706,2310,12581,13786,2427,86,28879,899,4662,1129,6690,780,2949,3729
2018-05-10,19,5502,5518,2312,12965,13508,2513,81,29068,504,1941,548,2993,845,2994,3839
2018-05-10,20,5397,5506,2302,13091,13381,2633,77,29182,69,167,65,301,900,2997,3897
2018-05-10,21,5341,5520,2338,13258,13539,2643,74,29514,1,0,0,1,904,2983,3887
2018-05-10,22,5066,5206,2312,12842,12890,2476,68,28276,0,0,0,0,896,2941,3837
2018-05-10,23,4718,4836,2132,11811,11857,2242,61,25971,0,0,0,0,870,2879,3749
2018-05-10,24,4358,4560,1951,10858,10775,2037,55,23725,0,0,0,0,784,2890,3674
2018-05-11,1,4068,4290,1800,10259,9913,1907,50,22129,0,0,0,0,655,3038,3693
2018-05-11,2,3845,4187,1736,9844,9447,1816,48,21155,0,0,0,0,626,3021,3647
2018-05-11,3,3696,4153,1710,9677,9129,1769,46,20620,0,0,0,0,578,2974,3552
2018-05-11,4,3604,4185,1720,9605,8981,1743,45,20374,0,0,0,0,550,2896,3446
2018-05-11,5,3590,4340,1796,9678,9165,1779,46,20667,0,0,0,0,533,2862,3395
2018-05-11,6,3637,4569,1993,10110,9735,1877,48,21770,0,5,0,5,512,2835,3347
2018-05-11,7,3708,4838,2277,10929,10360,2049,49,23388,121,721,109,951,491,2782,3273
2018-05-11,8,3871,5028,2453,11463,10771,2186,52,24472,709,3167,653,4529,483,2751,3234
2018-05-11,9,4034,5143,2441,11355,10945,2239,55,24594,1080,5188,1168,7436,532,2788,3320
2018-05-11,10,4222,5229,2401,11229,11122,2205,59,24615,1164,6085,1413,8662,643,2817,3460
2018-05-11,11,4398,5271,2361,11186,11239,2065,63,24552,1194,6590,1578,9362,727,2847,3574
2018-05-11,12,4558,5257,2330,11008,11333,1955,66,24362,1211,6750,1618,9579,781,2968,3749
2018-05-11,13,4707,5256,2303,10849,11364,1923,69,24205,1227,6799,1630,9656,808,3050,3858
2018-05-11,14,4857,5248,2278,11028,11428,1918,72,24446,1224,6769,1634,9627,822,3096,3918
2018-05-11,15,4984,5228,2246,11216,11469,1942,74,24701,1223,6687,1619,9529,840,3136,3976
2018-05-11,16,5046,5212,2235,11521,11586,1972,75,25154,1217,6362,1554,9133,879,3163,4042
2018-05-11,17,5064,5192,2253,11900,11598,2055,75,25628,1180,5777,1393,8350,903,3174,4077
2018-05-11,18,4964,5117,2251,12243,11617,2166,73,26100,1071,4513,1125,6709,926,3108,4034
2018-05-11,19,4839,5069,2231,12627,11633,2247,70,26577,644,2021,564,3229,911,2994,3905
2018-05-11,20,4766,5109,2202,12804,11686,2376,67,26933,96,200,64,360,943,2769,3712
2018-05-11,21,4774,5192,2202,13011,12031,2470,65,27577,1,0,0,1,966,2696,3662
2018-05-11,22,4577,5029,2187,12679,11716,2371,61,26827,0,0,0,0,978,2639,3617
2018-05-11,23,4298,4757,2033,11848,10985,2191,56,25080,0,0,0,0,961,2496,3457
2018-05-11,24,3986,4502,1873,10950,10165,2007,50,23172,0,0,0,0,928,2244,3172
2018-05-12,1,3742,4146,1757,10393,9375,1868,44,21681,0,0,0,0,907,2215,3122
2018-05-12,2,3535,4067,1692,9831,8980,1772,43,20626,0,0,0,0,875,2033,2908
2018-05-12,3,3394,4049,1655,9498,8642,1711,42,19892,0,0,0,0,843,1873,2716
2018-05-12,4,3296,4061,1647,9313,8491,1683,41,19529,0,0,0,0,801,1723,2524
2018-05-12,5,3261,4123,1680,9302,8565,1693,41,19602,0,0,0,0,790,1570,2360
2018-05-12,6,3236,4176,1752,9383,8738,1740,42,19903,0,10,0,10,750,1451,2201
2018-05-12,7,3186,4285,1850,9601,8803,1809,43,20257,138,865,122,1125,725,1341,2066
2018-05-12,8,3271,4489,1976,9883,8981,1904,47,20815,760,3578,688,5026,702,1174,1876
2018-05-12,9,3446,4597,2063,10184,9127,1966,49,21326,1118,5722,1208,8048,651,1119,1770
2018-05-12,10,3620,4651,2126,10300,9176,1920,50,21446,1185,6453,1435,9073,568,1066,1634
2018-05-12,11,3767,4667,2136,10117,9113,1846,52,21128,1209,6891,1590,9690,431,999,1430
2018-05-12,12,3864,4656,2104,9961,8998,1760,54,20773,1218,7028,1625,9871,285,1106,1391
2018-05-12,13,3937,4628,2077,9991,8999,1706,56,20751,1215,7033,1623,9871,220,1268,1488
2018-05-12,14,4026,4608,2056,10076,9035,1683,57,20851,1201,7022,1630,9853,192,1496,1688
2018-05-12,15,4113,4597,2055,10285,9178,1705,59,21226,1170,6955,1609,9734,203,1821,2024
2018-05-12,16,4204,4639,2065,10640,9338,1773,61,21812,1119,6629,1522,9270,238,2069,2307
2018-05-12,17,4277,4693,2089,10925,9558,1872,63,22418,1032,6064,1354,8450,385,2249,2634
2018-05-12,18,4285,4705,2113,11253,9814,1990,62,23119,900,4820,1092,6812,633,2295,2928
2018-05-12,19,4209,4709,2161,11593,10000,2145,60,23798,500,2189,553,3242,710,2254,2964
2018-05-12,20,4174,4787,2138,11805,10298,2256,59,24418,65,233,69,367,797,2133,2930
2018-05-12,21,4233,4883,2140,12093,10798,2368,58,25316,1,0,0,1,883,2113,2996
2018-05-12,22,4096,4732,2087,11858,10562,2287,55,24761,0,0,0,0,1014,2124,3138
2018-05-12,23,3858,4483,1915,11145,9991,2130,51,23316,0,0,0,0,1061,2067,3128
2018-05-12,24,3621,4264,1765,10368,9356,1963,47,21734,0,0,0,0,1074,1961,3035
2018-05-13,1,3485,4087,1704,9913,8968,1806,44,20731,0,0,0,0,1080,1923,3003
2018-05-13,2,3314,4015,1634,9485,8606,1718,43,19850,0,0,0,0,1067,1882,2949
2018-05-13,3,3197,3993,1587,9172,8356,1657,42,19227,0,0,0,0,1060,1854,2914
2018-05-13,4,3122,4008,1572,9000,8210,1635,41,18886,0,0,0,0,1030,1824,2854
2018-05-13,5,3098,4039,1589,8985,8212,1642,42,18881,0,0,0,0,983,1791,2774
2018-05-13,6,3052,4042,1638,9074,8281,1671,44,19070,0,8,0,8,907,1682,2589
2018-05-13,7,2981,4112,1706,9015,8131,1674,45,18865,121,841,113,1075,824,1589,2413
2018-05-13,8,3097,4280,1821,9099,8155,1709,47,19011,681,3488,641,4810,733,1436,2169
2018-05-13,9,3297,4338,1958,9029,7965,1742,49,18785,1042,5603,1163,7808,693,1285,1978
2018-05-13,10,3495,4382,2021,8925,8003,1706,50,18684,1129,6347,1425,8901,611,1141,1752
2018-05-13,11,3633,4370,2022,8799,7990,1634,51,18474,1167,6783,1582,9532,527,1032,1559
2018-05-13,12,3735,4412,2017,8709,7919,1557,52,18237,1180,6913,1616,9709,575,1119,1694
2018-05-13,13,3837,4396,2043,8709,7941,1523,54,18227,1178,6926,1631,9735,660,1249,1909
2018-05-13,14,3935,4418,2068,8815,8093,1534,56,18499,1165,6918,1625,9708,746,1438,2184
2018-05-13,15,4060,4446,2098,9035,8341,1584,58,19018,1131,6847,1611,9589,871,1768,2639
2018-05-13,16,4232,4559,2146,9429,8706,1680,60,19876,1109,6501,1554,9164,970,2073,3043
2018-05-13,17,4404,4620,2231,9945,9098,1804,63,20911,1041,5925,1394,8360,1082,2355,3437
2018-05-13,18,4419,4678,2275,10556,9609,1968,64,22196,897,4716,1150,6763,1110,2462,3572
2018-05-13,19,4399,4652,2300,10991,9872,2108,62,23033,543,2174,587,3304,1126,2538,3664
2018-05-13,20,4406,4737,2300,11223,10297,2240,61,23821,75,235,71,381,1131,2562,3693
2018-05-13,21,4468,4808,2285,11706,10853,2362,59,24981,1,0,0,1,1115,2568,3683
2018-05-13,22,4294,4595,2209,11590,10572,2257,56,24474,0,0,0,0,1098,2496,3594
2018-05-13,23,3985,4317,1996,10807,9960,2065,50,22882,0,0,0,0,1085,2376,3461
2018-05-13,24,3687,4123,1800,10006,9300,1885,45,21237,0,0,0,0,1077,2312,3389
2018-05-14,1,3459,4008,1730,9714,8853,1852,42,20462,0,0,0,0,1160,2303,3463
2018-05-14,2,3301,3973,1671,9357,8570,1772,41,19740,0,0,0,0,1142,2220,3362
2018-05-14,3,3182,3981,1634,9192,8402,1734,40,19368,0,0,0,0,1096,2175,3271
2018-05-14,4,3118,4061,1629,9176,8394,1719,41,19329,0,0,0,0,1052,2106,3158
2018-05-14,5,3113,4258,1692,9378,8686,1757,43,19863,0,0,0,0,1032,2050,3082
2018-05-14,6,3209,4556,1862,10049,9311,1883,46,21289,0,10,0,10,986,1915,2901
2018-05-14,7,3304,4830,2141,10927,9952,2052,50,22981,129,893,108,1130,940,1782,2722
2018-05-14,8,3495,4955,2338,11541,10431,2158,53,24183,699,3659,593,4951,880,1648,2528
2018-05-14,9,3679,4998,2399,11539,10587,2168,54,24348,1037,5759,1066,7862,826,1372,2198
2018-05-14,10,3849,5026,2421,11216,10688,2129,56,24089,1125,6478,1304,8907,732,1064,1796
2018-05-14,11,4002,5030,2444,10841,10792,2075,57,23765,1155,6903,1456,9514,643,739,1382
2018-05-14,12,4120,5010,2475,10718,10813,1992,60,23583,1168,7031,1502,9701,675,671,1346
2018-05-14,13,4230,5013,2533,10601,10821,1968,62,23452,1168,7043,1509,9720,735,726,1461
2018-05-14,14,4368,4994,2576,10765,10994,1972,64,23795,1142,7026,1496,9664,822,871,1693
2018-05-14,15,4489,4974,2606,10927,11184,2005,66,24181,1103,6964,1474,9541,955,1153,2108
2018-05-14,16,4614,4985,2633,11285,11413,2072,67,24837,1077,6691,1396,9164,1076,1514,2590
2018-05-14,17,4701,5000,2677,11595,11629,2189,68,25481,1038,6160,1334,8532,1155,1875,3030
2018-05-14,18,4722,5066,2672,12137,11700,2331,68,26236,888,4977,1076,6941,1179,2050,3229
2018-05-14,19,4724,4983,2663,12632,11718,2425,67,26841,521,2354,547,3422,1181,2156,3337
2018-05-14,20,4652,5012,2625,13003,11904,2556,65,27529,73,253,66,392,1173,2149,3322
2018-05-14,21,4672,5034,2585,13251,12328,2611,64,28253,2,0,0,2,1167,2221,3388
2018-05-14,22,4447,4763,2460,12831,11853,2467,59,27210,0,0,0,0,1161,2299,3460
2018-05-14,23,4116,4441,2213,11809,10992,2225,53,25078,0,0,0,0,1157,2292,3449
2018-05-14,24,3788,4223,1990,10923,10098,2011,48,23080,0,0,0,0,1160,2240,3400
2018-05-15,1,3572,4103,1852,10195,9400,1840,44,21479,0,0,0,0,1147,2120,3267
2018-05-15,2,3398,4052,1773,9705,8942,1757,42,20446,0,0,0,0,1120,2029,3149
2018-05-15,3,3287,4043,1719,9401,8696,1717,41,19855,0,0,0,0,1070,1982,3052
2018-05-15,4,3214,4103,1697,9265,8562,1702,42,19571,0,0,0,0,1005,1895,2900
2018-05-15,5,3211,4291,1743,9462,8708,1741,43,19955,0,0,0,0,933,1794,2727
2018-05-15,6,3286,4575,1904,9982,9311,1870,47,21210,0,9,0,9,889,1638,2527
2018-05-15,7,3400,4852,2160,10787,10163,2043,51,23043,119,894,115,1128,816,1486,2302
2018-05-15,8,3592,4962,2365,11528,10727,2158,53,24467,661,3646,638,4945,749,1258,2007
2018-05-15,9,3755,4997,2416,11550,10952,2168,54,24724,971,5727,1136,7834,729,1000,1729
2018-05-15,10,3920,5029,2434,11297,10954,2129,55,24435,1061,6455,1386,8902,663,791,1454
2018-05-15,11,4082,5041,2453,11011,10877,2075,58,24021,1087,6851,1551,9489,588,638,1226
2018-05-15,12,4209,5035,2494,10724,10820,1992,61,23597,1122,6984,1601,9707,570,686,1256
2018-05-15,13,4334,5077,2557,10587,10820,1968,63,23438,1126,7012,1608,9746,599,810,1409
2018-05-15,14,4480,5107,2602,10693,10962,1972,65,23691,1102,7002,1600,9704,664,939,1603
2018-05-15,15,4630,5156,2632,10843,11106,2005,67,24021,1091,6942,1584,9617,751,1113,1864
2018-05-15,16,4786,5207,2664,11135,11280,2072,69,24556,1059,6647,1453,9159,851,1270,2121
2018-05-15,17,4844,5226,2688,11576,11453,2189,70,25289,1024,6107,1299,8430,950,1404,2354
2018-05-15,18,4845,5241,2663,11979,11489,2331,70,25869,868,4938,1062,6868,1013,1423,2436
2018-05-15,19,4761,5163,2627,12468,11599,2425,68,26560,482,2302,521,3305,1058,1442,2500
2018-05-15,20,4696,5159,2584,12877,12002,2556,66,27501,67,252,63,382,1082,1374,2456
2018-05-15,21,4718,5166,2543,13204,12272,2611,63,28151,2,0,0,2,1064,1467,2531
2018-05-15,22,4503,4823,2449,12880,11822,2467,58,27227,0,0,0,0,1038,1533,2571
2018-05-15,23,4184,4468,2213,11930,10971,2225,52,25179,0,0,0,0,1016,1558,2574
2018-05-15,24,3848,4251,1991,11036,10094,2011,48,23188,0,0,0,0,964,1556,2520
2018-05-16,1,3710,4188,1817,9880,9416,1888,45,21230,0,0,0,0,953,1707,2660
2018-05-16,2,3526,4120,1730,9471,9019,1800,44,20334,0,0,0,0,859,1681,2540
2018-05-16,3,3406,4096,1677,9264,8779,1761,43,19847,0,0,0,0,813,1646,2459
2018-05-16,4,3325,4145,1657,9166,8697,1737,43,19644,0,0,0,0,772,1613,2385
2018-05-16,5,3319,4322,1703,9388,8917,1777,45,20127,0,0,0,0,749,1525,2274
2018-05-16,6,3401,4592,1864,9891,9428,1895,48,21262,0,9,0,9,736,1362,2098
2018-05-16,7,3488,4857,2120,10676,10052,2067,52,22846,86,917,97,1100,704,1240,1944
2018-05-16,8,3679,4997,2321,11366,10600,2165,55,24185,484,3662,522,4668,658,1113,1771
2018-05-16,9,3846,5072,2371,11427,10806,2163,56,24451,729,5730,949,7408,628,1003,1631
2018-05-16,10,4009,5132,2387,11301,10840,2093,57,24291,804,6459,1192,8455,571,913,1484
2018-05-16,11,4160,5170,2406,11107,10859,2026,60,24052,850,6890,1347,9087,541,904,1445
2018-05-16,12,4282,5203,2415,10858,10855,1955,62,23730,938,7028,1435,9401,509,1072,1581
2018-05-16,13,4392,5278,2445,10677,10852,1935,65,23529,992,7030,1488,9510,471,1322,1793
2018-05-16,14,4526,5353,2461,10728,11039,1952,68,23786,1005,7026,1507,9538,454,1601,2055
2018-05-16,15,4662,5428,2471,10864,11131,1977,70,24042,1022,6962,1480,9464,485,1951,2436
2018-05-16,16,4798,5485,2452,11084,11211,2024,72,24391,1013,6675,1390,9078,533,2234,2767
2018-05-16,17,4838,5551,2437,11401,11361,2122,73,24957,989,6146,1230,8365,580,2490,3070
2018-05-16,18,4801,5437,2432,11779,11508,2254,72,25614,862,4975,996,6833,656,2631,3287
2018-05-16,19,4724,5370,2413,12172,11643,2394,70,26279,492,2375,493,3360,715,2728,3443
2018-05-16,20,4680,5336,2384,12431,11888,2545,67,26931,71,268,62,401,744,2796,3540
2018-05-16,21,4725,5366,2373,12815,12414,2599,65,27894,2,0,0,2,777,2823,3600
2018-05-16,22,4521,5011,2320,12556,11960,2453,60,27030,0,0,0,0,840,2823,3663
2018-05-16,23,4201,4607,2145,11693,11091,2221,54,25059,0,0,0,0,884,2835,3719
2018-05-16,24,3874,4340,1949,10801,10201,2010,49,23061,0,0,0,0,876,2858,3734
2018-05-17,1,3685,4227,1798,9934,9436,1884,45,21300,0,0,0,0,831,2879,3710
2018-05-17,2,3502,4148,1720,9529,9047,1796,43,20416,0,0,0,0,796,2854,3650
2018-05-17,3,3370,4119,1672,9292,8799,1755,42,19888,0,0,0,0,709,2827,3536
2018-05-17,4,3306,4159,1663,9239,8709,1733,42,19723,0,0,0,0,601,2781,3382
2018-05-17,5,3314,4326,1723,9477,8924,1772,44,20217,0,0,0,0,500,2727,3227
2018-05-17,6,3376,4574,1906,10116,9492,1884,48,21540,0,9,0,9,508,2672,3180
2018-05-17,7,3475,4846,2187,10947,10056,2058,51,23112,151,928,114,1193,492,2557,3049
2018-05-17,8,3658,5010,2359,11570,10530,2165,54,24319,725,3652,608,4985,456,2421,2877
2018-05-17,9,3806,5106,2379,11504,10663,2178,55,24400,1049,5718,1108,7875,423,2325,2748
2018-05-17,10,3958,5188,2401,11357,10772,2139,57,24325,1126,6450,1395,8971,381,2208,2589
2018-05-17,11,4080,5235,2405,11082,10815,2047,60,24004,1160,6891,1571,9622,336,2147,2483
2018-05-17,12,4178,5267,2402,10791,10812,1953,62,23618,1186,7033,1631,9850,335,2240,2575
2018-05-17,13,4271,5341,2417,10497,10847,1918,65,23327,1209,7048,1642,9899,354,2375,2729
2018-05-17,14,4399,5409,2424,10638,11004,1917,67,23626,1190,7043,1641,9874,394,2510,2904
2018-05-17,15,4530,5482,2423,10717,11093,1925,69,23803,1161,6969,1626,9756,519,2751,3270
2018-05-17,16,4643,5564,2419,10915,11302,1967,70,24254,1115,6667,1571,9353,660,2929,3589
2018-05-17,17,4717,5499,2447,11341,11429,2072,72,24914,1048,6103,1409,8560,804,3040,3844
2018-05-17,18,4679,5401,2429,11796,11488,2209,71,25564,913,4952,1160,7025,878,3022,3900
2018-05-17,19,4605,5306,2423,12371,11620,2354,69,26414,605,2381,593,3579,955,3018,3973
2018-05-17,20,4557,5292,2405,12865,11865,2496,66,27292,150,275,83,508,1019,2982,4001
2018-05-17,21,4613,5312,2391,13163,12393,2562,65,28183,4,0,0,4,1030,2984,4014
2018-05-17,22,4425,4985,2314,12815,11941,2428,60,27244,0,0,0,0,1039,3002,4041
2018-05-17,23,4121,4616,2131,11903,11105,2198,54,25260,0,0,0,0,1051,2999,4050
2018-05-17,24,3803,4358,1938,10998,10200,1996,49,23243,0,0,0,0,1021,3049,4070
2018-05-18,1,3648,4165,1789,10356,9583,1922,46,21907,0,0,0,0,1020,3106,4126
2018-05-18,2,3468,4083,1710,9841,9164,1831,44,20881,0,0,0,0,960,3082,4042
2018-05-18,3,3333,4055,1665,9581,8857,1783,43,20264,0,0,0,0,915,3046,3961
2018-05-18,4,3256,4092,1657,9495,8728,1748,43,20014,0,0,0,0,862,2981,3843
2018-05-18,5,3258,4251,1715,9662,8868,1780,45,20354,0,0,0,0,813,2910,3723
2018-05-18,6,3311,4473,1886,10167,9407,1859,48,21481,0,13,0,13,780,2804,3584
2018-05-18,7,3391,4750,2141,10897,10066,2035,50,23048,151,956,127,1234,734,2604,3338
2018-05-18,8,3608,4906,2321,11575,10516,2188,53,24331,779,3670,669,5118,704,2348,3052
2018-05-18,9,3807,4995,2349,11556,10696,2254,53,24560,1110,5675,1172,7957,635,2028,2663
2018-05-18,10,3988,5049,2371,11406,10825,2203,55,24488,1200,6391,1429,9020,549,1680,2229
2018-05-18,11,4155,5057,2377,11238,10769,2023,59,24089,1237,6825,1592,9654,458,1298,1756
2018-05-18,12,4307,5017,2367,11026,10645,1914,62,23647,1243,6961,1639,9843,419,1239,1658
2018-05-18,13,4470,5019,2360,10803,10614,1890,65,23372,1252,6970,1651,9873,404,1223,1627
2018-05-18,14,4653,5025,2357,10958,10818,1893,69,23738,1249,6970,1650,9869,406,1297,1703
2018-05-18,15,4844,5044,2341,11123,10896,1929,72,24019,1237,6909,1638,9784,558,1832,2390
2018-05-18,16,5009,5041,2330,11376,10998,1963,74,24411,1194,6608,1559,9361,713,2372,3085
2018-05-18,17,5119,5024,2333,11752,11247,2050,77,25125,1161,6052,1397,8610,861,2785,3646
2018-05-18,18,5107,4999,2340,12003,11381,2169,76,25628,1045,4921,1148,7114,939,2849,3788
2018-05-18,19,4996,4896,2306,12283,11445,2259,74,26062,639,2362,580,3581,1001,2880,3881
2018-05-18,20,4872,4874,2266,12639,11657,2415,71,26782,150,280,79,509,1049,2862,3911
2018-05-18,21,4851,4932,2247,12855,12038,2501,68,27462,3,0,0,3,1055,2852,3907
2018-05-18,22,4627,4774,2212,12650,11620,2403,63,26735,0,0,0,0,1064,2842,3906
2018-05-18,23,4324,4505,2075,11923,10937,2216,57,25133,0,0,0,0,1083,2807,3890
2018-05-18,24,4025,4266,1898,11097,10131,2023,51,23303,0,0,0,0,1095,2793,3888
2018-05-19,1,3816,4108,1736,10277,9432,1892,47,21647,0,0,0,0,1128,2767,3895
2018-05-19,2,3603,4032,1662,9798,9023,1793,44,20658,0,0,0,0,1135,2740,3875
2018-05-19,3,3472,4005,1619,9470,8730,1730,42,19973,0,0,0,0,1110,2658,3768
2018-05-19,4,3375,4011,1603,9301,8582,1697,42,19622,0,0,0,0,1071,2557,3628
2018-05-19,5,3330,4071,1624,9306,8624,1699,42,19671,0,0,0,0,1056,2445,3501
2018-05-19,6,3293,4100,1697,9433,8743,1737,43,19956,0,12,0,12,978,2297,3275
2018-05-19,7,3278,4220,1774,9655,8716,1766,45,20181,140,910,125,1175,883,2148,3031
2018-05-19,8,3451,4416,1910,9915,8867,1831,46,20660,730,3497,640,4867,807,1981,2788
2018-05-19,9,3700,4544,2026,10216,9081,1905,50,21252,1074,5486,1157,7717,786,1774,2560
2018-05-19,10,3936,4609,2099,10327,9275,1938,53,21593,1153,6224,1419,8796,727,1557,2284
2018-05-19,11,4153,4624,2123,10108,9425,1893,57,21484,1178,6692,1580,9450,676,1393,2069
2018-05-19,12,4342,4611,2107,9858,9402,1801,61,21122,1200,6829,1623,9652,740,1450,2190
2018-05-19,13,4508,4588,2078,9825,9346,1745,65,20982,1229,6797,1629,9655,818,1641,2459
2018-05-19,14,4675,4586,2053,9907,9332,1734,69,21042,1237,6750,1625,9612,904,1848,2752
2018-05-19,15,4864,4613,2038,10098,9432,1755,73,21358,1222,6665,1612,9499,1003,2212,3215
2018-05-19,16,5023,4689,2047,10428,9705,1809,75,22018,1204,6315,1547,9066,1103,2555,3658
2018-05-19,17,5111,4749,2077,10852,10103,1909,77,22941,1165,5691,1409,8265,1176,2824,4000
2018-05-19,18,5082,4812,2097,11072,10464,2045,75,23657,1033,4570,1145,6748,1188,2892,4080
2018-05-19,19,4966,4760,2106,11390,10827,2166,72,24456,645,2180,598,3423,1174,2872,4046
2018-05-19,20,4821,4766,2101,11723,10942,2292,68,25025,136,255,83,474,1163,2798,3961
2018-05-19,21,4783,4847,2098,12126,11339,2425,65,25955,2,0,0,2,1133,2784,3917
2018-05-19,22,4581,4690,2062,12056,10987,2363,61,25468,0,0,0,0,1114,2766,3880
2018-05-19,23,4351,4433,1924,11299,10366,2202,55,23922,0,0,0,0,1085,2709,3794
2018-05-19,24,4067,4207,1766,10546,9613,2014,50,22224,0,0,0,0,1079,2700,3779
2018-05-20,1,3876,4098,1639,10224,9222,1887,47,21380,0,0,0,0,1150,2807,3957
2018-05-20,2,3675,4010,1566,9738,8853,1797,44,20431,0,0,0,0,1131,2744,3875
2018-05-20,3,3518,3974,1523,9433,8528,1714,43,19717,0,0,0,0,1095,2662,3757
2018-05-20,4,3406,3970,1506,9290,8357,1676,42,19365,0,0,0,0,1044,2569,3613
2018-05-20,5,3351,4002,1522,9258,8351,1677,42,19328,0,0,0,0,973,2462,3435
2018-05-20,6,3293,3981,1561,9317,8398,1726,42,19484,0,13,0,13,909,2293,3202
2018-05-20,7,3226,4084,1628,9350,8352,1749,43,19494,152,874,123,1149,848,2095,2943
2018-05-20,8,3359,4268,1749,9382,8259,1775,46,19461,772,3413,650,4835,776,1866,2642
2018-05-20,9,3593,4377,1889,9352,8593,1816,50,19810,1127,5357,1162,7646,710,1603,2313
2018-05-20,10,3854,4482,1981,9219,8863,1797,54,19933,1210,6108,1404,8722,617,1329,1946
2018-05-20,11,4064,4509,2011,9053,8906,1710,58,19727,1236,6574,1549,9359,544,1126,1670
2018-05-20,12,4244,4573,2003,8864,8743,1637,61,19305,1241,6747,1584,9572,544,1234,1778
2018-05-20,13,4419,4602,1992,8822,8784,1567,65,19238,1231,6776,1580,9587,567,1435,2002
2018-05-20,14,4581,4693,1986,8891,8991,1540,67,19490,1201,6709,1565,9475,632,1717,2349
2018-05-20,15,4734,4798,1972,9081,9223,1589,70,19963,1190,6635,1543,9368,751,2049,2800
2018-05-20,16,4888,4939,1982,9425,9585,1680,72,20761,1150,6260,1452,8862,867,2340,3207
2018-05-20,17,4947,5054,2027,9846,9968,1821,74,21709,1072,5623,1294,7989,963,2529,3492
2018-05-20,18,4949,5017,2085,10386,10358,2030,73,22847,851,4373,961,6185,1003,2570,3573
2018-05-20,19,4867,4982,2106,10913,10568,2166,70,23718,483,1994,471,2948,992,2540,3532
2018-05-20,20,4759,4964,2100,11468,10799,2286,66,24619,92,222,63,377,993,2430,3423
2018-05-20,21,4772,5020,2103,11970,11291,2440,64,25765,0,0,0,0,1019,2424,3443
2018-05-20,22,4584,4774,2075,11839,10904,2337,59,25140,0,0,0,0,1054,2511,3565
2018-05-20,23,4294,4425,1913,11038,10177,2168,53,23436,0,0,0,0,1080,2557,3637
2018-05-20,24,3971,4207,1739,10230,9405,1951,47,21633,0,0,0,0,1076,2608,3684
2018-05-21,1,3756,4193,1661,9729,8990,1868,44,20631,0,0,0,0,993,2728,3721
2018-05-21,2,3558,4128,1608,9312,8690,1781,42,19825,0,0,0,0,969,2703,3672
2018-05-21,3,3435,4105,1586,9120,8517,1752,41,19430,0,0,0,0,922,2599,3521
2018-05-21,4,3361,4156,1598,9097,8495,1727,40,19360,0,0,0,0,818,2466,3284
2018-05-21,5,3355,4333,1683,9321,8783,1761,42,19907,0,0,0,0,742,2334,3076
2018-05-21,6,3411,4582,1883,9779,9413,1879,45,21116,0,11,0,11,707,2248,2955
2018-05-21,7,3509,4884,2171,10649,10057,2054,47,22807,142,809,108,1059,653,2136,2789
2018-05-21,8,3684,5090,2366,11476,10659,2179,51,24365,685,3134,561,4380,590,1991,2581
2018-05-21,9,3865,5227,2372,11554,10875,2229,54,24712,983,4600,1013,6596,531,1804,2335
2018-05-21,10,4033,5341,2386,11475,11017,2213,58,24763,1101,5379,1284,7764,438,1601,2039
2018-05-21,11,4182,5415,2392,11258,11070,2068,61,24457,1154,5954,1462,8570,361,1441,1802
2018-05-21,12,4305,5481,2388,11006,11037,1983,63,24089,1157,6167,1512,8836,386,1451,1837
2018-05-21,13,4422,5577,2403,10926,11016,1934,65,23941,1153,6288,1551,8992,429,1586,2015
2018-05-21,14,4525,5659,2416,10982,11139,1924,66,24112,1075,6297,1560,8932,540,1674,2214
2018-05-21,15,4629,5728,2420,11136,11254,1957,67,24414,1095,6180,1530,8805,655,1848,2503
2018-05-21,16,4710,5779,2436,11390,11449,1997,68,24904,1022,5651,1405,8078,767,2071,2838
2018-05-21,17,4695,5786,2463,11770,11664,2097,67,25598,957,5042,1241,7240,861,2290,3151
2018-05-21,18,4685,5747,2519,12231,11713,2229,67,26239,817,3911,942,5670,887,2348,3235
2018-05-21,19,4644,5600,2510,12593,11689,2326,65,26673,525,1900,510,2935,912,2416,3328
2018-05-21,20,4588,5509,2487,12849,11841,2498,63,27250,117,217,75,409,928,2362,3290
2018-05-21,21,4609,5517,2457,13212,12313,2574,63,28162,0,0,0,0,968,2342,3310
2018-05-21,22,4416,5167,2370,12902,11959,2446,59,27366,0,0,0,0,1044,2341,3385
2018-05-21,23,4099,4760,2139,11939,11046,2218,53,25256,0,0,0,0,1106,2389,3495
2018-05-21,24,3785,4483,1934,11078,10146,1998,48,23271,0,0,0,0,1116,2374,3490
2018-05-22,1,3539,4303,1844,10100,9496,1870,46,21511,0,0,0,0,1128,2353,3481
2018-05-22,2,3365,4209,1771,9673,9124,1798,44,20639,0,0,0,0,1124,2350,3474
2018-05-22,3,3243,4172,1724,9434,8901,1751,43,20129,0,0,0,0,1022,2213,3235
2018-05-22,4,3173,4209,1707,9364,8821,1733,43,19961,0,0,0,0,873,2068,2941
2018-05-22,5,3176,4376,1762,9526,8972,1771,44,20313,0,0,0,0,729,1923,2652
2018-05-22,6,3244,4616,1940,9989,9482,1903,47,21422,0,15,0,15,629,1737,2366
2018-05-22,7,3333,4901,2205,10736,10115,2087,50,22988,153,895,119,1167,546,1427,1973
2018-05-22,8,3558,5084,2382,11477,10797,2189,54,24517,739,3405,588,4732,496,1190,1686
2018-05-22,9,3726,5196,2424,11530,10918,2200,55,24703,1036,5331,1083,7450,482,906,1388
2018-05-22,10,3889,5293,2440,11411,11018,2153,57,24639,1125,6113,1347,8585,455,668,1123
2018-05-22,11,4038,5357,2444,11313,11005,2093,59,24470,1177,6576,1496,9249,442,514,956
2018-05-22,12,4172,5397,2475,11225,10939,2015,62,24241,1192,6732,1567,9491,531,509,1040
2018-05-22,13,4299,5469,2532,11128,10910,1971,65,24074,1190,6686,1567,9443,610,567,1177
2018-05-22,14,4444,5531,2578,11306,11037,1975,67,24385,1184,6670,1576,9430,708,671,1379
2018-05-22,15,4616,5569,2615,11507,11184,1998,69,24759,1144,6585,1549,9278,837,926,1763
2018-05-22,16,4778,5607,2657,11792,11358,2054,71,25276,1097,6252,1440,8789,964,1270,2234
2018-05-22,17,4884,5580,2700,12151,11507,2158,73,25889,1038,5563,1296,7897,1090,1612,2702
2018-05-22,18,4883,5555,2734,12449,11568,2284,73,26375,894,4439,1011,6344,1142,1841,2983
2018-05-22,19,4835,5432,2719,12810,11674,2399,72,26955,560,2084,519,3163,1179,2082,3261
2018-05-22,20,4761,5378,2672,13130,11994,2538,69,27731,127,252,79,458,1208,2226,3434
2018-05-22,21,4778,5393,2608,13410,12462,2583,67,28521,1,0,0,1,1225,2185,3410
2018-05-22,22,4547,5070,2500,12967,12048,2437,62,27513,0,0,0,0,1235,2137,3372
2018-05-22,23,4212,4718,2239,12021,11182,2201,55,25459,0,0,0,0,1244,2016,3260
2018-05-22,24,3883,4470,2008,11089,10270,1995,50,23404,0,0,0,0,1229,1882,3111
2018-05-23,1,3647,4274,1895,10248,9466,1892,45,21652,0,0,0,0,1206,1798,3004
2018-05-23,2,3451,4184,1809,9840,9070,1802,43,20755,0,0,0,0,1164,1642,2806
2018-05-23,3,3326,4151,1754,9594,8827,1754,43,20217,0,0,0,0,1133,1533,2666
2018-05-23,4,3245,4190,1731,9513,8746,1715,42,20016,0,0,0,0,1077,1426,2503
2018-05-23,5,3241,4356,1775,9694,8856,1763,44,20357,0,0,0,0,1003,1307,2310
2018-05-23,6,3280,4589,1922,10229,9415,1881,47,21572,1,19,0,20,908,1193,2101
2018-05-23,7,3416,4878,2173,11021,10031,2062,51,23165,167,959,132,1258,829,1048,1877
2018-05-23,8,3617,5050,2382,11572,10684,2209,54,24519,823,3290,645,4758,747,826,1573
2018-05-23,9,3807,5153,2437,11513,10958,2250,55,24776,1139,5073,1154,7366,734,526,1260
2018-05-23,10,3993,5236,2458,11368,11081,2218,58,24725,1218,5808,1422,8448,684,333,1017
2018-05-23,11,4183,5292,2499,11167,11155,1986,61,24369,1250,6222,1591,9063,633,241,874
2018-05-23,12,4361,5323,2540,10909,11167,1873,65,24013,1260,6357,1621,9238,671,258,929
2018-05-23,13,4517,5390,2603,10683,11191,1851,68,23793,1270,6357,1628,9255,733,334,1067
2018-05-23,14,4692,5449,2662,10712,11249,1877,71,23909,1270,6357,1629,9256,824,456,1280
2018-05-23,15,4878,5513,2707,10820,11290,1903,73,24086,1238,6308,1617,9163,927,571,1498
2018-05-23,16,5060,5549,2715,11049,11561,1971,75,24657,1222,6058,1533,8813,1004,730,1734
2018-05-23,17,5165,5555,2712,11461,11737,2086,77,25360,1159,5494,1393,8046,1084,918,2002
2018-05-23,18,5133,5549,2719,11930,11808,2224,76,26038,1026,4464,1116,6606,1112,1020,2132
2018-05-23,19,5038,5443,2690,12408,11889,2347,74,26718,648,2194,585,3427,1129,1146,2275
2018-05-23,20,4934,5395,2653,12846,12023,2465,70,27404,148,274,91,513,1126,1264,2390
2018-05-23,21,4929,5434,2593,13105,12473,2572,67,28217,1,0,0,1,1107,1321,2428
2018-05-23,22,4696,5108,2509,12822,12042,2442,62,27369,0,0,0,0,1116,1356,2472
2018-05-23,23,4359,4729,2272,11854,11159,2232,56,25300,0,0,0,0,1089,1262,2351
2018-05-23,24,4008,4466,2044,10959,10267,2013,50,23289,0,0,0,0,1041,1108,2149
2018-05-24,1,3811,4360,1897,10355,9609,1889,47,21900,0,0,0,0,860,1074,1934
2018-05-24,2,3610,4273,1810,9914,9185,1802,45,20946,0,0,0,0,836,970,1806
2018-05-24,3,3476,4234,1753,9685,8908,1747,43,20383,0,0,0,0,863,858,1721
2018-05-24,4,3385,4269,1729,9606,8816,1721,42,20186,0,0,0,0,881,774,1655
2018-05-24,5,3375,4432,1770,9795,8974,1763,44,20576,0,0,0,0,872,695,1567
2018-05-24,6,3418,4658,1914,10254,9469,1892,47,21662,1,26,1,28,822,635,1457
2018-05-24,7,3531,4940,2164,11012,10110,2113,50,23285,170,1023,143,1336,745,594,1339
2018-05-24,8,3754,5136,2369,11744,10792,2233,53,24822,816,3714,657,5187,642,533,1175
2018-05-24,9,3978,5262,2426,11814,10981,2182,56,25033,1107,5653,1137,7897,622,467,1089
2018-05-24,10,4193,5374,2456,11698,11124,2047,60,24929,1195,6361,1393,8949,573,389,962
2018-05-24,11,4401,5459,2494,11527,11215,1976,63,24781,1230,6788,1550,9568,511,349,860
2018-05-24,12,4599,5532,2528,11291,11204,1922,67,24484,1235,6930,1599,9764,572,401,973
2018-05-24,13,4775,5647,2582,11060,11213,1889,71,24232,1249,6962,1591,9802,672,478,1150
2018-05-24,14,4969,5766,2629,11038,11211,1920,74,24244,1248,6955,1587,9790,776,587,1363
2018-05-24,15,5167,5868,2656,11115,11345,1966,77,24502,1212,6890,1547,9649,880,802,1682
2018-05-24,16,5340,5920,2694,11352,11495,2028,79,24954,1149,6588,1448,9185,997,1007,2004
2018-05-24,17,5430,5948,2672,11700,11738,2127,80,25645,1075,5999,1296,8370,1086,1226,2312
2018-05-24,18,5382,5944,2689,11960,11745,2253,79,26038,930,4868,1016,6814,1097,1349,2446
2018-05-24,19,5255,5807,2654,12407,11800,2347,76,26629,568,2359,505,3432,1083,1463,2546
2018-05-24,20,5117,5712,2615,12695,11890,2467,71,27122,133,295,78,506,1063,1503,2566
2018-05-24,21,5096,5691,2570,13139,12312,2564,68,28083,0,0,0,0,1013,1544,2557
2018-05-24,22,4858,5326,2497,12888,12020,2436,63,27407,0,0,0,0,964,1564,2528
2018-05-24,23,4517,4907,2267,11871,11119,2222,56,25267,0,0,0,0,916,1517,2433
2018-05-24,24,4154,4598,2036,10911,10226,2022,50,23210,0,0,0,0,862,1513,2375
2018-05-25,1,3896,4480,1826,10218,9533,1851,46,21648,0,0,0,0,948,1695,2643
2018-05-25,2,3684,4378,1735,9808,9142,1763,44,20757,0,0,0,0,894,1734,2628
2018-05-25,3,3537,4327,1682,9545,8944,1719,43,20251,0,0,0,0,817,1783,2600
2018-05-25,4,3437,4347,1659,9474,8840,1703,42,20059,0,0,0,0,667,1844,2511
2018-05-25,5,3419,4488,1699,9668,9050,1746,44,20507,0,0,0,0,509,1902,2411
2018-05-25,6,3456,4672,1833,10151,9588,1860,46,21645,0,26,0,26,312,1901,2213
2018-05-25,7,3557,4953,2065,10816,10050,2027,49,22941,111,999,96,1206,181,1823,2004
2018-05-25,8,3751,5193,2269,11496,10565,2149,51,24261,541,3584,462,4587,130,1767,1897
2018-05-25,9,3932,5379,2335,11638,10706,2185,54,24581,735,5407,841,6983,127,1735,1862
2018-05-25,10,4117,5517,2367,11640,10792,2170,56,24658,757,6138,1109,8004,121,1767,1888
2018-05-25,11,4290,5621,2386,11569,10879,2114,58,24618,795,6571,1282,8648,109,1797,1906
2018-05-25,12,4436,5719,2389,11300,10857,2045,59,24262,793,6744,1316,8853,115,1963,2078
2018-05-25,13,4574,5845,2395,10966,10863,1989,61,23880,821,6756,1329,8906,133,2159,2292
2018-05-25,14,4700,5962,2404,10921,10977,1971,63,23932,835,6730,1322,8887,142,2341,2483
2018-05-25,15,4836,6075,2392,10895,11046,1990,64,23994,795,6626,1277,8698,135,2595,2730
2018-05-25,16,4941,6106,2363,11043,11141,2032,65,24280,788,6238,1177,8203,177,2784,2961
2018-05-25,17,4958,6089,2353,11328,11273,2103,67,24771,744,5659,1045,7448,251,2933,3184
2018-05-25,18,4912,6084,2334,11583,11248,2188,66,25085,661,4579,788,6028,288,2958,3246
2018-05-25,19,4792,5887,2287,11771,11215,2252,63,25302,400,2212,381,2993,288,2950,3238
2018-05-25,20,4675,5741,2238,11959,11307,2323,60,25649,105,281,64,450,291,2873,3164
2018-05-25,21,4687,5717,2213,12175,11721,2433,59,26389,0,0,0,0,282,2848,3130
2018-05-25,22,4517,5412,2217,12151,11451,2346,56,26005,0,0,0,0,292,2865,3157
2018-05-25,23,4240,5011,2099,11505,10742,2166,52,24465,0,0,0,0,300,2868,3168
2018-05-25,24,3943,4682,1921,10788,9990,1988,48,22815,0,0,0,0,363,2901,3264
2018-05-26,1,3674,4461,1728,10095,9507,1915,44,21560,0,0,0,0,539,2804,3343
2018-05-26,2,3496,4333,1645,9626,9081,1831,42,20580,0,0,0,0,560,2797,3357
2018-05-26,3,3367,4266,1594,9315,8800,1758,41,19914,0,0,0,0,510,2775,3285
2018-05-26,4,3283,4245,1573,9161,8683,1728,41,19612,0,0,0,0,455,2757,3212
2018-05-26,5,3240,4277,1593,9171,8692,1739,42,19644,0,0,0,0,406,2726,3132
2018-05-26,6,3182,4262,1647,9366,8829,1791,43,20029,0,23,0,23,397,2741,3138
2018-05-26,7,3140,4384,1757,9576,8798,1807,44,20225,129,1008,88,1225,404,2746,3150
2018-05-26,8,3238,4629,1907,9732,8872,1867,47,20518,545,3579,416,4540,405,2763,3168
2018-05-26,9,3422,4846,2018,9835,9138,2019,50,21041,808,5424,767,6999,379,2835,3214
2018-05-26,10,3619,4984,2086,9741,9353,2082,51,21227,908,6210,1030,8148,320,2887,3207
2018-05-26,11,3742,5066,2114,9579,9414,1998,52,21043,1027,6667,1217,8911,265,2949,3214
2018-05-26,12,3857,5175,2108,9369,9350,1881,53,20652,1073,6842,1322,9237,217,3020,3237
2018-05-26,13,3966,5267,2076,9257,9303,1767,54,20381,1081,6953,1394,9428,189,3096,3285
2018-05-26,14,4076,5347,2047,9260,9143,1676,56,20135,1116,6951,1396,9463,177,3138,3315
2018-05-26,15,4196,5431,2022,9356,9152,1734,58,20299,1123,6894,1412,9429,210,3252,3462
2018-05-26,16,4305,5528,2031,9585,9241,1774,59,20659,1100,6577,1367,9044,283,3351,3634
2018-05-26,17,4406,5499,2047,10029,9527,1900,62,21518,1060,5962,1260,8282,374,3401,3775
2018-05-26,18,4417,5454,2070,10574,9795,2017,61,22447,952,4874,1007,6833,451,3385,3836
2018-05-26,19,4340,5368,2060,11084,10083,2145,60,23372,591,2424,528,3543,600,3339,3939
2018-05-26,20,4273,5284,2034,11402,10481,2327,58,24268,124,331,92,547,698,3241,3939
2018-05-26,21,4334,5307,2012,11736,10950,2416,57,25159,0,0,0,0,685,3205,3890
2018-05-26,22,4230,5089,2040,11615,10727,2337,55,24734,0,0,0,0,715,3176,3891
2018-05-26,23,4025,4794,1930,10982,10125,2201,50,23358,0,0,0,0,771,3101,3872
2018-05-26,24,3764,4506,1777,10264,9565,2026,47,21901,0,0,0,0,775,3049,3824
2018-05-27,1,3550,4183,1668,9755,9002,1872,44,20673,0,0,0,0,869,2977,3846
2018-05-27,2,3375,4061,1603,9380,8618,1766,43,19807,0,0,0,0,852,2912,3764
2018-05-27,3,3246,4024,1574,9077,8414,1719,42,19252,0,0,0,0,787,2801,3588
2018-05-27,4,3161,3996,1568,8942,8243,1689,41,18915,0,0,0,0,694,2635,3329
2018-05-27,5,3126,3992,1598,8976,8204,1666,42,18888,0,0,0,0,635,2457,3092
2018-05-27,6,3067,3955,1641,9094,8243,1683,43,19063,0,26,1,27,585,2117,2702
2018-05-27,7,3025,4038,1711,9139,8100,1688,45,18972,186,1070,156,1412,521,1713,2234
2018-05-27,8,3176,4251,1839,9402,8132,1712,47,19293,815,3698,686,5199,440,1269,1709
2018-05-27,9,3377,4420,1944,9513,8291,1752,49,19605,1133,5589,1179,7901,350,852,1202
2018-05-27,10,3583,4561,2031,9409,8419,1761,50,19639,1213,6363,1442,9018,298,496,794
2018-05-27,11,3730,4622,2052,9242,8517,1730,52,19541,1245,6819,1605,9669,254,295,549
2018-05-27,12,3877,4681,2022,9114,8620,1708,55,19497,1263,6981,1651,9895,244,224,468
2018-05-27,13,4034,4654,2001,9059,8754,1688,59,19561,1272,6976,1653,9901,239,232,471
2018-05-27,14,4212,4664,1992,9161,8930,1712,62,19865,1273,6935,1655,9863,273,306,579
2018-05-27,15,4412,4710,2000,9424,9198,1762,66,20450,1262,6863,1649,9774,348,522,870
2018-05-27,16,4678,4769,2057,10040,9495,1817,68,21420,1244,6545,1594,9383,455,846,1301
2018-05-27,17,4819,4770,2133,10721,9961,1945,71,22698,1208,5938,1442,8588,564,1257,1821
2018-05-27,18,4877,4752,2227,11202,10276,2096,73,23647,1102,4853,1172,7127,628,1635,2263
2018-05-27,19,4891,4764,2246,11704,10569,2218,71,24561,727,2441,641,3809,664,1959,2623
2018-05-27,20,4732,4818,2236,11999,10722,2344,69,25134,152,350,118,620,723,2231,2954
2018-05-27,21,4691,4940,2218,12298,11312,2436,66,26112,0,0,0,0,751,2230,2981
2018-05-27,22,4534,4779,2178,12111,11039,2331,61,25541,0,0,0,0,785,2167,2952
2018-05-27,23,4266,4503,1973,11267,10364,2142,54,23828,0,0,0,0,843,2054,2897
2018-05-27,24,3975,4286,1777,10389,9707,1959,49,22104,0,0,0,0,838,1944,2782
2018-05-28,1,3700,4012,1698,10072,9106,1914,44,21136,0,0,0,0,862,1813,2675
2018-05-28,2,3504,3937,1632,9606,8701,1821,41,20170,0,0,0,0,827,1721,2548
2018-05-28,3,3365,3917,1587,9295,8402,1756,40,19494,0,0,0,0,757,1503,2260
2018-05-28,4,3284,3926,1563,9183,8237,1728,40,19188,0,0,0,0,686,1273,1959
2018-05-28,5,3243,3976,1579,9238,8266,1748,41,19293,0,0,0,0,632,1064,1696
2018-05-28,6,3183,3971,1609,9393,8373,1800,42,19608,1,32,1,34,521,877,1398
2018-05-28,7,3179,4104,1677,9556,8287,1808,44,19694,218,1135,169,1522,424,699,1123
2018-05-28,8,3322,4288,1802,9903,8331,1849,47,20131,878,3835,731,5444,343,525,868
2018-05-28,9,3561,4404,1949,10203,8584,1909,51,20746,1182,5727,1252,8161,227,337,564
2018-05-28,10,3840,4518,2021,10396,8911,1939,55,21301,1248,6469,1494,9211,171,243,414
2018-05-28,11,4065,4588,2060,10577,9346,1948,59,21930,1279,6905,1640,9824,142,214,356
2018-05-28,12,4329,4595,2100,10771,9666,1920,64,22422,1293,7056,1665,10014,127,221,348
2018-05-28,13,4563,4577,2151,11005,9995,1877,69,22946,1296,7064,1666,10026,137,244,381
2018-05-28,14,4814,4613,2197,11365,10379,1853,73,23670,1296,7044,1666,10006,169,348,517
2018-05-28,15,5079,4691,2246,11856,10825,1886,77,24644,1294,6985,1659,9938,215,584,799
2018-05-28,16,5330,4802,2310,12514,11270,1954,79,25817,1275,6632,1610,9517,312,928,1240
2018-05-28,17,5459,4907,2371,13255,11657,2101,81,27093,1242,6056,1456,8754,427,1366,1793
2018-05-28,18,5508,5009,2416,13848,11964,2266,82,28160,1135,4969,1190,7294,479,1717,2196
2018-05-28,19,5419,4989,2399,14207,12035,2369,78,28690,767,2524,667,3958,531,1977,2508
2018-05-28,20,5259,4960,2351,14220,12026,2469,74,28789,166,357,125,648,659,2157,2816
2018-05-28,21,5203,5035,2298,14232,12443,2601,70,29346,0,0,0,0,669,2175,2844
2018-05-28,22,4949,4783,2271,13846,12035,2466,65,28412,0,0,0,0,707,2163,2870
2018-05-28,23,4584,4473,2065,12689,11122,2229,58,26098,0,0,0,0,768,2088,2856
2018-05-28,24,4213,4240,1847,11633,10229,2027,52,23941,0,0,0,0,764,2017,2781
2018-05-29,1,3904,4134,1708,10782,10117,1937,51,22887,0,0,0,0,779,1951,2730
2018-05-29,2,3682,4061,1633,10304,9584,1833,48,21769,0,0,0,0,773,1819,2592
2018-05-29,3,3533,4039,1584,9947,9232,1773,47,20999,0,0,0,0,755,1636,2391
2018-05-29,4,3440,4088,1566,9838,9056,1746,46,20685,0,0,0,0,724,1404,2128
2018-05-29,5,3430,4259,1620,9986,9197,1767,47,20998,0,0,0,0,673,1177,1850
2018-05-29,6,3460,4494,1786,10472,9579,1896,49,21996,1,28,1,30,574,879,1453
2018-05-29,7,3567,4777,2062,11291,10198,2073,53,23615,213,1071,178,1462,495,636,1131
2018-05-29,8,3832,4920,2238,12036,10841,2191,57,25125,866,3677,750,5293,398,437,835
2018-05-29,9,4073,4987,2271,12190,11258,2192,61,25701,1185,5564,1249,7998,331,235,566
2018-05-29,10,4343,5027,2289,12417,11570,2167,65,26219,1242,6348,1482,9072,269,173,442
2018-05-29,11,4633,5043,2286,12756,12001,2141,70,26967,1274,6874,1640,9788,217,177,394
2018-05-29,12,4915,5050,2281,13157,12372,2109,75,27712,1290,7015,1661,9966,247,200,447
2018-05-29,13,5152,5104,2290,13491,12669,2105,80,28345,1289,6981,1660,9930,293,222,515
2018-05-29,14,5422,5153,2288,14143,13145,2133,84,29505,1291,6958,1656,9905,374,285,659
2018-05-29,15,5684,5224,2265,14709,13598,2163,87,30557,1279,6858,1646,9783,544,456,1000
2018-05-29,16,5895,5254,2266,15343,14071,2248,89,31750,1263,6529,1571,9363,720,793,1513
2018-05-29,17,5959,5282,2234,15953,14351,2352,90,32746,1229,5924,1418,8571,885,1246,2131
2018-05-29,18,5942,5268,2226,16320,14478,2443,90,33331,1115,4830,1159,7104,967,1384,2351
2018-05-29,19,5810,5262,2244,16428,14221,2525,86,33261,750,2474,649,3873,1053,1645,2698
2018-05-29,20,5614,5186,2226,16062,13872,2609,81,32623,162,358,121,641,1104,1827,2931
2018-05-29,21,5524,5207,2183,15585,13864,2683,77,32209,1,0,0,1,1136,1904,3040
2018-05-29,22,5223,4891,2184,14695,13448,2548,70,30761,0,0,0,0,1170,1975,3145
2018-05-29,23,4816,4515,2024,13255,12315,2316,62,27948,0,0,0,0,1198,2018,3216
2018-05-29,24,4400,4274,1858,11925,11200,2084,56,25266,0,0,0,0,1204,1992,3196
2018-05-30,1,4022,4298,1735,10939,9964,1891,53,22848,0,0,0,0,1189,2157,3346
2018-05-30,2,3784,4225,1676,10354,9526,1807,51,21737,0,0,0,0,1161,2085,3246
2018-05-30,3,3629,4188,1644,9988,9231,1762,49,21030,0,0,0,0,1151,2016,3167
2018-05-30,4,3522,4220,1653,9855,9105,1725,48,20733,0,0,0,0,1129,1935,3064
2018-05-30,5,3502,4381,1729,9993,9312,1772,49,21126,0,0,0,0,1120,1849,2969
2018-05-30,6,3514,4589,1931,10474,9809,1898,50,22232,1,27,1,29,1083,1710,2793
2018-05-30,7,3635,4872,2218,11191,10385,2091,54,23721,220,1142,180,1542,1066,1564,2630
2018-05-30,8,3890,5060,2387,11755,11146,2217,58,25177,872,3821,740,5433,1033,1396,2429
2018-05-30,9,4143,5182,2365,11776,11474,2261,62,25573,1163,5671,1223,8057,975,1241,2216
2018-05-30,10,4425,5272,2337,11760,11627,2280,67,25734,1218,6406,1449,9073,939,1137,2076
2018-05-30,11,4726,5333,2321,11706,11755,2260,72,25794,1246,6874,1607,9727,914,1131,2045
2018-05-30,12,5008,5401,2296,11606,11823,2186,77,25692,1253,7028,1628,9909,964,1281,2245
2018-05-30,13,5268,5515,2279,11444,11917,2095,81,25538,1229,7055,1610,9894,1000,1466,2466
2018-05-30,14,5532,5619,2263,11568,12108,2026,85,25787,1198,7047,1594,9839,1056,1691,2747
2018-05-30,15,5803,5707,2240,11711,12327,2017,87,26142,1193,6982,1580,9755,1137,1990,3127
2018-05-30,16,5995,5805,2244,11937,12449,2080,89,26556,1158,6679,1504,9341,1202,2208,3410
2018-05-30,17,6001,5797,2254,12244,12471,2177,89,26980,1113,6108,1340,8561,1246,2435,3681
2018-05-30,18,5944,5760,2273,12479,12545,2286,88,27397,1022,5062,1089,7173,1257,2472,3729
2018-05-30,19,5796,5677,2283,12863,12610,2372,84,27929,697,2666,629,3992,1243,2521,3764
2018-05-30,20,5586,5596,2256,13082,12558,2470,78,28189,155,425,123,703,1237,2510,3747
2018-05-30,21,5515,5588,2218,13349,12953,2577,74,28953,1,0,0,1,1222,2473,3695
2018-05-30,22,5224,5233,2210,12928,12488,2445,69,27930,0,0,0,0,1215,2423,3638
2018-05-30,23,4859,4811,2039,11925,11508,2227,62,25722,0,0,0,0,1197,2332,3529
2018-05-30,24,4461,4507,1853,10999,10495,2010,56,23559,0,0,0,0,1172,2324,3496
2018-05-31,1,4160,4467,1774,10357,9715,1890,51,22013,0,0,0,0,1090,2278,3368
2018-05-31,2,3933,4362,1711,9913,9341,1798,48,21099,0,0,0,0,1072,2266,3338
2018-05-31,3,3774,4312,1678,9660,9062,1747,46,20515,0,0,0,0,1013,2205,3218
2018-05-31,4,3673,4337,1678,9567,8937,1722,45,20270,0,0,0,0,950,2141,3091
2018-05-31,5,3659,4494,1745,9752,9128,1755,46,20681,0,0,0,0,881,2041,2922
2018-05-31,6,3670,4689,1926,10289,9693,1890,47,21920,1,24,1,26,807,1921,2728
2018-05-31,7,3770,4964,2207,11057,10321,2072,49,23499,221,1027,156,1404,740,1764,2504
2018-05-31,8,3977,5206,2368,11657,10867,2203,53,24781,905,3437,650,4992,694,1611,2305
2018-05-31,9,4178,5377,2363,11728,11183,2260,58,25229,1248,5189,1129,7566,632,1541,2173
2018-05-31,10,4374,5510,2363,11574,11431,2274,63,25342,1327,6064,1435,8826,578,1498,2076
2018-05-31,11,4578,5610,2359,11443,11640,2253,67,25403,1357,6506,1600,9463,499,1471,1970
2018-05-31,12,4761,5701,2349,11268,11654,2223,70,25215,1384,6717,1651,9752,478,1622,2100
2018-05-31,13,4944,5832,2345,10999,11446,2141,73,24659,1390,6878,1659,9927,460,1814,2274
2018-05-31,14,5120,5942,2330,10991,11361,2123,76,24551,1388,6872,1656,9916,491,1929,2420
2018-05-31,15,5279,6032,2297,11001,11326,2108,77,24512,1382,6834,1653,9869,557,2026,2583
2018-05-31,16,5394,6113,2294,11048,11459,2153,78,24738,1363,6690,1606,9659,632,2140,2772
2018-05-31,17,5377,6061,2268,11233,11665,2209,78,25185,1321,6143,1456,8920,725,2266,2991
2018-05-31,18,5320,5982,2277,11556,11818,2265,77,25716,1196,5104,1194,7494,756,2286,3042
2018-05-31,19,5196,5879,2294,12009,11847,2336,74,26266,816,2723,682,4221,761,2373,3134
2018-05-31,20,5056,5773,2280,12381,12042,2434,69,26926,193,435,134,762,774,2342,3116
2018-05-31,21,5055,5752,2272,12724,12575,2542,67,27908,2,0,0,2,797,2410,3207
2018-05-31,22,4847,5404,2266,12537,12216,2406,63,27221,0,0,0,0,815,2541,3356
2018-05-31,23,4535,4987,2114,11697,11271,2147,56,25172,0,0,0,0,838,2577,3415
2018-05-31,24,4186,4665,1942,10851,10441,1991,51,23334,0,0,0,0,796,2648,3444
2018-06-01,1,3879,4346,1841,10260,9749,1922,47,21979,0,0,0,0,778,3153,3931
2018-06-01,2,3662,4230,1776,9881,9349,1831,45,21106,0,0,0,0,694,3127,3821
2018-06-01,3,3505,4179,1748,9688,9133,1783,43,20648,0,0,0,0,623,3039,3662
2018-06-01,4,3415,4205,1755,9604,9024,1748,43,20419,0,0,0,0,524,2908,3432
2018-06-01,5,3397,4325,1827,9755,9150,1780,44,20729,0,0,0,0,461,2725,3186
2018-06-01,6,3394,4502,2007,10182,9547,1876,46,21651,1,32,1,34,382,2336,2718
2018-06-01,7,3494,4775,2264,10931,9983,2026,49,22988,250,1201,193,1644,312,1756,2068
2018-06-01,8,3719,4987,2417,11508,10421,2122,53,24103,983,4004,771,5758,252,1131,1383
2018-06-01,9,3959,5123,2413,11477,10672,2114,56,24319,1292,5844,1257,8393,191,644,835
2018-06-01,10,4202,5232,2399,11318,10908,2092,59,24378,1347,6548,1502,9397,151,339,490
2018-06-01,11,4412,5283,2383,11217,10981,2003,64,24265,1377,6987,1647,10011,140,216,356
2018-06-01,12,4590,5273,2355,11015,11095,1957,68,24135,1390,7144,1669,10203,114,190,304
2018-06-01,13,4813,5311,2335,10850,11248,1915,72,24086,1401,7169,1669,10239,99,190,289
2018-06-01,14,5027,5370,2326,11022,11525,1905,76,24528,1400,7160,1667,10227,101,213,314
2018-06-01,15,5240,5443,2308,11214,11893,1907,79,25092,1396,7100,1662,10158,130,283,413
2018-06-01,16,5405,5503,2316,11498,12275,1977,81,25832,1379,6799,1615,9793,172,450,622
2018-06-01,17,5471,5501,2331,11914,12542,2083,82,26621,1344,6231,1467,9042,260,857,1117
2018-06-01,18,5510,5460,2349,12267,12609,2206,82,27164,1252,5177,1207,7636,358,1285,1643
2018-06-01,19,5393,5393,2326,12730,12345,2293,81,27449,901,2755,691,4347,427,1654,2081
2018-06-01,20,5207,5224,2277,13088,12155,2385,77,27705,218,456,140,814,478,2022,2500
2018-06-01,21,5090,5213,2238,13196,12562,2483,71,28313,3,0,0,3,516,2040,2556
2018-06-01,22,4859,5047,2201,12982,12244,2400,66,27691,0,0,0,0,563,1945,2508
2018-06-01,23,4516,4762,2076,12142,11435,2233,59,25869,0,0,0,0,655,1824,2479
2018-06-01,24,4184,4493,1919,11275,10574,2039,52,23940,0,0,0,0,646,1666,2312
2018-06-02,1,3932,4282,1888,10929,10033,1908,47,22917,0,0,0,0,640,1249,1889
2018-06-02,2,3699,4189,1818,10415,9479,1813,43,21750,0,0,0,0,651,1032,1683
2018-06-02,3,3527,4148,1769,9997,9100,1758,41,20897,0,0,0,0,611,904,1515
2018-06-02,4,3417,4155,1749,9804,8922,1733,41,20499,0,0,0,0,547,752,1299
2018-06-02,5,3357,4188,1768,9796,8934,1742,42,20514,0,0,0,0,469,612,1081
2018-06-02,6,3289,4198,1807,9912,8925,1780,43,20660,2,36,1,39,402,461,863
2018-06-02,7,3296,4322,1865,10060,8892,1808,45,20805,286,1214,198,1698,369,362,731
2018-06-02,8,3531,4536,1966,10285,9123,1867,47,21322,1013,4000,794,5807,335,297,632
2018-06-02,9,3846,4693,2108,10702,9398,1892,50,22043,1292,5817,1278,8387,227,240,467
2018-06-02,10,4166,4804,2206,11066,9666,1873,55,22660,1353,6523,1506,9382,164,268,432
2018-06-02,11,4488,4862,2242,11273,10099,1842,60,23275,1383,6960,1649,9992,127,330,457
2018-06-02,12,4818,4886,2248,11618,10507,1805,66,23996,1398,7119,1671,10188,98,329,427
2018-06-02,13,5138,4946,2254,11837,10959,1784,72,24652,1401,7147,1670,10218,74,305,379
2018-06-02,14,5468,5035,2282,12099,11447,1789,78,25413,1400,7129,1668,10197,70,285,355
2018-06-02,15,5791,5176,2323,12717,11992,1834,83,26626,1398,7074,1661,10133,99,291,390
2018-06-02,16,6064,5334,2386,13433,12530,1953,86,28002,1381,6782,1615,9778,175,393,568
2018-06-02,17,6234,5452,2453,14184,12954,2085,88,29311,1347,6206,1469,9022,275,854,1129
2018-06-02,18,6243,5509,2509,14721,13275,2220,89,30304,1259,5168,1210,7637,334,1295,1629
2018-06-02,19,6114,5398,2510,14977,13313,2320,87,30696,920,2754,701,4375,435,1749,2184
2018-06-02,20,5850,5268,2473,14850,13112,2397,81,30440,227,463,144,834,556,2156,2712
2018-06-02,21,5669,5261,2391,14787,13176,2481,73,30518,3,0,0,3,603,2269,2872
2018-06-02,22,5361,5041,2331,14366,12775,2390,67,29598,0,0,0,0,704,2358,3062
2018-06-02,23,4984,4716,2147,13225,11862,2207,59,27353,0,0,0,0,777,2404,3181
2018-06-02,24,4575,4432,1953,12168,10937,2016,54,25174,0,0,0,0,799,2384,3183
2018-06-03,1,4247,4295,1814,11437,10278,1976,52,23744,0,0,0,0,750,2171,2921
2018-06-03,2,3982,4192,1733,10807,9761,1865,49,22483,0,0,0,0,698,2079,2777
2018-06-03,3,3774,4138,1682,10361,9346,1789,47,21544,0,0,0,0,653,1951,2604
2018-06-03,4,3635,4123,1656,10082,9092,1747,46,20968,0,0,0,0,600,1801,2401
2018-06-03,5,3542,4117,1649,9976,9019,1736,46,20776,0,0,0,0,546,1574,2120
2018-06-03,6,3432,4075,1656,9959,8927,1752,46,20684,2,38,1,41,490,1249,1739
2018-06-03,7,3413,4171,1704,10005,8879,1757,49,20689,293,1245,206,1744,439,937,1376
2018-06-03,8,3674,4406,1831,10256,9003,1814,53,21126,1032,4067,806,5905,378,668,1046
2018-06-03,9,4035,4568,1951,10419,9059,1880,57,21416,1295,5873,1285,8453,339,365,704
2018-06-03,10,4442,4698,2021,10656,9412,1896,63,22027,1354,6580,1508,9442,297,197,494
2018-06-03,11,4842,4758,2096,10994,9910,1923,70,22897,1381,7009,1651,10041,264,164,428
2018-06-03,12,5208,4902,2147,11475,10588,1943,77,24083,1394,7161,1672,10227,301,176,477
2018-06-03,13,5532,5017,2205,12035,11283,1968,83,25369,1397,7179,1671,10247,346,230,576
2018-06-03,14,5861,5203,2259,12678,12041,2025,89,26833,1396,7170,1669,10235,435,303,738
2018-06-03,15,6185,5402,2314,13363,12784,2115,94,28355,1395,7125,1663,10183,569,473,1042
2018-06-03,16,6411,5626,2375,14080,13470,2231,97,29878,1379,6836,1614,9829,683,798,1481
2018-06-03,17,6591,5796,2404,14837,13962,2356,100,31255,1345,6262,1471,9078,788,1239,2027
2018-06-03,18,6599,5863,2432,15454,14242,2512,100,32307,1270,5233,1229,7732,854,1561,2415
2018-06-03,19,6448,5823,2418,15670,14265,2601,97,32633,932,2803,711,4446,916,1766,2682
2018-06-03,20,6150,5615,2363,15403,13854,2618,90,31964,234,482,148,864,962,1930,2892
2018-06-03,21,5936,5551,2302,15109,13774,2699,82,31663,3,0,0,3,1004,2003,3007
2018-06-03,22,5606,5225,2257,14635,13170,2578,74,30457,0,0,0,0,1021,2038,3059
2018-06-03,23,5164,4815,2100,13408,12158,2339,65,27971,0,0,0,0,1028,2037,3065
2018-06-03,24,4730,4524,1898,12187,11185,2119,58,25549,0,0,0,0,1030,2075,3105
2018-06-04,1,4307,4479,1708,11182,10608,1994,55,23839,0,0,0,0,903,2239,3142
2018-06-04,2,4022,4391,1635,10536,9996,1935,52,22519,0,0,0,0,866,2224,3090
2018-06-04,3,3815,4338,1592,10149,9559,1866,50,21624,0,0,0,0,846,2134,2980
2018-06-04,4,3680,4381,1583,9988,9371,1841,48,21248,0,0,0,0,811,2028,2839
2018-06-04,5,3658,4530,1642,10159,9457,1838,50,21503,0,0,0,0,780,1921,2701
2018-06-04,6,3640,4735,1800,10644,10016,1957,52,22669,2,37,1,40,708,1693,2401
2018-06-04,7,3755,5038,2049,11315,10716,2108,56,24194,294,1255,203,1752,643,1434,2077
2018-06-04,8,4043,5333,2240,12005,11427,2244,61,25737,1034,4074,795,5903,564,1168,1732
2018-06-04,9,4392,5556,2312,12452,11928,2305,67,26752,1296,5854,1265,8415,524,953,1477
2018-06-04,10,4761,5760,2363,12635,12353,2324,73,27386,1353,6531,1485,9369,495,771,1266
2018-06-04,11,5128,5928,2402,12848,12885,2346,81,28160,1381,6957,1626,9964,468,675,1143
2018-06-04,12,5484,6091,2409,13075,13461,2374,88,28998,1393,7110,1647,10150,601,687,1288
2018-06-04,13,5825,6293,2424,13303,13889,2352,94,29639,1396,7115,1648,10159,766,764,1530
2018-06-04,14,6183,6477,2429,13793,14445,2359,100,30696,1395,7102,1645,10142,923,935,1858
2018-06-04,15,6560,6627,2418,14264,15009,2416,104,31792,1394,7053,1637,10084,1026,1269,2295
2018-06-04,16,6849,6762,2418,14776,15546,2503,107,32931,1380,6716,1583,9679,1102,1604,2706
2018-06-04,17,6957,6818,2413,15203,15898,2625,109,33834,1344,6138,1430,8912,1164,1926,3090
2018-06-04,18,6907,6831,2417,15463,16024,2733,106,34326,1269,5108,1198,7575,1192,2031,3223
2018-06-04,19,6746,6619,2422,15543,15765,2752,102,34163,931,2728,693,4352,1194,2083,3277
2018-06-04,20,6417,6381,2396,15279,15183,2770,94,33327,235,463,145,843,1200,2101,3301
2018-06-04,21,6189,6236,2344,14929,15111,2841,87,32968,3,0,0,3,1202,2153,3355
2018-06-04,22,5843,5821,2314,14452,14261,2664,79,31456,0,0,0,0,1187,2215,3402
2018-06-04,23,5361,5311,2166,13174,12919,2386,70,28550,0,0,0,0,1176,2286,3462
2018-06-04,24,4893,4927,1972,12031,11660,2151,62,25904,0,0,0,0,1158,2396,3554
2018-06-05,1,4464,4763,1798,10895,10520,1961,57,23434,0,0,0,0,1180,2659,3839
2018-06-05,2,4193,4611,1724,10329,10040,1864,54,22287,0,0,0,0,1177,2697,3874
2018-06-05,3,3996,4524,1689,10011,9664,1814,52,21541,0,0,0,0,1151,2631,3782
2018-06-05,4,3865,4534,1689,9865,9477,1791,50,21183,0,0,0,0,1114,2528,3642
2018-06-05,5,3821,4679,1758,9985,9623,1820,51,21479,0,0,0,0,1056,2423,3479
2018-06-05,6,3795,4881,1939,10336,9937,1925,53,22250,2,32,1,35,991,2205,3196
2018-06-05,7,3901,5183,2211,10931,10546,2110,55,23643,282,1163,198,1643,897,1903,2800
2018-06-05,8,4169,5454,2370,11642,11328,2252,61,25283,927,3756,780,5463,797,1597,2394
2018-06-05,9,4470,5694,2368,11717,11749,2201,66,25733,1200,5602,1246,8048,663,1358,2021
2018-06-05,10,4802,5917,2386,11604,12025,2122,73,25823,1278,6387,1473,9138,525,1150,1675
2018-06-05,11,5149,6094,2385,11573,12330,2082,79,26064,1310,6835,1615,9760,412,1017,1429
2018-06-05,12,5479,6246,2384,11517,12579,2043,86,26225,1326,7008,1640,9974,399,1099,1498
2018-06-05,13,5785,6437,2393,11480,12821,2039,91,26432,1328,7015,1641,9984,415,1283,1698
2018-06-05,14,6079,6589,2394,11746,13452,2079,96,27373,1326,6989,1638,9953,450,1549,1999
2018-06-05,15,6362,6720,2386,12108,13831,2136,100,28175,1326,6898,1633,9857,544,1849,2393
2018-06-05,16,6584,6832,2395,12539,14244,2199,103,29084,1315,6493,1582,9390,645,2102,2747
2018-06-05,17,6656,6914,2409,13137,14446,2322,104,30009,1279,5861,1433,8573,779,2315,3094
2018-06-05,18,6610,6787,2442,13686,14308,2451,102,30547,1188,4782,1190,7160,894,2368,3262
2018-06-05,19,6481,6609,2436,14007,14117,2526,98,30748,847,2552,685,4084,975,2371,3346
2018-06-05,20,6205,6409,2411,14053,13813,2586,92,30543,217,453,144,814,1017,2345,3362
2018-06-05,21,5989,6278,2360,13921,13898,2657,85,30561,3,0,0,3,1056,2414,3470
2018-06-05,22,5659,5872,2296,13575,13348,2531,78,29532,0,0,0,0,1074,2467,3541
2018-06-05,23,5216,5382,2129,12467,12184,2288,69,27008,0,0,0,0,1097,2511,3608
2018-06-05,24,4768,4990,1941,11419,11082,2069,62,24632,0,0,0,0,1117,2498,3615
2018-06-06,1,4429,4827,1869,10697,10129,1939,55,22820,0,0,0,0,1130,2479,3609
2018-06-06,2,4154,4660,1795,10163,9675,1849,52,21740,0,0,0,0,1120,2399,3519
2018-06-06,3,3966,4563,1755,9856,9341,1800,50,21047,0,0,0,0,1107,2266,3373
2018-06-06,4,3836,4565,1750,9743,9187,1780,49,20758,0,0,0,0,1058,2105,3163
2018-06-06,5,3801,4698,1810,9909,9283,1815,49,21056,0,0,0,0,1033,1951,2984
2018-06-06,6,3769,4879,1977,10314,9706,1931,51,22002,2,31,1,34,1002,1747,2749
2018-06-06,7,3882,5167,2229,10905,10280,2089,53,23326,265,1170,195,1630,947,1545,2492
2018-06-06,8,4107,5474,2376,11475,10819,2171,58,24523,897,3856,761,5514,876,1281,2157
2018-06-06,9,4391,5720,2408,11590,11153,2192,63,24998,1168,5639,1227,8034,837,1052,1889
2018-06-06,10,4684,5956,2439,11448,11370,2179,69,25066,1261,6395,1446,9102,745,879,1624
2018-06-06,11,4992,6144,2454,11101,11672,2136,74,24983,1297,6836,1585,9718,647,827,1474
2018-06-06,12,5278,6294,2463,11014,11829,2084,80,25007,1310,7027,1632,9969,665,952,1617
2018-06-06,13,5535,6485,2497,10911,11964,2054,85,25014,1310,7061,1639,10010,692,1187,1879
2018-06-06,14,5794,6653,2532,11112,12301,2051,89,25553,1292,7051,1636,9979,775,1432,2207
2018-06-06,15,6054,6798,2566,11375,12654,2095,92,26215,1308,6973,1634,9915,894,1724,2618
2018-06-06,16,6262,6926,2606,11701,13030,2170,94,26995,1303,6659,1576,9538,999,1956,2955
2018-06-06,17,6346,6949,2654,12264,13366,2279,95,28004,1269,6079,1427,8775,1095,2200,3295
2018-06-06,18,6293,6907,2672,12765,13452,2400,93,28710,1181,5024,1184,7389,1137,2302,3439
2018-06-06,19,6184,6690,2645,13206,13323,2471,90,29090,845,2764,684,4293,1155,2379,3534
2018-06-06,20,5927,6482,2598,13333,13103,2544,84,29064,231,482,145,858,1178,2403,3581
2018-06-06,21,5753,6362,2533,13314,13237,2613,78,29242,2,0,0,2,1191,2503,3694
2018-06-06,22,5452,5966,2458,13179,12774,2493,72,28518,0,0,0,0,1197,2649,3846
2018-06-06,23,5029,5481,2247,12241,11703,2266,64,26275,0,0,0,0,1195,2714,3909
2018-06-06,24,4609,5083,2029,11267,10667,2052,58,24043,0,0,0,0,1189,2732,3921
2018-06-07,1,4222,4840,1896,10459,10182,1937,53,22631,0,0,0,0,1194,2688,3882
2018-06-07,2,3965,4673,1812,10016,9712,1833,50,21611,0,0,0,0,1170,2712,3882
2018-06-07,3,3787,4577,1758,9726,9360,1773,48,20906,0,0,0,0,1155,2696,3851
2018-06-07,4,3675,4585,1737,9614,9190,1746,46,20596,0,0,0,0,1132,2656,3788
2018-06-07,5,3652,4719,1779,9772,9271,1767,47,20857,0,0,0,0,1093,2594,3687
2018-06-07,6,3620,4903,1921,10201,9735,1896,49,21880,3,35,2,40,1024,2447,3471
2018-06-07,7,3754,5195,2155,10852,10305,2073,50,23280,303,1244,210,1757,959,2236,3195
2018-06-07,8,3983,5499,2339,11440,10919,2191,55,24605,1037,3956,792,5785,912,1967,2879
2018-06-07,9,4252,5751,2400,11576,11289,2158,60,25084,1288,5740,1260,8288,889,1687,2576
2018-06-07,10,4526,5989,2443,11341,11547,2041,66,24995,1350,6458,1484,9292,847,1407,2254
2018-06-07,11,4811,6185,2474,11064,11773,2012,72,24920,1379,6903,1627,9909,791,1232,2023
2018-06-07,12,5071,6346,2497,10956,12017,1985,77,25034,1394,7079,1651,10124,763,1363,2126
2018-06-07,13,5326,6541,2556,10850,12130,1975,82,25036,1398,7098,1651,10147,747,1560,2307
2018-06-07,14,5561,6719,2599,11060,12337,2026,86,25508,1398,7072,1648,10118,772,1821,2593
2018-06-07,15,5807,6861,2626,11336,12726,2085,89,26236,1394,6988,1646,10028,889,2219,3108
2018-06-07,16,6007,6982,2656,11687,13047,2172,92,26997,1379,6659,1595,9633,1000,2585,3585
2018-06-07,17,6099,7013,2675,12394,13530,2286,93,28304,1343,6110,1441,8894,1099,2859,3958
2018-06-07,18,6057,6946,2647,12782,13650,2428,91,28951,1264,5057,1199,7520,1156,2917,4073
2018-06-07,19,5949,6729,2621,13090,13522,2525,89,29226,923,2740,698,4361,1187,2971,4158
2018-06-07,20,5712,6489,2566,13140,13247,2609,83,29080,243,474,154,871,1203,2957,4160
2018-06-07,21,5557,6369,2496,13163,13377,2683,78,29301,2,0,0,2,1195,2994,4189
2018-06-07,22,5278,5989,2440,13104,12940,2548,72,28664,0,0,0,0,1195,2971,4166
2018-06-07,23,4868,5500,2259,12175,11910,2316,64,26465,0,0,0,0,1198,2935,4133
2018-06-07,24,4474,5096,2047,11237,10853,2084,57,24231,0,0,0,0,1174,2944,4118
2018-06-08,1,4234,4796,1872,10539,10182,1935,52,22708,0,0,0,0,1112,2882,3994
2018-06-08,2,3975,4627,1781,10075,9693,1839,49,21656,0,0,0,0,1076,2813,3889
2018-06-08,3,3804,4519,1724,9817,9342,1784,47,20990,0,0,0,0,1049,2692,3741
2018-06-08,4,3689,4526,1700,9711,9168,1766,46,20690,0,0,0,0,1013,2512,3525
2018-06-08,5,3657,4640,1744,9877,9321,1799,46,21044,0,0,0,0,978,2327,3305
2018-06-08,6,3639,4790,1880,10332,9685,1889,48,21953,4,39,2,45,893,1995,2888
2018-06-08,7,3727,5067,2096,10952,10193,2020,50,23215,315,1316,214,1845,784,1564,2348
2018-06-08,8,4003,5388,2270,11487,10807,2129,54,24477,1062,4141,804,6007,660,1108,1768
2018-06-08,9,4310,5645,2348,11557,11157,2150,58,24922,1298,5864,1277,8439,549,731,1280
2018-06-08,10,4631,5880,2398,11409,11451,2120,64,25044,1354,6549,1491,9394,444,423,867
2018-06-08,11,4953,6054,2426,11307,11919,2104,70,25401,1384,6980,1633,9997,357,290,647
2018-06-08,12,5241,6193,2432,11256,12307,2098,77,25738,1397,7147,1652,10196,364,336,700
2018-06-08,13,5535,6359,2456,11180,12675,2124,82,26062,1401,7158,1651,10210,432,424,856
2018-06-08,14,5826,6516,2482,11433,13222,2184,88,26926,1400,7143,1648,10191,535,574,1109
2018-06-08,15,6122,6649,2492,11913,13826,2282,91,28113,1397,7063,1645,10105,729,1099,1828
2018-06-08,16,6370,6739,2525,12374,14395,2387,95,29251,1382,6761,1601,9744,887,1717,2604
2018-06-08,17,6448,6761,2497,12879,14728,2507,96,30210,1345,6221,1447,9013,1036,2283,3319
2018-06-08,18,6466,6687,2467,13504,14776,2590,96,30966,1269,5181,1203,7653,1073,2516,3589
2018-06-08,19,6318,6546,2390,13745,14473,2600,93,30912,925,2865,698,4488,1110,2678,3788
2018-06-08,20,6028,6259,2322,13750,14012,2608,87,30457,244,519,152,915,1125,2767,3892
2018-06-08,21,5814,6172,2260,13607,13968,2675,79,30329,2,0,0,2,1175,2847,4022
2018-06-08,22,5505,5862,2258,13432,13478,2573,72,29556,0,0,0,0,1176,2906,4082
2018-06-08,23,5095,5412,2163,12550,12484,2367,65,27466,0,0,0,0,1187,2927,4114
2018-06-08,24,4700,5033,1980,11596,11433,2152,57,25239,0,0,0,0,1135,2943,4078
2018-06-09,1,4335,4798,1763,10691,10660,2051,52,23454,0,0,0,0,1032,2949,3981
2018-06-09,2,4073,4623,1673,10157,10021,1907,48,22134,0,0,0,0,988,2923,3911
2018-06-09,3,3884,4510,1616,9806,9636,1834,46,21322,0,0,0,0,929,2880,3809
2018-06-09,4,3734,4470,1590,9631,9365,1794,45,20835,0,0,0,0,889,2846,3735
2018-06-09,5,3661,4482,1601,9641,9298,1788,45,20771,0,0,0,0,849,2803,3652
2018-06-09,6,3560,4448,1632,9835,9168,1826,45,20875,4,39,2,45,829,2753,3582
2018-06-09,7,3580,4611,1707,10041,9186,1866,47,21140,302,1309,212,1823,810,2664,3474
2018-06-09,8,3802,4914,1842,10129,9459,1910,50,21548,1025,4110,796,5931,793,2560,3353
2018-06-09,9,4105,5195,1986,10226,9757,1902,55,21940,1279,5840,1266,8385,809,2524,3333
2018-06-09,10,4431,5466,2076,10232,10185,1867,60,22344,1343,6531,1486,9360,781,2472,3253
2018-06-09,11,4733,5680,2121,10211,10626,1850,67,22754,1373,6975,1629,9977,760,2460,3220
2018-06-09,12,4981,5869,2126,10146,11008,1839,74,23067,1388,7149,1651,10188,787,2625,3412
2018-06-09,13,5198,6056,2110,10078,11395,1855,80,23407,1390,7167,1647,10204,837,2807,3644
2018-06-09,14,5406,6232,2077,10099,11827,1895,86,23907,1386,7151,1645,10182,880,3001,3881
2018-06-09,15,5636,6421,2036,10185,12227,1964,90,24466,1373,7068,1640,10081,915,3217,4132
2018-06-09,16,5819,6635,2027,10416,12701,2070,92,25280,1303,6771,1584,9658,971,3383,4354
2018-06-09,17,5887,6698,2048,10879,13067,2215,95,26257,1191,6251,1420,8862,1034,3468,4502
2018-06-09,18,5821,6689,2062,11459,13327,2361,93,27240,1064,5238,1146,7448,1031,3484,4515
2018-06-09,19,5664,6505,2065,11958,13271,2518,90,27836,784,2938,659,4381,993,3443,4436
2018-06-09,20,5431,6257,2045,12226,12982,2600,83,27891,218,607,150,975,951,3354,4305
2018-06-09,21,5356,6133,2051,12297,13035,2687,76,28096,2,43,0,45,801,3313,4114
2018-06-09,22,5165,5810,2110,12329,12684,2590,71,27673,0,0,0,0,675,3276,3951
2018-06-09,23,4887,5387,2024,11714,11865,2398,64,26040,0,0,0,0,571,3242,3813
2018-06-09,24,4559,4975,1871,10952,10962,2193,57,24165,0,0,0,0,490,3248,3738
2018-06-10,1,4315,4527,1700,10206,10332,1986,53,22578,0,0,0,0,385,3334,3719
2018-06-10,2,4088,4330,1630,9751,9811,1892,50,21504,0,0,0,0,299,3261,3560
2018-06-10,3,3914,4232,1606,9492,9394,1804,47,20738,0,0,0,0,309,3246,3555
2018-06-10,4,3796,4167,1611,9310,9137,1762,46,20254,0,0,0,0,319,3222,3541
2018-06-10,5,3708,4133,1646,9305,9027,1757,45,20134,0,0,0,0,324,3174,3498
2018-06-10,6,3590,4070,1679,9315,8917,1775,45,20053,3,37,2,42,321,3141,3462
2018-06-10,7,3563,4175,1738,9293,8727,1766,45,19831,295,1265,214,1774,329,3005,3334
2018-06-10,8,3747,4420,1868,9394,8910,1818,49,20170,995,3957,802,5754,385,2775,3160
2018-06-10,9,4037,4633,1998,9324,9071,1846,54,20294,1244,5689,1264,8197,389,2514,2903
2018-06-10,10,4311,4841,2065,9130,9448,1848,60,20486,1337,6447,1493,9277,369,2162,2531
2018-06-10,11,4522,4963,2064,8929,9871,1844,66,20710,1366,6892,1637,9895,357,1804,2161
2018-06-10,12,4712,5131,2042,8805,10253,1831,71,20960,1381,7072,1667,10120,312,1866,2178
2018-06-10,13,4881,5221,2034,8767,10689,1843,75,21373,1390,7120,1669,10179,283,1976,2259
2018-06-10,14,5043,5324,2014,8923,11159,1896,79,22056,1388,7107,1667,10162,257,2198,2455
2018-06-10,15,5208,5436,1982,9242,11811,1973,81,23108,1383,7033,1664,10080,292,2495,2787
2018-06-10,16,5363,5519,1984,9784,12369,2075,84,24312,1369,6770,1623,9762,352,2809,3161
2018-06-10,17,5438,5519,2022,10500,12854,2237,86,25677,1333,6258,1462,9053,472,3052,3524
2018-06-10,18,5503,5419,2076,11197,13164,2415,87,26863,1255,5247,1217,7719,600,3174,3774
2018-06-10,19,5396,5285,2106,11772,13172,2506,84,27535,901,3007,709,4617,681,3196,3877
2018-06-10,20,5200,5220,2100,11987,12925,2531,79,27521,239,669,161,1069,772,3154,3926
2018-06-10,21,5161,5247,2093,12134,12973,2612,74,27793,3,64,1,68,754,3123,3877
2018-06-10,22,4946,5083,2101,12080,12608,2524,68,27280,0,0,0,0,747,3038,3785
2018-06-10,23,4618,4823,1979,11282,11676,2318,60,25336,0,0,0,0,768,2908,3676
2018-06-10,24,4290,4579,1823,10448,10629,2101,54,23232,0,0,0,0,763,2796,3559
2018-06-11,1,4185,4365,1722,10119,10292,2041,50,22502,0,0,0,0,826,2614,3440
2018-06-11,2,3943,4267,1671,9720,9765,1948,46,21479,0,0,0,0,767,2468,3235
2018-06-11,3,3767,4233,1656,9478,9415,1891,44,20828,0,0,0,0,707,2257,2964
2018-06-11,4,3641,4286,1677,9415,9280,1865,43,20604,0,0,0,0,630,2008,2638
2018-06-11,5,3627,4439,1762,9643,9464,1902,45,21053,0,0,0,0,558,1714,2272
2018-06-11,6,3609,4648,1947,10112,9908,2018,47,22085,4,36,2,42,493,1335,1828
2018-06-11,7,3726,4951,2227,10784,10503,2196,50,23534,298,1307,219,1824,437,919,1356
2018-06-11,8,4033,5177,2390,11416,11287,2278,54,25035,1009,4090,814,5913,385,546,931
2018-06-11,9,4358,5339,2390,11599,11864,2294,60,25817,1287,5844,1287,8418,351,316,667
2018-06-11,10,4688,5483,2389,11649,12384,2317,65,26416,1345,6511,1508,9364,304,241,545
2018-06-11,11,5001,5583,2393,11727,13006,2341,71,27146,1374,6941,1652,9967,278,241,519
2018-06-11,12,5321,5649,2390,11846,13554,2367,77,27844,1388,7127,1671,10186,231,244,475
2018-06-11,13,5630,5768,2398,12000,14070,2397,82,28549,1392,7135,1670,10197,197,246,443
2018-06-11,14,5925,5886,2402,12405,14630,2462,87,29584,1391,7118,1669,10178,183,248,431
2018-06-11,15,6245,6011,2391,12864,15269,2566,91,30790,1385,7023,1666,10074,212,303,515
2018-06-11,16,6544,6144,2400,13386,15846,2674,94,32000,1370,6702,1625,9697,248,433,681
2018-06-11,17,6665,6208,2417,13944,16133,2783,96,32956,1334,6195,1469,8998,337,720,1057
2018-06-11,18,6726,6180,2452,14493,16123,2854,96,33567,1246,5209,1210,7665,421,1148,1569
2018-06-11,19,6619,6089,2464,14850,15792,2874,94,33610,881,2994,723,4598,516,1484,2000
2018-06-11,20,6310,5863,2439,14906,15313,2905,88,33212,236,691,163,1090,624,1757,2381
2018-06-11,21,6102,5806,2385,14717,15277,2898,81,32973,3,65,1,69,674,1764,2438
2018-06-11,22,5765,5480,2318,14404,14628,2745,74,31851,0,0,0,0,736,1724,2460
2018-06-11,23,5276,5050,2148,13199,13349,2471,65,29084,0,0,0,0,795,1612,2407
2018-06-11,24,4828,4730,1960,12052,12080,2232,58,26422,0,0,0,0,806,1475,2281
2018-06-12,1,4428,4538,1873,11213,11510,2058,55,24836,0,0,0,0,793,1395,2188
2018-06-12,2,4152,4427,1802,10638,10696,1939,52,23325,0,0,0,0,796,1261,2057
2018-06-12,3,3941,4369,1767,10230,10229,1882,50,22392,0,0,0,0,732,1113,1845
2018-06-12,4,3810,4397,1764,10073,9928,1855,49,21905,0,0,0,0,661,908,1569
2018-06-12,5,3772,4531,1828,10203,9896,1888,50,22037,0,0,0,0,581,740,1321
2018-06-12,6,3729,4719,1995,10614,10207,1985,53,22859,4,37,2,43,542,563,1105
2018-06-12,7,3841,5022,2264,11290,10780,2123,55,24248,299,1246,217,1762,488,418,906
2018-06-12,8,4151,5243,2415,12152,11738,2265,61,26216,1020,3899,769,5688,454,293,747
2018-06-12,9,4509,5408,2433,12538,12287,2317,66,27208,1293,5607,1228,8128,392,190,582
2018-06-12,10,4903,5558,2465,12759,12816,2339,71,27985,1347,6290,1451,9088,326,171,497
2018-06-12,11,5295,5680,2465,13093,13459,2358,77,28988,1378,6736,1594,9708,266,188,454
2018-06-12,12,5695,5774,2484,13515,14036,2367,85,30003,1393,6939,1616,9948,246,225,471
2018-06-12,13,6064,5926,2526,13967,14570,2398,91,31026,1395,6952,1615,9962,255,250,505
2018-06-12,14,6433,6074,2558,14679,15306,2462,97,32545,1394,6917,1614,9925,279,299,578
2018-06-12,15,6816,6248,2587,15351,16107,2555,102,34115,1389,6799,1610,9798,377,404,781
2018-06-12,16,7143,6423,2629,16013,16736,2646,105,35500,1372,6444,1568,9384,516,618,1134
2018-06-12,17,7270,6509,2695,16660,17151,2756,106,36673,1341,5921,1449,8711,678,910,1588
2018-06-12,18,7254,6496,2721,17056,17140,2831,107,37134,1265,4951,1210,7426,748,1097,1845
2018-06-12,19,7142,6414,2697,17080,16784,2835,103,36801,955,2907,743,4605,825,1293,2118
2018-06-12,20,6808,6142,2640,16728,16031,2816,96,35671,350,648,177,1175,896,1521,2417
2018-06-12,21,6517,6046,2560,16223,15706,2875,87,34892,102,60,1,163,977,1623,2600
2018-06-12,22,6121,5686,2479,15672,14865,2745,79,33362,0,0,0,0,1045,1651,2696
2018-06-12,23,5605,5217,2267,14213,13561,2470,70,30314,0,0,0,0,1106,1627,2733
2018-06-12,24,5116,4867,2042,12857,12264,2221,63,27405,0,0,0,0,1111,1588,2699
2018-06-13,1,4661,4759,1887,11795,11144,2163,59,25161,0,0,0,0,1057,1714,2771
2018-06-13,2,4350,4637,1801,11122,10453,2038,55,23669,0,0,0,0,1027,1657,2684
2018-06-13,3,4127,4562,1748,10687,9988,1960,53,22688,0,0,0,0,944,1574,2518
2018-06-13,4,3969,4575,1726,10467,9694,1924,52,22137,0,0,0,0,877,1481,2358
2018-06-13,5,3905,4698,1767,10553,9723,1952,53,22281,0,0,0,0,830,1333,2163
2018-06-13,6,3860,4857,1906,10870,10133,2058,54,23115,4,36,2,42,758,1096,1854
2018-06-13,7,3957,5162,2133,11483,10680,2175,57,24394,300,1190,221,1711,684,897,1581
2018-06-13,8,4265,5442,2324,12161,11363,2293,62,25880,1022,3784,799,5605,566,673,1239
2018-06-13,9,4630,5679,2385,12682,12141,2369,68,27260,1294,5502,1263,8059,431,474,905
2018-06-13,10,5027,5887,2424,12964,12680,2414,74,28133,1349,6198,1484,9031,320,341,661
2018-06-13,11,5428,6084,2455,13366,13306,2471,81,29225,1381,6662,1626,9669,223,310,533
2018-06-13,12,5808,6278,2477,13784,13908,2525,88,30305,1394,6874,1648,9916,222,354,576
2018-06-13,13,6176,6522,2526,14226,14646,2594,95,31561,1398,6937,1648,9983,248,470,718
2018-06-13,14,6542,6746,2564,14988,15502,2675,100,33265,1397,6914,1647,9958,342,638,980
2018-06-13,15,6911,6973,2589,15769,16329,2755,104,34958,1391,6807,1642,9840,542,875,1417
2018-06-13,16,7207,7188,2584,16477,17021,2856,107,36461,1381,6454,1605,9440,742,1185,1927
2018-06-13,17,7288,7276,2602,17105,17351,2967,108,37530,1350,5943,1453,8746,923,1516,2439
2018-06-13,18,7250,7311,2582,17472,17196,3066,107,37842,1278,5034,1217,7529,1011,1601,2612
2018-06-13,19,7133,7119,2528,17520,16738,3055,103,37416,970,3005,749,4724,1095,1675,2770
2018-06-13,20,6809,6803,2488,17152,16138,3050,96,36436,353,690,178,1221,1146,1722,2868
2018-06-13,21,6549,6610,2422,16541,15815,3032,88,35475,103,63,1,167,1166,1844,3010
2018-06-13,22,6164,6186,2377,15866,15031,2859,80,33837,0,0,0,0,1167,1979,3146
2018-06-13,23,5664,5648,2235,14393,13735,2580,72,30780,0,0,0,0,1165,2083,3248
2018-06-13,24,5183,5237,2036,12968,12408,2328,64,27768,0,0,0,0,1153,2087,3240
2018-06-14,1,4759,5000,1853,11713,11110,2118,59,25183,0,0,0,0,1147,2021,3168
2018-06-14,2,4449,4827,1772,11012,10429,2020,55,23700,0,0,0,0,1142,1974,3116
2018-06-14,3,4224,4733,1726,10567,9969,1952,53,22726,0,0,0,0,1124,1910,3034
2018-06-14,4,4062,4734,1720,10345,9731,1919,51,22228,0,0,0,0,1105,1807,2912
2018-06-14,5,4012,4857,1779,10443,9823,1955,52,22453,0,0,0,0,1080,1680,2760
2018-06-14,6,3962,5030,1939,10858,10235,2060,53,23387,4,37,3,44,991,1469,2460
2018-06-14,7,4049,5311,2201,11465,10826,2196,56,24723,301,1164,224,1689,893,1194,2087
2018-06-14,8,4343,5656,2357,11972,11373,2297,61,25883,1021,3650,817,5488,788,980,1768
2018-06-14,9,4688,5939,2381,12218,11853,2317,67,26636,1289,5210,1281,7780,644,838,1482
2018-06-14,10,5061,6205,2421,12391,12355,2341,74,27342,1346,5811,1503,8660,504,725,1229
2018-06-14,11,5428,6431,2441,12608,12960,2364,81,28193,1376,6174,1645,9195,382,720,1102
2018-06-14,12,5790,6623,2445,12856,13526,2383,88,29033,1389,6378,1667,9434,344,871,1215
2018-06-14,13,6129,6852,2461,13125,14153,2415,94,29967,1404,6419,1666,9489,328,1042,1370
2018-06-14,14,6451,7047,2466,13677,15093,2491,99,31540,1402,6369,1667,9438,338,1243,1581
2018-06-14,15,6761,7210,2462,14299,15969,2592,103,33143,1396,6293,1663,9352,399,1348,1747
2018-06-14,16,7018,7356,2465,14935,16598,2678,106,34497,1381,5895,1618,8894,496,1463,1959
2018-06-14,17,7041,7329,2492,15526,16946,2778,107,35537,1352,5340,1462,8154,619,1593,2212
2018-06-14,18,7010,7232,2490,15907,16875,2886,104,35952,1277,4425,1220,6922,743,1590,2333
2018-06-14,19,6890,7049,2487,16053,16507,2955,100,35798,965,2401,735,4101,844,1595,2439
2018-06-14,20,6580,6777,2457,15861,15923,2958,94,35019,352,522,175,1049,908,1684,2592
2018-06-14,21,6371,6633,2404,15419,15608,2961,87,34259,103,47,1,151,966,1681,2647
2018-06-14,22,6022,6246,2358,14934,14868,2800,80,32865,0,0,0,0,1017,1695,2712
2018-06-14,23,5561,5730,2194,13678,13548,2538,71,30019,0,0,0,0,1070,1716,2786
2018-06-14,24,5103,5293,2000,12415,12218,2291,64,27171,0,0,0,0,1076,1678,2754
2018-06-15,1,4789,4941,1849,11417,10892,2095,58,24647,0,0,0,0,1082,1659,2741
2018-06-15,2,4497,4746,1763,10865,10308,1986,54,23399,0,0,0,0,1068,1573,2641
2018-06-15,3,4269,4624,1720,10478,9948,1915,51,22575,0,0,0,0,1016,1504,2520
2018-06-15,4,4113,4601,1711,10289,9762,1886,50,22169,0,0,0,0,971,1443,2414
2018-06-15,5,4057,4700,1768,10403,9874,1923,50,22431,0,0,0,0,927,1351,2278
2018-06-15,6,4007,4838,1913,10805,10234,2015,51,23288,4,26,2,32,840,1184,2024
2018-06-15,7,4089,5120,2144,11313,10686,2154,53,24391,302,1029,220,1551,758,1068,1826
2018-06-15,8,4368,5459,2294,11809,11163,2289,58,25499,1010,3292,805,5107,689,909,1598
2018-06-15,9,4689,5737,2347,12068,11602,2334,63,26249,1284,4828,1267,7379,639,859,1498
2018-06-15,10,5046,5982,2391,12153,12059,2314,70,26776,1348,5482,1497,8327,598,840,1438
2018-06-15,11,5373,6164,2409,12190,12502,2300,76,27248,1378,5920,1638,8936,531,912,1443
2018-06-15,12,5670,6287,2410,12251,12868,2280,83,27661,1392,6070,1667,9129,547,1054,1601
2018-06-15,13,5965,6440,2419,12292,13197,2275,89,28035,1397,6138,1666,9201,601,1214,1815
2018-06-15,14,6232,6582,2426,12703,13730,2308,94,29017,1396,6061,1667,9124,672,1381,2053
2018-06-15,15,6487,6690,2413,13164,14276,2371,97,30089,1392,5990,1664,9046,780,1546,2326
2018-06-15,16,6682,6774,2413,13625,14729,2444,100,31078,1376,5738,1610,8724,884,1738,2622
2018-06-15,17,6721,6813,2456,14054,14926,2541,100,31801,1348,5283,1451,8082,1000,1902,2902
2018-06-15,18,6679,6715,2421,14346,14827,2605,98,32059,1276,4503,1207,6986,1037,1920,2957
2018-06-15,19,6549,6470,2392,14533,14515,2614,95,31940,961,2682,735,4378,1052,1917,2969
2018-06-15,20,6269,6235,2338,14441,14034,2605,89,31352,353,628,176,1157,1052,1856,2908
2018-06-15,21,6079,6151,2271,14109,13856,2667,83,30899,103,53,1,157,1027,1816,2843
2018-06-15,22,5772,5906,2257,13846,13424,2569,76,30099,0,0,0,0,1032,1811,2843
2018-06-15,23,5374,5499,2139,12910,12411,2384,68,27956,0,0,0,0,1031,1833,2864
2018-06-15,24,4978,5110,1962,11923,11427,2173,60,25767,0,0,0,0,1017,1777,2794
2018-06-16,1,4695,4853,1805,11137,10192,2043,53,23618,0,0,0,0,1029,1329,2358
2018-06-16,2,4406,4665,1720,10562,9695,1929,49,22428,0,0,0,0,990,1222,2212
2018-06-16,3,4197,4554,1667,10186,9416,1865,47,21707,0,0,0,0,909,1168,2077
2018-06-16,4,4039,4506,1650,9997,9228,1840,46,21303,0,0,0,0,827,1097,1924
2018-06-16,5,3937,4503,1666,9969,9237,1842,45,21286,0,0,0,0,743,1071,1814
2018-06-16,6,3827,4463,1704,10072,9323,1875,45,21509,4,25,2,31,645,1049,1694
2018-06-16,7,3822,4608,1765,10163,9218,1911,45,21539,300,1061,211,1572,545,1019,1564
2018-06-16,8,4017,4900,1878,10439,9493,1993,49,22164,1008,3421,774,5203,462,976,1438
2018-06-16,9,4317,5182,2028,10570,9830,2044,55,22687,1291,5050,1239,7580,424,1007,1431
2018-06-16,10,4666,5407,2127,10604,10227,2076,60,23154,1352,5851,1483,8686,382,1070,1452
2018-06-16,11,4982,5566,2164,10589,10322,2075,66,23239,1383,6323,1631,9337,340,1196,1536
2018-06-16,12,5233,5739,2163,10569,10315,2013,71,23157,1397,6465,1660,9522,465,1419,1884
2018-06-16,13,5439,5923,2157,10521,10291,1941,76,23019,1400,6607,1665,9672,614,1628,2242
2018-06-16,14,5643,6074,2147,10730,10440,1866,80,23305,1398,6624,1668,9690,788,1825,2613
2018-06-16,15,5815,6249,2135,10964,10594,1839,83,23667,1396,6630,1665,9691,968,1981,2949
2018-06-16,16,5970,6402,2148,11367,10734,1893,85,24265,1377,6335,1603,9315,1122,2086,3208
2018-06-16,17,6064,6531,2184,11812,10938,1969,87,24994,1350,5817,1453,8620,1186,2152,3338
2018-06-16,18,6032,6455,2201,12240,11011,2069,86,25594,1278,4902,1213,7393,1193,2119,3312
2018-06-16,19,5911,6359,2198,12694,11078,2185,82,26227,963,2967,727,4657,1207,2085,3292
2018-06-16,20,5676,6138,2178,12977,11084,2292,77,26619,353,702,181,1236,1222,2013,3235
2018-06-16,21,5561,6060,2140,12905,11440,2425,72,27033,103,92,1,196,1214,1911,3125
2018-06-16,22,5345,5823,2138,12778,11263,2363,68,26662,0,0,0,0,1222,1854,3076
2018-06-16,23,5002,5431,2021,12106,10676,2202,61,25238,0,0,0,0,1209,1767,2976
2018-06-16,24,4679,5038,1851,11209,9963,2022,55,23443,0,0,0,0,1141,1665,2806
2018-06-17,1,4336,4658,1774,10283,9469,1916,50,21928,0,0,0,0,1044,1781,2825
2018-06-17,2,4072,4495,1696,9816,9063,1816,47,20955,0,0,0,0,909,1758,2667
2018-06-17,3,3890,4389,1646,9495,8703,1754,44,20209,0,0,0,0,827,1731,2558
2018-06-17,4,3759,4347,1620,9317,8491,1726,43,19791,0,0,0,0,767,1725,2492
2018-06-17,5,3669,4324,1621,9323,8448,1730,42,19757,0,0,0,0,728,1720,2448
2018-06-17,6,3566,4253,1631,9322,8428,1749,42,19755,3,39,1,43,616,1720,2336
2018-06-17,7,3524,4396,1663,9231,8187,1758,45,19422,250,1281,190,1721,449,1674,2123
2018-06-17,8,3717,4670,1795,9351,8253,1809,48,19663,867,3947,705,5519,308,1641,1949
2018-06-17,9,3974,4852,1962,9381,8536,1851,52,20030,1160,5678,1147,7985,243,1684,1927
2018-06-17,10,4195,5051,2064,9315,8758,1848,56,20186,1254,6400,1386,9040,184,1739,1923
2018-06-17,11,4376,5230,2104,9202,8801,1787,60,20060,1302,6829,1520,9651,127,1829,1956
2018-06-17,12,4548,5485,2133,9140,8721,1701,64,19836,1344,7017,1614,9975,118,1937,2055
2018-06-17,13,4732,5661,2160,9125,8721,1648,66,19770,1365,7055,1634,10054,126,2038,2164
2018-06-17,14,4886,5868,2179,9211,8874,1648,70,20011,1370,7050,1650,10070,162,2145,2307
2018-06-17,15,5039,6064,2207,9474,9139,1689,72,20583,1361,6971,1650,9982,262,2244,2506
2018-06-17,16,5187,6262,2251,9974,9524,1785,75,21566,1343,6671,1615,9629,361,2361,2722
2018-06-17,17,5284,6368,2319,10580,9897,1923,76,22683,1310,6172,1465,8947,495,2468,2963
2018-06-17,18,5268,6357,2380,11273,10334,2069,76,23961,1219,5228,1221,7668,672,2514,3186
2018-06-17,19,5196,6285,2423,11826,10662,2186,74,24957,919,3170,751,4840,826,2560,3386
2018-06-17,20,5014,6085,2390,12058,10786,2263,69,25384,339,773,189,1301,933,2571,3504
2018-06-17,21,4983,5981,2338,12189,11143,2388,66,25996,103,109,2,214,1003,2531,3534
2018-06-17,22,4792,5679,2310,12176,11034,2341,62,25822,0,0,0,0,1068,2536,3604
2018-06-17,23,4509,5278,2137,11440,10395,2155,55,24256,0,0,0,0,1102,2518,3620
2018-06-17,24,4200,4913,1929,10561,9573,1959,49,22353,0,0,0,0,1075,2595,3670
2018-06-18,1,3973,4513,1788,9938,9079,1902,45,21175,0,0,0,0,993,2742,3735
2018-06-18,2,3768,4386,1716,9586,8810,1826,43,20475,0,0,0,0,920,2739,3659
2018-06-18,3,3598,4320,1675,9339,8611,1784,42,19986,0,0,0,0,899,2704,3603
2018-06-18,4,3487,4346,1667,9285,8564,1761,42,19862,0,0,0,0,880,2603,3483
2018-06-18,5,3485,4478,1721,9518,8797,1804,44,20372,0,0,0,0,858,2460,3318
2018-06-18,6,3493,4659,1858,9997,9323,1918,46,21493,3,43,2,48,789,2187,2976
2018-06-18,7,3590,4967,2095,10637,9913,2072,50,22880,283,1316,214,1813,717,1776,2493
2018-06-18,8,3868,5244,2316,11374,10392,2192,54,24225,974,4047,815,5836,641,1308,1949
2018-06-18,9,4131,5463,2398,11598,10647,2174,57,24685,1266,5794,1279,8339,557,906,1463
2018-06-18,10,4392,5638,2451,11566,10850,2151,60,24835,1333,6444,1506,9283,461,570,1031
2018-06-18,11,4606,5744,2500,11622,11052,2120,63,25065,1364,6866,1650,9880,364,347,711
2018-06-18,12,4811,5805,2544,11670,11154,2068,67,25166,1378,7058,1665,10101,338,375,713
2018-06-18,13,5010,5894,2612,11769,11276,2020,70,25342,1388,7091,1666,10145,335,502,837
2018-06-18,14,5192,5998,2651,12107,11545,1998,73,25930,1386,7082,1670,10138,362,735,1097
2018-06-18,15,5386,6075,2672,12565,11846,2011,76,26705,1384,7009,1667,10060,453,1248,1701
2018-06-18,16,5595,6159,2694,13067,12180,2095,78,27628,1365,6706,1637,9708,586,1794,2380
2018-06-18,17,5708,6220,2693,13556,12328,2215,80,28388,1339,6168,1487,8994,733,2328,3061
2018-06-18,18,5767,6122,2713,14018,12283,2372,81,28963,1279,5228,1259,7766,818,2531,3349
2018-06-18,19,5728,6061,2707,14371,12328,2456,81,29444,972,3056,778,4806,883,2630,3513
2018-06-18,20,5527,5864,2691,14340,12336,2553,77,29514,368,661,195,1224,920,2652,3572
2018-06-18,21,5421,5825,2589,14137,12694,2645,72,29756,104,49,2,155,933,2716,3649
2018-06-18,22,5167,5520,2528,13909,12281,2515,66,28978,0,0,0,0,943,2717,3660
2018-06-18,23,4768,5125,2323,12815,11313,2276,58,26672,0,0,0,0,964,2708,3672
2018-06-18,24,4397,4803,2095,11721,10392,2059,52,24433,0,0,0,0,972,2652,3624
2018-06-19,1,4051,4593,1984,10961,9929,2005,49,23153,0,0,0,0,963,2522,3485
2018-06-19,2,3818,4455,1897,10474,9529,1915,47,22174,0,0,0,0,932,2402,3334
2018-06-19,3,3643,4389,1839,10129,9198,1857,45,21438,0,0,0,0,890,2200,3090
2018-06-19,4,3542,4407,1811,10026,9053,1832,44,21165,0,0,0,0,839,1982,2821
2018-06-19,5,3516,4533,1844,10217,9202,1872,45,21546,0,0,0,0,786,1728,2514
2018-06-19,6,3502,4724,1969,10618,9663,1973,48,22511,3,43,1,47,700,1322,2022
2018-06-19,7,3621,5027,2195,11219,10193,2091,51,23762,288,1328,214,1830,609,914,1523
2018-06-19,8,3904,5257,2407,11847,10805,2170,55,25084,973,4089,814,5876,526,563,1089
2018-06-19,9,4210,5415,2487,12046,11160,2178,60,25651,1258,5836,1278,8372,441,336,777
2018-06-19,10,4523,5554,2544,12132,11464,2163,64,26030,1314,6485,1495,9294,333,260,593
2018-06-19,11,4835,5653,2590,12295,11870,2154,68,26595,1355,6907,1639,9901,233,231,464
2018-06-19,12,5144,5713,2663,12485,12228,2140,73,27134,1372,7084,1660,10116,209,226,435
2018-06-19,13,5432,5823,2745,12741,12631,2139,78,27797,1377,7104,1655,10136,221,238,459
2018-06-19,14,5718,5942,2810,13271,13198,2141,82,28901,1379,7094,1658,10131,253,276,529
2018-06-19,15,6028,6051,2859,13856,13724,2196,86,30070,1371,7013,1655,10039,367,450,817
2018-06-19,16,6331,6176,2906,14477,14290,2286,89,31352,1355,6723,1626,9704,499,809,1308
2018-06-19,17,6487,6243,2956,15060,14713,2385,91,32459,1325,6189,1474,8988,649,1353,2002
2018-06-19,18,6528,6191,2994,15488,14816,2501,92,33107,1240,5243,1242,7725,733,1732,2465
2018-06-19,19,6461,6105,2973,15717,14655,2592,90,33264,940,3100,767,4807,801,1926,2727
2018-06-19,20,6189,5988,2902,15574,14285,2676,85,32830,325,651,190,1166,847,2124,2971
2018-06-19,21,5983,5867,2787,15203,14213,2742,78,32446,71,51,2,124,928,2198,3126
2018-06-19,22,5650,5570,2695,14748,13663,2616,71,31307,0,0,0,0,990,2171,3161
2018-06-19,23,5178,5156,2453,13497,12500,2391,63,28660,0,0,0,0,1040,2107,3147
2018-06-19,24,4754,4827,2199,12320,11492,2172,57,26250,0,0,0,0,1057,2012,3069
2018-06-20,1,4400,4613,2056,11405,10930,2022,56,24623,0,0,0,0,1113,1869,2982
2018-06-20,2,4117,4495,1951,10820,10414,1931,53,23428,0,0,0,0,1116,1739,2855
2018-06-20,3,3921,4430,1886,10437,9997,1871,52,22566,0,0,0,0,1091,1534,2625
2018-06-20,4,3792,4447,1858,10273,9805,1841,50,22178,0,0,0,0,1073,1278,2351
2018-06-20,5,3746,4571,1890,10405,9891,1871,51,22427,0,0,0,0,1052,1022,2074
2018-06-20,6,3711,4752,2005,10849,10265,1956,53,23332,3,45,2,50,1020,708,1728
2018-06-20,7,3807,5057,2219,11413,10856,2138,56,24673,293,1317,213,1823,959,463,1422
2018-06-20,8,4136,5291,2441,12044,11563,2294,62,26172,999,4134,810,5943,887,296,1183
2018-06-20,9,4500,5455,2529,12204,11861,2291,67,26634,1282,5877,1287,8446,869,224,1093
2018-06-20,10,4896,5603,2607,12234,12353,2234,73,27103,1344,6505,1507,9356,843,206,1049
2018-06-20,11,5291,5719,2680,12356,13010,2230,79,27885,1375,6926,1649,9950,792,218,1010
2018-06-20,12,5684,5816,2757,12522,13674,2236,86,28727,1389,7103,1669,10161,779,227,1006
2018-06-20,13,6042,5961,2857,12719,14319,2266,93,29606,1395,7119,1666,10180,792,241,1033
2018-06-20,14,6408,6120,2946,13202,15080,2339,99,30929,1393,7105,1670,10168,828,259,1087
2018-06-20,15,6792,6258,3013,13766,15805,2436,104,32320,1387,7038,1667,10092,883,321,1204
2018-06-20,16,7143,6428,3054,14331,16426,2538,107,33610,1370,6746,1640,9756,949,512,1461
2018-06-20,17,7278,6508,3076,14868,16796,2662,109,34644,1340,6214,1490,9044,1015,901,1916
2018-06-20,18,7291,6501,3051,15287,16903,2778,109,35285,1264,5298,1264,7826,1058,1303,2361
2018-06-20,19,7187,6443,3041,15499,16563,2809,106,35186,940,3196,772,4908,1086,1753,2839
2018-06-20,20,6861,6231,2968,15363,15948,2785,99,34403,284,685,196,1165,1087,2039,3126
2018-06-20,21,6596,6095,2849,15037,15626,2855,90,33816,13,52,2,67,1103,2152,3255
2018-06-20,22,6199,5743,2761,14671,14922,2741,82,32624,0,0,0,0,1108,2193,3301
2018-06-20,23,5696,5278,2527,13493,13584,2490,73,29848,0,0,0,0,1115,2168,3283
2018-06-20,24,5198,4923,2266,12325,12357,2245,65,27202,0,0,0,0,1091,2169,3260
2018-06-21,1,4808,4797,2052,11491,11452,2043,62,25257,0,0,0,0,1056,2146,3202
2018-06-21,2,4498,4665,1943,10876,10787,1945,58,23877,0,0,0,0,1030,2096,3126
2018-06-21,3,4278,4584,1871,10478,10330,1886,56,22959,0,0,0,0,1001,2016,3017
2018-06-21,4,4120,4595,1840,10322,10102,1857,54,22544,0,0,0,0,967,1903,2870
2018-06-21,5,4072,4713,1872,10428,10203,1894,55,22788,0,0,0,0,931,1780,2711
2018-06-21,6,4005,4885,1983,10808,10563,1996,56,23632,3,37,2,42,867,1630,2497
2018-06-21,7,4126,5185,2193,11396,11271,2140,59,25074,293,1331,220,1844,768,1465,2233
2018-06-21,8,4438,5483,2409,12018,11984,2255,66,26532,987,4135,832,5954,677,1241,1918
2018-06-21,9,4805,5707,2496,12287,12542,2296,72,27407,1273,5875,1286,8434,578,1100,1678
2018-06-21,10,5210,5910,2582,12366,13076,2279,79,28008,1343,6515,1504,9362,426,957,1383
2018-06-21,11,5626,6085,2658,12519,13689,2252,87,28755,1371,6939,1648,9958,287,872,1159
2018-06-21,12,6041,6246,2725,12781,14233,2251,94,29567,1384,7113,1667,10164,228,1012,1240
2018-06-21,13,6413,6467,2808,13081,14763,2264,102,30419,1390,7136,1665,10191,201,1189,1390
2018-06-21,14,6765,6662,2876,13675,15403,2311,108,31705,1388,7127,1669,10184,186,1439,1625
2018-06-21,15,7119,6820,2908,14364,16091,2384,112,33160,1385,7070,1666,10121,258,1799,2057
2018-06-21,16,7415,6971,2938,15031,16667,2473,115,34494,1367,6789,1642,9798,351,2160,2511
2018-06-21,17,7515,7063,2988,15697,16936,2589,117,35547,1337,6256,1491,9084,486,2491,2977
2018-06-21,18,7477,7059,2974,16189,16829,2706,115,36047,1252,5354,1270,7876,610,2616,3226
2018-06-21,19,7353,6855,2938,16379,16458,2748,110,35904,937,3233,780,4950,735,2658,3393
2018-06-21,20,7017,6643,2857,16275,15877,2761,103,35225,287,719,199,1205,786,2675,3461
2018-06-21,21,6742,6449,2744,15832,15669,2837,95,34641,14,55,2,71,830,2798,3628
2018-06-21,22,6359,6066,2678,15326,14989,2718,86,33327,0,0,0,0,860,2881,3741
2018-06-21,23,5869,5570,2466,14107,13740,2472,77,30604,0,0,0,0,878,2910,3788
2018-06-21,24,5374,5154,2219,12881,12586,2235,69,27980,0,0,0,0,887,2919,3806
2018-06-22,1,4999,4822,2014,11754,11192,2056,64,25278,0,0,0,0,823,2790,3613
2018-06-22,2,4673,4639,1899,11108,10522,1959,60,23863,0,0,0,0,794,2761,3555
2018-06-22,3,4435,4545,1833,10673,10144,1910,57,22998,0,0,0,0,751,2610,3361
2018-06-22,4,4258,4549,1803,10477,9960,1895,55,22602,0,0,0,0,701,2451,3152
2018-06-22,5,4199,4656,1827,10583,10071,1930,55,22853,0,0,0,0,649,2344,2993
2018-06-22,6,4102,4811,1923,10961,10478,2028,56,23737,3,41,2,46,543,2082,2625
2018-06-22,7,4219,5091,2114,11472,10892,2161,59,24796,291,1357,219,1867,443,1702,2145
2018-06-22,8,4518,5409,2323,12083,11547,2259,64,26161,986,4137,831,5954,366,1273,1639
2018-06-22,9,4882,5645,2432,12450,12111,2340,70,27179,1271,5881,1285,8437,295,811,1106
2018-06-22,10,5292,5847,2506,12714,12652,2313,78,27965,1342,6517,1502,9361,236,483,719
2018-06-22,11,5674,5995,2574,13070,13268,2248,86,28880,1370,6943,1647,9960,187,331,518
2018-06-22,12,6048,6106,2629,13491,13876,2254,94,29922,1384,7120,1668,10172,151,314,465
2018-06-22,13,6399,6239,2690,13915,14485,2290,102,31001,1387,7141,1666,10194,143,333,476
2018-06-22,14,6743,6372,2743,14712,15205,2361,108,32596,1385,7128,1670,10183,158,436,594
2018-06-22,15,7072,6475,2770,15540,15993,2461,112,34315,1381,7070,1668,10119,228,817,1045
2018-06-22,16,7354,6536,2804,16366,16577,2578,116,35847,1363,6784,1644,9791,332,1464,1796
2018-06-22,17,7416,6573,2803,17026,16829,2701,117,36885,1330,6256,1492,9078,480,2145,2625
2018-06-22,18,7440,6478,2772,17462,16776,2842,117,37410,1248,5354,1271,7873,555,2457,3012
2018-06-22,19,7293,6321,2704,17486,16328,2818,113,36957,944,3245,778,4967,639,2661,3300
2018-06-22,20,6954,6183,2613,17160,15575,2826,106,35879,290,728,198,1216,697,2757,3454
2018-06-22,21,6686,6034,2515,16525,15234,2863,97,34929,14,58,2,74,746,2818,3564
2018-06-22,22,6319,5780,2484,15955,14613,2742,88,33608,0,0,0,0,795,2843,3638
2018-06-22,23,5854,5370,2341,14679,13514,2527,79,31012,0,0,0,0,807,2839,3646
2018-06-22,24,5390,4998,2132,13374,12358,2294,70,28310,0,0,0,0,761,2803,3564
2018-06-23,1,4946,4776,1908,12378,11188,2142,62,25982,0,0,0,0,676,2806,3482
2018-06-23,2,4607,4608,1811,11590,10456,2025,57,24341,0,0,0,0,645,2726,3371
2018-06-23,3,4350,4500,1741,11009,9965,1953,54,23193,0,0,0,0,577,2627,3204
2018-06-23,4,4153,4456,1702,10685,9718,1920,52,22586,0,0,0,0,530,2484,3014
2018-06-23,5,4028,4449,1694,10593,9648,1914,52,22417,0,0,0,0,480,2330,2810
2018-06-23,6,3881,4415,1721,10639,9678,1936,52,22516,3,42,3,48,417,2135,2552
2018-06-23,7,3887,4570,1779,10698,9620,2006,53,22587,289,1337,219,1845,387,1887,2274
2018-06-23,8,4144,4848,1936,11065,9916,2057,58,23307,982,4104,830,5916,364,1595,1959
2018-06-23,9,4533,5091,2090,12668,10452,2035,65,25433,1270,5866,1287,8423,378,1349,1727
2018-06-23,10,4968,5288,2186,12053,10998,1969,72,25306,1338,6503,1504,9345,376,1095,1471
2018-06-23,11,5393,5457,2234,11540,11501,1945,80,25279,1367,6929,1649,9945,388,929,1317
2018-06-23,12,5815,5602,2283,11214,12025,1960,89,25501,1381,7109,1669,10159,351,1022,1373
2018-06-23,13,6197,5754,2318,11061,12571,1948,97,25891,1385,7136,1668,10189,324,1176,1500
2018-06-23,14,6575,5901,2350,11143,13082,1963,105,26507,1384,7124,1670,10178,302,1442,1744
2018-06-23,15,6918,6016,2380,11275,13579,2042,110,27219,1380,7062,1668,10110,293,1766,2059
2018-06-23,16,7176,6137,2423,11842,14063,2116,114,28347,1360,6789,1646,9795,306,2117,2423
2018-06-23,17,7323,6255,2480,12405,14422,2223,117,29379,1328,6260,1494,9082,330,2462,2792
2018-06-23,18,7310,6279,2533,12735,14544,2358,115,29965,1243,5357,1272,7872,351,2485,2836
2018-06-23,19,7138,6122,2493,13138,14283,2451,111,30197,936,3258,791,4985,391,2413,2804
2018-06-23,20,6793,5948,2450,13497,13820,2514,104,30149,291,739,215,1245,426,2311,2737
2018-06-23,21,6537,5820,2364,13895,13659,2606,96,30468,14,59,22,95,465,2391,2856
2018-06-23,22,6208,5582,2327,14550,13211,2538,87,30597,0,0,0,0,530,2463,2993
2018-06-23,23,5783,5226,2175,15408,12323,2382,78,30403,0,0,0,0,600,2513,3113
2018-06-23,24,5363,4877,1990,16240,11403,2197,70,30122,0,0,0,0,616,2401,3017
2018-06-24,1,4948,4633,1931,12225,10432,1979,62,24910,0,0,0,0,719,2227,2946
2018-06-24,2,4627,4467,1845,11446,9891,1876,57,23484,0,0,0,0,702,2044,2746
2018-06-24,3,4379,4390,1775,10895,9461,1808,55,22432,0,0,0,0,681,1750,2431
2018-06-24,4,4193,4341,1741,10558,9189,1779,52,21791,0,0,0,0,699,1486,2185
2018-06-24,5,4069,4300,1728,10408,9091,1777,52,21540,0,0,0,0,700,1232,1932
2018-06-24,6,3905,4256,1723,10359,9040,1792,51,21456,2,38,1,41,685,935,1620
2018-06-24,7,3866,4385,1759,10244,8866,1788,53,21164,286,1339,213,1838,653,698,1351
2018-06-24,8,4119,4650,1909,10443,8882,1842,59,21437,973,4099,814,5886,630,513,1143
2018-06-24,9,4485,4858,2066,10797,9209,1897,65,22179,1260,5850,1270,8380,658,392,1050
2018-06-24,10,4895,5028,2165,11191,9549,1915,72,22938,1332,6494,1494,9320,665,341,1006
2018-06-24,11,5319,5142,2263,11608,9947,1894,80,23739,1361,6917,1642,9920,644,321,965
2018-06-24,12,5739,5357,2354,12117,10366,1847,87,24628,1374,7095,1662,10131,645,308,953
2018-06-24,13,6108,5503,2435,12678,10764,1834,93,25581,1382,7125,1662,10169,694,333,1027
2018-06-24,14,6481,5687,2507,13325,11173,1869,99,26678,1383,7114,1664,10161,790,395,1185
2018-06-24,15,6812,5844,2580,14057,11710,1935,103,28017,1377,7054,1662,10093,897,503,1400
2018-06-24,16,7057,6014,2664,14788,12350,2037,106,29492,1359,6796,1640,9795,998,755,1753
2018-06-24,17,7205,6159,2752,15526,12905,2181,108,30931,1328,6265,1488,9081,1118,1128,2246
2018-06-24,18,7275,6165,2830,16097,13332,2321,110,32073,1247,5362,1269,7878,1187,1400,2587
2018-06-24,19,7100,6140,2825,16285,13311,2411,106,32324,938,3261,792,4991,1213,1790,3003
2018-06-24,20,6775,5945,2770,15999,13045,2437,99,31793,299,742,218,1259,1226,2153,3379
2018-06-24,21,6544,5832,2670,15446,12954,2538,91,31241,14,59,22,95,1239,2285,3524
2018-06-24,22,6202,5590,2597,14968,12617,2466,83,30346,0,0,0,0,1253,2311,3564
2018-06-24,23,5750,5179,2372,13715,11632,2270,74,27902,0,0,0,0,1264,2316,3580
2018-06-24,24,5300,4861,2111,12467,10659,2074,66,25478,0,0,0,0,1258,2292,3550
2018-06-25,1,5010,4744,1828,11507,9942,1951,59,23673,0,0,0,0,1227,2076,3303
2018-06-25,2,4682,4626,1712,10839,9501,1869,55,22478,0,0,0,0,1208,1951,3159
2018-06-25,3,4438,4551,1655,10447,9207,1821,53,21741,0,0,0,0,1181,1760,2941
2018-06-25,4,4252,4569,1644,10296,9090,1799,52,21450,0,0,0,0,1142,1580,2722
2018-06-25,5,4181,4693,1699,10399,9305,1845,52,21812,0,0,0,0,1075,1375,2450
2018-06-25,6,4140,4872,1828,10871,9805,1951,54,22891,2,38,2,42,1030,1177,2207
2018-06-25,7,4213,5214,2053,11566,10346,2128,57,24308,288,1334,217,1839,960,963,1923
2018-06-25,8,4539,5535,2271,12170,11031,2243,64,25720,977,4132,825,5934,883,752,1635
2018-06-25,9,4943,5808,2362,12347,11447,2255,71,26334,1263,5886,1281,8430,812,524,1336
2018-06-25,10,5379,6039,2436,12438,11836,2189,78,26756,1333,6531,1501,9365,733,392,1125
2018-06-25,11,5801,6240,2508,12620,12259,2167,86,27346,1363,6956,1647,9966,650,357,1007
2018-06-25,12,6214,6441,2553,12803,12631,2190,92,27932,1377,7134,1667,10178,657,407,1064
2018-06-25,13,6613,6661,2607,13012,13050,2194,99,28570,1385,7164,1666,10215,668,515,1183
2018-06-25,14,6954,6883,2636,13503,13619,2239,104,29682,1385,7155,1668,10208,698,657,1355
2018-06-25,15,7305,7052,2639,13985,14203,2349,107,30859,1377,7098,1667,10142,755,829,1584
2018-06-25,16,7575,7221,2632,14482,14679,2438,110,31925,1362,6810,1638,9810,818,1057,1875
2018-06-25,17,7630,7316,2637,15098,15012,2532,111,32968,1332,6278,1495,9105,897,1353,2250
2018-06-25,18,7660,7339,2598,15581,15066,2639,111,33611,1251,5379,1281,7911,947,1630,2577
2018-06-25,19,7556,7237,2561,15973,14838,2683,107,33816,944,3270,836,5050,966,1926,2892
2018-06-25,20,7239,6935,2510,16030,14363,2709,100,33416,300,745,317,1362,986,2111,3097
2018-06-25,21,6978,6708,2438,15698,14253,2781,93,33038,14,30,150,194,1002,2243,3245
2018-06-25,22,6591,6285,2409,15185,13724,2657,85,31864,0,0,0,0,995,2315,3310
2018-06-25,23,6062,5750,2258,13910,12508,2411,75,29117,0,0,0,0,1000,2323,3323
2018-06-25,24,5558,5320,2060,12658,11414,2182,67,26533,0,0,0,0,982,2301,3283
2018-06-26,1,5072,5105,1893,11595,10913,1980,62,24762,0,0,0,0,905,2259,3164
2018-06-26,2,4728,4930,1801,10964,10323,1883,58,23439,0,0,0,0,898,2222,3120
2018-06-26,3,4480,4819,1747,10554,9896,1808,56,22525,0,0,0,0,868,2173,3041
2018-06-26,4,4303,4814,1733,10370,9685,1786,54,22107,0,0,0,0,832,2100,2932
2018-06-26,5,4225,4937,1788,10479,9797,1826,54,22367,0,0,0,0,799,2007,2806
2018-06-26,6,4159,5125,1939,10909,10186,1925,56,23285,2,42,2,46,745,1769,2514
2018-06-26,7,4245,5438,2184,11481,10705,2074,58,24529,290,1305,217,1812,681,1543,2224
2018-06-26,8,4524,5784,2344,12112,11371,2219,65,25978,985,4136,832,5953,573,1312,1885
2018-06-26,9,4893,6064,2398,12368,11829,2301,72,26783,1271,5897,1293,8461,477,1071,1548
2018-06-26,10,5296,6335,2455,12436,12234,2251,79,27212,1337,6537,1505,9379,375,794,1169
2018-06-26,11,5713,6564,2474,12608,12729,2224,86,27860,1367,6966,1648,9981,288,607,895
2018-06-26,12,6148,6771,2500,12795,13173,2217,93,28491,1381,7146,1669,10196,273,651,924
2018-06-26,13,6566,7004,2530,13063,13611,2249,100,29235,1387,7164,1668,10219,290,773,1063
2018-06-26,14,6932,7207,2547,13650,14297,2327,106,30591,1386,7156,1669,10211,328,953,1281
2018-06-26,15,7298,7361,2566,14228,15081,2422,110,32052,1379,7095,1668,10142,426,1267,1693
2018-06-26,16,7590,7518,2593,14872,15642,2541,113,33379,1364,6792,1638,9794,565,1617,2182
2018-06-26,17,7662,7580,2629,15465,16004,2659,115,34455,1333,6265,1498,9096,696,1979,2675
2018-06-26,18,7631,7554,2688,15895,16211,2741,113,35171,1252,5369,1286,7907,791,2154,2945
2018-06-26,19,7536,7438,2653,16100,15914,2730,110,35066,945,3246,841,5032,863,2239,3102
2018-06-26,20,7219,7135,2605,15932,15227,2706,104,34180,300,736,318,1354,923,2230,3153
2018-06-26,21,6939,6890,2521,15474,14864,2765,95,33409,14,28,151,193,975,2324,3299
2018-06-26,22,6529,6464,2474,14992,14227,2656,87,32172,0,0,0,0,1008,2463,3471
2018-06-26,23,6011,5925,2274,13797,13058,2414,77,29557,0,0,0,0,1040,2507,3547
2018-06-26,24,5504,5485,2050,12551,11832,2178,69,26842,0,0,0,0,1051,2483,3534
2018-06-27,1,5046,5302,1914,11690,11071,2048,62,25082,0,0,0,0,1078,2487,3565
2018-06-27,2,4697,5107,1823,11019,10457,1938,58,23684,0,0,0,0,1073,2397,3470
2018-06-27,3,4453,4970,1767,10626,10032,1878,56,22804,0,0,0,0,1055,2335,3390
2018-06-27,4,4275,4934,1745,10424,9817,1860,54,22366,0,0,0,0,1035,2270,3305
2018-06-27,5,4207,5035,1785,10532,9930,1895,54,22622,0,0,0,0,1015,2203,3218
2018-06-27,6,4149,5192,1927,10968,10305,1998,56,23537,2,36,2,40,968,2043,3011
2018-06-27,7,4236,5511,2146,11594,10848,2124,59,24836,288,1228,212,1728,907,1833,2740
2018-06-27,8,4498,5888,2332,11935,11495,2241,65,25946,973,3953,820,5746,831,1598,2429
2018-06-27,9,4852,6223,2410,12014,12036,2257,72,26590,1261,5702,1281,8244,764,1439,2203
2018-06-27,10,5239,6532,2460,12019,12546,2258,78,27112,1333,6351,1501,9185,677,1267,1944
2018-06-27,11,5643,6793,2493,12045,13094,2253,85,27688,1364,6786,1642,9792,584,1142,1726
2018-06-27,12,6044,7022,2529,12138,13612,2248,92,28301,1379,6966,1668,10013,576,1231,1807
2018-06-27,13,6423,7270,2592,12299,14142,2283,99,29033,1385,6987,1667,10039,598,1405,2003
2018-06-27,14,6764,7509,2649,12778,14808,2358,104,30262,1384,6934,1668,9986,633,1652,2285
2018-06-27,15,7106,7676,2693,13276,15536,2447,109,31579,1376,6804,1667,9847,718,2001,2719
2018-06-27,16,7385,7828,2713,13805,16127,2552,111,32805,1362,6388,1638,9388,813,2317,3130
2018-06-27,17,7456,7909,2751,14407,16394,2667,112,33790,1327,5788,1491,8606,914,2523,3437
2018-06-27,18,7425,7912,2721,14882,16413,2772,111,34388,1238,4911,1270,7419,994,2589,3583
2018-06-27,19,7339,7731,2669,15243,16137,2813,107,34511,934,2989,838,4761,1039,2616,3655
2018-06-27,20,7047,7446,2587,15333,15489,2801,100,33936,297,668,318,1283,1049,2586,3635
2018-06-27,21,6802,7162,2509,15055,15115,2850,92,33323,14,25,151,190,1052,2693,3745
2018-06-27,22,6413,6704,2469,14677,14388,2723,85,32083,0,0,0,0,1055,2723,3778
2018-06-27,23,5916,6127,2298,13639,13130,2471,75,29527,0,0,0,0,1036,2734,3770
2018-06-27,24,5424,5670,2081,12494,11873,2226,67,26872,0,0,0,0,1006,2758,3764
2018-06-28,1,4913,5320,1899,11406,10880,2015,61,24575,0,0,0,0,1017,2821,3838
2018-06-28,2,4583,5116,1805,10827,10310,1921,57,23328,0,0,0,0,976,2768,3744
2018-06-28,3,4359,4992,1747,10456,9892,1856,54,22471,0,0,0,0,912,2692,3604
2018-06-28,4,4196,4967,1724,10303,9683,1837,53,22087,0,0,0,0,860,2615,3475
2018-06-28,5,4133,5066,1762,10425,9738,1874,53,22300,0,0,0,0,808,2548,3356
2018-06-28,6,4090,5233,1907,10831,10156,1962,54,23214,2,32,2,36,756,2468,3224
2018-06-28,7,4156,5552,2123,11354,10642,2090,56,24353,287,1120,211,1618,715,2353,3068
2018-06-28,8,4405,5917,2306,11973,11315,2225,62,25787,972,3708,812,5492,648,2202,2850
2018-06-28,9,4732,6238,2384,12184,11775,2316,69,26555,1263,5473,1270,8006,532,2156,2688
2018-06-28,10,5071,6543,2445,12242,12145,2312,76,26986,1335,6247,1491,9073,388,2106,2494
2018-06-28,11,5416,6801,2481,12297,12570,2238,83,27399,1366,6680,1637,9683,274,2094,2368
2018-06-28,12,5757,7017,2505,12370,12999,2220,89,27889,1379,6903,1665,9947,228,2290,2518
2018-06-28,13,6060,7262,2541,12506,13353,2209,95,28373,1384,6967,1664,10015,202,2580,2782
2018-06-28,14,6344,7480,2567,12967,13911,2258,99,29445,1380,6945,1663,9988,218,2854,3072
2018-06-28,15,6617,7620,2587,13490,14456,2314,103,30571,1372,6858,1662,9892,312,3074,3386
2018-06-28,16,6849,7770,2605,14052,14977,2397,105,31740,1360,6557,1629,9546,486,3227,3713
2018-06-28,17,6942,7747,2624,14670,15361,2490,106,32836,1326,6025,1477,8828,690,3320,4010
2018-06-28,18,6908,7635,2599,15075,15411,2645,104,33444,1239,5119,1245,7603,794,3313,4107
2018-06-28,19,6828,7449,2563,15314,15294,2675,101,33594,937,3147,825,4909,857,3276,4133
2018-06-28,20,6580,7182,2526,15281,14779,2663,96,33028,301,710,317,1328,910,3177,4087
2018-06-28,21,6364,6947,2463,14947,14512,2730,89,32488,14,16,151,181,957,3221,4178
2018-06-28,22,6041,6565,2435,14603,13959,2618,81,31470,0,0,0,0,996,3239,4235
2018-06-28,23,5588,6029,2266,13451,12815,2374,72,28924,0,0,0,0,1029,3266,4295
2018-06-28,24,5135,5568,2061,12333,11684,2141,65,26436,0,0,0,0,1018,3265,4283
2018-06-29,1,4713,5105,1903,11389,10904,2021,59,24580,0,0,0,0,941,3327,4268
2018-06-29,2,4403,4874,1809,10798,10283,1931,55,23275,0,0,0,0,904,3287,4191
2018-06-29,3,4196,4748,1753,10403,9858,1876,52,22397,0,0,0,0,805,3202,4007
2018-06-29,4,4034,4711,1731,10227,9635,1853,51,21974,0,0,0,0,720,3062,3782
2018-06-29,5,3992,4792,1774,10343,9752,1883,51,22237,0,0,0,0,664,2884,3548
2018-06-29,6,3941,4933,1909,10740,10081,1985,51,23065,1,30,1,32,619,2639,3258
2018-06-29,7,4014,5226,2112,11254,10531,2106,54,24153,184,1149,182,1515,569,2348,2917
2018-06-29,8,4283,5571,2282,11896,11196,2199,59,25562,626,3630,714,4970,482,2004,2486
2018-06-29,9,4592,5859,2375,12198,11697,2221,65,26393,829,5161,1149,7139,408,1721,2129
2018-06-29,10,4929,6115,2436,12361,12074,2149,71,26868,888,5743,1364,7995,339,1420,1759
2018-06-29,11,5257,6293,2467,12573,12479,2089,77,27429,909,6111,1513,8533,283,1217,1500
2018-06-29,12,5575,6416,2490,12824,12941,2052,83,28111,917,6298,1540,8755,245,1258,1503
2018-06-29,13,5893,6539,2518,13090,13270,2038,89,28696,920,6334,1543,8797,239,1408,1647
2018-06-29,14,6183,6654,2545,13701,13832,2050,94,29886,915,6317,1540,8772,250,1632,1882
2018-06-29,15,6468,6732,2569,14370,14377,2074,97,31128,908,6219,1536,8663,289,2071,2360
2018-06-29,16,6707,6785,2592,15045,14845,2141,100,32339,898,5943,1501,8342,347,2518,2865
2018-06-29,17,6793,6784,2639,15687,15018,2268,101,33284,871,5510,1351,7732,433,2893,3326
2018-06-29,18,6834,6671,2623,16121,15102,2416,102,33950,808,4731,1138,6677,473,2946,3419
2018-06-29,19,6719,6522,2578,16260,14837,2513,99,33918,597,2914,716,4227,520,2929,3449
2018-06-29,20,6448,6259,2500,16103,14324,2564,93,33294,189,683,300,1172,554,2852,3406
2018-06-29,21,6231,6177,2416,15627,14053,2640,86,32614,3,20,151,174,566,2831,3397
2018-06-29,22,5902,5948,2395,15207,13568,2560,79,31622,0,0,0,0,577,2781,3358
2018-06-29,23,5483,5544,2248,14112,12600,2367,70,29359,0,0,0,0,589,2704,3293
2018-06-29,24,5060,5173,2047,12936,11565,2153,63,26926,0,0,0,0,556,2619,3175
2018-06-30,1,4654,4863,1913,12106,10804,1988,58,25169,0,0,0,0,616,2615,3231
2018-06-30,2,4337,4678,1822,11397,10234,1877,54,23775,0,0,0,0,623,2443,3066
2018-06-30,3,4107,4566,1757,10862,9804,1817,51,22748,0,0,0,0,615,2129,2744
2018-06-30,4,3941,4516,1721,10575,9539,1789,50,22165,0,0,0,0,594,1758,2352
2018-06-30,5,3848,4495,1717,10512,9490,1793,49,22056,0,0,0,0,577,1420,1997
2018-06-30,6,3739,4461,1739,10583,9565,1824,49,22233,2,31,1,34,519,1170,1689
2018-06-30,7,3729,4626,1784,10629,9514,1869,50,22274,285,1248,199,1732,499,932,1431
2018-06-30,8,3972,4891,1929,10941,9521,1933,55,22658,970,3986,810,5766,489,666,1155
2018-06-30,9,4317,5179,2097,11417,9873,2002,61,23561,1261,5771,1270,8302,453,397,850
2018-06-30,10,4703,5391,2200,11727,10365,2023,67,24391,1335,6443,1481,9259,402,279,681
2018-06-30,11,5074,5543,2245,12141,10697,2021,74,25142,1362,6859,1634,9855,358,259,617
2018-06-30,12,5437,5681,2297,12588,10952,1974,81,25805,1375,7064,1660,10099,298,276,574
2018-06-30,13,5773,5831,2347,13128,11254,1939,88,26620,1378,7111,1662,10151,254,252,506
2018-06-30,14,6112,5959,2395,13829,11742,1886,94,27766,1375,7102,1659,10136,220,234,454
2018-06-30,15,6411,6112,2451,14601,12228,1940,99,29078,1367,6999,1656,10022,218,235,453
2018-06-30,16,6676,6243,2516,15362,12729,2034,102,30438,1355,6690,1620,9665,246,337,583
2018-06-30,17,6847,6369,2595,16039,13149,2077,104,31580,1321,6177,1477,8975,338,616,954
2018-06-30,18,6889,6382,2639,16515,13306,2190,104,32325,1241,5286,1257,7784,452,1001,1453
2018-06-30,19,6758,6355,2576,16676,13244,2285,101,32518,940,3231,812,4983,571,1580,2151
2018-06-30,20,6469,6118,2517,16448,12891,2320,95,31964,301,723,233,1257,735,2122,2857
2018-06-30,21,6236,5995,2405,15911,12847,2453,88,31509,8,21,151,180,796,2248,3044
2018-06-30,22,5934,5781,2373,15421,12457,2409,80,30577,0,0,0,0,837,2302,3139
2018-06-30,23,5542,5410,2206,14319,11695,2249,72,28546,0,0,0,0,835,2296,3131
2018-06-30,24,5130,5043,2011,13102,10865,2073,65,26317,0,0,0,0,836,2173,3009
2018-07-01,1,4757,4698,1862,12135,10336,1941,61,24684,0,0,0,0,894,1979,2873
2018-07-01,2,4458,4548,1772,11385,9847,1831,57,23331,0,0,0,0,904,1791,2695
2018-07-01,3,4225,4464,1710,10851,9445,1764,55,22325,0,0,0,0,887,1539,2426
2018-07-01,4,4057,4422,1679,10519,9199,1739,53,21721,0,0,0,0,882,1270,2152
2018-07-01,5,3941,4408,1666,10395,9091,1744,52,21492,0,0,0,0,886,964,1850
2018-07-01,6,3812,4359,1662,10378,9101,1776,53,21519,2,30,1,33,864,754,1618
2018-07-01,7,3767,4475,1681,10297,9026,1767,54,21355,283,1243,194,1720,798,576,1374
2018-07-01,8,4040,4769,1803,10431,9125,1800,59,21627,966,3982,787,5735,704,392,1096
2018-07-01,9,4435,4981,1944,10688,9422,1830,65,22217,1256,5769,1249,8274,670,236,906
2018-07-01,10,4875,5165,2048,10936,9664,1811,72,22694,1329,6440,1469,9238,612,176,788
2018-07-01,11,5315,5309,2140,11182,9942,1789,80,23203,1358,6852,1625,9835,523,166,689
2018-07-01,12,5724,5586,2215,11609,10319,1759,87,23986,1371,7059,1655,10085,503,173,676
2018-07-01,13,6091,5786,2285,12126,10736,1754,93,24922,1376,7103,1660,10139,511,183,694
2018-07-01,14,6421,6017,2344,12752,11293,1817,98,26171,1373,7088,1659,10120,544,197,741
2018-07-01,15,6729,6219,2389,13458,11920,1895,103,27585,1365,6994,1653,10012,674,255,929
2018-07-01,16,6971,6440,2461,14241,12507,2013,106,29077,1353,6681,1620,9654,820,433,1253
2018-07-01,17,7092,6632,2552,14977,12981,2183,108,30457,1319,6168,1479,8966,950,861,1811
2018-07-01,18,7138,6673,2585,15529,13298,2343,107,31487,1238,5274,1257,7769,1053,1367,2420
2018-07-01,19,6981,6627,2559,15761,13363,2447,104,31883,935,3231,843,5009,1102,1945,3047
2018-07-01,20,6704,6345,2497,15510,13273,2464,98,31553,300,725,230,1255,1137,2336,3473
2018-07-01,21,6483,6184,2397,15069,13088,2519,90,30975,8,20,150,178,1146,2422,3568
2018-07-01,22,6174,5886,2353,14702,12698,2463,82,30154,0,0,0,0,1158,2388,3546
2018-07-01,23,5709,5422,2200,13548,11771,2280,74,27883,0,0,0,0,1163,2321,3484
2018-07-01,24,5271,5064,1996,12371,10892,2077,67,25619,0,0,0,0,1174,2313,3487
2018-07-02,1,4923,4867,1803,11507,10264,1907,63,23954,0,0,0,0,1163,2256,3419
2018-07-02,2,4609,4726,1717,10857,9807,1818,60,22754,0,0,0,0,1146,2147,3293
2018-07-02,3,4387,4645,1669,10460,9508,1778,57,22016,0,0,0,0,1121,2032,3153
2018-07-02,4,4213,4672,1652,10304,9434,1765,56,21772,0,0,0,0,1098,1860,2958
2018-07-02,5,4163,4818,1702,10459,9657,1816,56,22199,0,0,0,0,1044,1691,2735
2018-07-02,6,4137,5011,1834,10925,10169,1915,58,23279,2,30,1,33,978,1468,2446
2018-07-02,7,4211,5326,2034,11500,10524,2019,60,24314,278,1239,190,1707,906,1247,2153
2018-07-02,8,4502,5685,2233,12159,11173,2133,67,25742,956,3959,782,5697,823,1026,1849
2018-07-02,9,4870,5985,2335,12578,11640,2181,74,26684,1245,5755,1250,8250,735,783,1518
2018-07-02,10,5267,6271,2413,12760,11963,2169,80,27183,1323,6443,1479,9245,613,574,1187
2018-07-02,11,5684,6518,2477,12938,12320,2133,87,27689,1352,6853,1629,9834,476,459,935
2018-07-02,12,6095,6758,2508,13181,12709,2113,94,28308,1366,7060,1656,10082,419,533,952
2018-07-02,13,6490,7005,2552,13472,13104,2129,100,29015,1374,7117,1660,10151,434,669,1103
2018-07-02,14,6838,7223,2585,13975,13549,2184,104,30021,1369,7106,1657,10132,484,907,1391
2018-07-02,15,7162,7361,2589,14585,14111,2257,105,31267,1362,7015,1654,10031,620,1340,1960
2018-07-02,16,7391,7495,2601,15178,14671,2372,107,32536,1350,6710,1617,9677,772,1791,2563
2018-07-02,17,7470,7581,2611,15777,15113,2478,108,33684,1317,6192,1482,8991,908,2270,3178
2018-07-02,18,7445,7565,2606,16204,15222,2573,107,34315,1236,5292,1259,7787,985,2440,3425
2018-07-02,19,7315,7435,2592,16339,15030,2599,103,34280,935,3219,840,4994,1020,2524,3544
2018-07-02,20,6997,7083,2540,16020,14478,2579,97,33384,299,721,218,1238,1050,2516,3566
2018-07-02,21,6748,6864,2448,15556,14267,2632,89,32754,8,20,130,158,1065,2549,3614
2018-07-02,22,6369,6436,2407,15098,13785,2560,82,31733,0,0,0,0,1092,2496,3588
2018-07-02,23,5882,5894,2269,13785,12656,2343,74,29069,0,0,0,0,1102,2421,3523
2018-07-02,24,5397,5452,2076,12568,11697,2137,67,26681,0,0,0,0,1082,2365,3447
2018-07-03,1,4930,5059,1893,11742,11002,2059,64,25078,0,0,0,0,1096,2472,3568
2018-07-03,2,4606,4867,1808,11103,10346,1959,61,23681,0,0,0,0,1061,2355,3416
2018-07-03,3,4375,4757,1763,10703,9952,1901,58,22826,0,0,0,0,986,2267,3253
2018-07-03,4,4214,4753,1754,10505,9746,1877,56,22396,0,0,0,0,893,2166,3059
2018-07-03,5,4161,4878,1811,10608,9859,1910,56,22645,0,0,0,0,808,2068,2876
2018-07-03,6,4147,5061,1976,11043,10319,2017,57,23648,2,27,1,30,747,1921,2668
2018-07-03,7,4185,5342,2200,11601,10793,2174,59,24840,268,1220,187,1675,651,1746,2397
2018-07-03,8,4464,5683,2352,12200,11404,2258,66,26139,942,3953,785,5680,580,1579,2159
2018-07-03,9,4817,5959,2386,12555,11953,2266,73,27058,1245,5762,1253,8260,508,1475,1983
2018-07-03,10,5185,6221,2442,12689,12338,2229,80,27549,1323,6442,1484,9249,409,1358,1767
2018-07-03,11,5577,6441,2473,12844,12842,2199,87,28186,1352,6860,1630,9842,291,1267,1558
2018-07-03,12,5953,6632,2497,13029,13283,2189,95,28809,1366,7070,1659,10095,250,1316,1566
2018-07-03,13,6314,6838,2528,13305,13699,2195,102,29513,1371,7106,1662,10139,245,1466,1711
2018-07-03,14,6617,7029,2550,13888,14258,2238,106,30701,1369,7090,1658,10117,287,1616,1903
2018-07-03,15,6934,7142,2555,14461,14778,2306,110,31864,1360,6999,1656,10015,430,1754,2184
2018-07-03,16,7164,7259,2576,15086,15318,2398,113,33123,1347,6693,1627,9667,615,1860,2475
2018-07-03,17,7204,7330,2613,15720,15712,2503,113,34257,1310,6175,1485,8970,792,1991,2783
2018-07-03,18,7175,7330,2671,16189,15796,2628,113,34937,1221,5277,1264,7762,895,2015,2910
2018-07-03,19,7075,7130,2656,16327,15558,2734,109,34938,918,3194,847,4959,922,2042,2964
2018-07-03,20,6792,6835,2604,16086,15001,2758,102,34157,295,707,217,1219,938,1992,2930
2018-07-03,21,6580,6640,2515,15603,14794,2817,94,33518,6,43,131,180,997,1949,2946
2018-07-03,22,6240,6257,2456,15088,14242,2657,87,32284,0,0,0,0,1072,1889,2961
2018-07-03,23,5754,5747,2272,13819,13029,2438,78,29576,0,0,0,0,1130,1775,2905
2018-07-03,24,5275,5329,2061,12580,11909,2219,70,26989,0,0,0,0,1150,1659,2809
2018-07-04,1,4850,4991,1902,11211,10750,2089,64,24327,0,0,0,0,1104,1336,2440
2018-07-04,2,4516,4807,1807,10623,10064,1975,60,22935,0,0,0,0,1081,1226,2307
2018-07-04,3,4275,4682,1736,10209,9594,1908,57,21982,0,0,0,0,1030,1126,2156
2018-07-04,4,4112,4645,1704,9987,9300,1864,55,21419,0,0,0,0,957,1020,1977
2018-07-04,5,4032,4688,1715,9913,9257,1868,55,21307,0,0,0,0,883,916,1799
2018-07-04,6,3903,4733,1755,9999,9252,1903,55,21423,2,25,1,28,795,779,1574
2018-07-04,7,3864,4918,1820,10079,9176,1934,56,21456,261,1181,181,1623,699,640,1339
2018-07-04,8,4105,5149,1951,10407,9364,1978,61,22021,943,3886,773,5602,617,492,1109
2018-07-04,9,4434,5371,2128,10759,9790,2019,67,22847,1247,5730,1252,8229,558,422,980
2018-07-04,10,4839,5642,2253,11174,10298,2032,73,23788,1323,6421,1472,9216,503,400,903
2018-07-04,11,5252,5892,2313,11570,10884,2041,79,24786,1353,6836,1623,9812,436,436,872
2018-07-04,12,5638,6159,2350,11893,11494,2076,86,25760,1366,7051,1659,10076,439,589,1028
2018-07-04,13,6018,6370,2425,12176,12180,2111,91,26770,1369,7092,1660,10121,489,766,1255
2018-07-04,14,6390,6579,2494,12651,12934,2163,94,28055,1366,7078,1658,10102,581,911,1492
2018-07-04,15,6692,6784,2568,13137,13628,2240,97,29314,1359,6986,1655,10000,727,1012,1739
2018-07-04,16,6951,6980,2638,13628,14249,2346,101,30535,1346,6685,1623,9654,834,1115,1949
2018-07-04,17,7167,7073,2710,14089,14598,2470,103,31470,1311,6153,1481,8945,939,1195,2134
2018-07-04,18,7169,7056,2723,14467,14763,2597,101,32139,1220,5254,1261,7735,1002,1182,2184
2018-07-04,19,7016,6904,2721,14587,14499,2657,98,32052,917,3180,844,4941,1035,1167,2202
2018-07-04,20,6674,6592,2649,14321,13917,2666,92,31206,296,706,214,1216,1041,1097,2138
2018-07-04,21,6376,6309,2512,13954,13575,2690,84,30513,6,38,8,52,1004,1056,2060
2018-07-04,22,5969,5981,2383,13511,13094,2572,77,29463,0,0,0,0,963,1031,1994
2018-07-04,23,5569,5713,2208,12836,12519,2455,72,28093,0,0,0,0,915,1037,1952
2018-07-04,24,5199,5376,2087,12008,11710,2261,65,26257,0,0,0,0,862,971,1833
2018-07-05,1,4629,5459,1963,11304,11205,2115,60,24895,0,0,0,0,1021,919,1940
2018-07-05,2,4309,5276,1874,10828,10618,2008,57,23722,0,0,0,0,970,845,1815
2018-07-05,3,4103,5152,1813,10463,10198,1945,54,22871,0,0,0,0,910,758,1668
2018-07-05,4,3950,5124,1785,10304,9982,1904,53,22455,0,0,0,0,866,701,1567
2018-07-05,5,3915,5239,1816,10412,10090,1920,53,22687,0,0,0,0,816,627,1443
2018-07-05,6,3903,5399,1934,10829,10499,2020,54,23614,2,25,1,28,742,501,1243
2018-07-05,7,3957,5704,2128,11357,11052,2131,56,24813,259,1160,177,1596,636,391,1027
2018-07-05,8,4259,6129,2316,11942,11666,2254,62,26142,936,3828,767,5531,542,271,813
2018-07-05,9,4618,6512,2403,12173,12107,2310,69,26871,1239,5670,1229,8138,422,160,582
2018-07-05,10,5007,6892,2476,12200,12525,2342,75,27356,1316,6346,1453,9115,293,122,415
2018-07-05,11,5392,7243,2545,12243,13130,2394,82,28061,1347,6763,1596,9706,205,113,318
2018-07-05,12,5756,7555,2604,12330,13936,2445,88,29012,1358,6973,1618,9949,182,125,307
2018-07-05,13,6106,7866,2694,12457,14818,2514,94,30096,1286,6959,1571,9816,178,174,352
2018-07-05,14,6425,8144,2784,12917,15710,2633,98,31569,1277,6920,1549,9746,170,258,428
2018-07-05,15,6763,8345,2844,13390,16625,2776,102,33103,1261,6808,1534,9603,203,475,678
2018-07-05,16,7019,8502,2900,14000,17481,2925,104,34721,1166,6376,1475,9017,267,833,1100
2018-07-05,17,7083,8514,2964,14669,17944,3051,105,35978,1109,5785,1336,8230,356,1254,1610
2018-07-05,18,7085,8480,2951,15130,18035,3134,105,36613,1024,4880,1090,6994,452,1551,2003
2018-07-05,19,6973,8179,2929,15336,17490,3088,101,36224,683,2802,657,4142,543,1776,2319
2018-07-05,20,6669,7804,2854,15234,16336,3007,96,34883,183,608,166,957,638,1958,2596
2018-07-05,21,6453,7547,2721,14922,16036,3042,89,34297,3,17,3,23,708,2049,2757
2018-07-05,22,6109,7115,2627,14644,15216,2926,81,33076,0,0,0,0,766,2038,2804
2018-07-05,23,5627,6543,2401,13509,13898,2657,73,30346,0,0,0,0,798,2007,2805
2018-07-05,24,5166,6044,2160,12400,12693,2406,66,27775,0,0,0,0,771,1972,2743
2018-07-06,1,4887,5353,1991,11739,12809,2546,62,27376,0,0,0,0,736,1812,2548
2018-07-06,2,4571,5155,1878,11102,11971,2400,58,25751,0,0,0,0,706,1731,2437
2018-07-06,3,4351,5034,1803,10706,11327,2298,55,24605,0,0,0,0,694,1671,2365
2018-07-06,4,4196,5004,1770,10527,10986,2233,54,24018,0,0,0,0,676,1596,2272
2018-07-06,5,4142,5099,1798,10622,10962,2247,54,24103,0,0,0,0,649,1524,2173
2018-07-06,6,4105,5256,1893,10997,11283,2362,55,24915,1,20,1,22,626,1343,1969
2018-07-06,7,4185,5548,2064,11788,11718,2501,58,26283,200,969,180,1349,592,1097,1689
2018-07-06,8,4531,5946,2257,12504,12699,2686,63,28170,812,3404,773,4989,562,827,1389
2018-07-06,9,4950,6300,2364,12795,13759,2848,70,29692,1110,5242,1232,7584,447,544,991
2018-07-06,10,5397,6631,2457,12962,15107,2998,77,31363,1220,5994,1455,8669,326,386,712
2018-07-06,11,5859,6929,2535,13258,16632,3206,85,33401,1263,6404,1613,9280,243,341,584
2018-07-06,12,6299,7192,2589,13590,18244,3399,93,35545,1256,6632,1646,9534,246,334,580
2018-07-06,13,6718,7470,2659,13942,19895,3594,101,37752,1260,6642,1639,9541,273,349,622
2018-07-06,14,7105,7704,2728,14618,21445,3812,107,40202,1264,6548,1636,9448,317,371,688
2018-07-06,15,7498,7873,2762,15313,22725,4015,113,42384,1232,6413,1614,9259,389,577,966
2018-07-06,16,7828,7984,2817,15966,23752,4231,117,44284,1182,6094,1543,8819,481,1100,1581
2018-07-06,17,7952,8027,2816,16610,24174,4350,120,45470,1115,5521,1393,8029,585,1711,2296
2018-07-06,18,7904,8014,2781,16931,24060,4335,120,45663,996,4509,1150,6655,647,2018,2665
2018-07-06,19,7756,7759,2717,16861,23093,4168,116,44455,691,2536,709,3936,672,2189,2861
2018-07-06,20,7406,7357,2600,16419,21852,4030,109,42626,195,489,173,857,714,2237,2951
2018-07-06,21,7122,7108,2475,16118,20997,3973,99,41403,3,9,5,17,741,2262,3003
2018-07-06,22,6713,6740,2434,15500,19851,3770,90,39427,0,0,0,0,769,2245,3014
2018-07-06,23,6232,6212,2289,14309,18066,3446,80,36120,0,0,0,0,803,2160,2963
2018-07-06,24,5772,5764,2093,13104,16164,3097,72,32656,0,0,0,0,809,2052,2861
2018-07-07,1,5378,5516,1944,12468,15420,2773,69,30948,0,0,0,0,751,1906,2657
2018-07-07,2,5040,5282,1836,11706,14345,2591,64,28924,0,0,0,0,748,1768,2516
2018-07-07,3,4797,5136,1763,11188,13517,2476,61,27460,0,0,0,0,687,1606,2293
2018-07-07,4,4597,5064,1718,10889,12866,2394,59,26426,0,0,0,0,647,1430,2077
2018-07-07,5,4462,5058,1704,10762,12542,2361,58,25941,0,0,0,0,601,1217,1818
2018-07-07,6,4349,5065,1723,10825,12496,2392,59,25988,1,19,0,20,548,984,1532
2018-07-07,7,4296,5232,1769,10919,12460,2399,60,26054,221,860,159,1240,493,711,1204
2018-07-07,8,4566,5619,1917,11324,12792,2502,65,26900,865,3059,727,4651,418,482,900
2018-07-07,9,5016,6042,2067,11705,13836,2673,73,28505,1180,4803,1181,7164,350,270,620
2018-07-07,10,5510,6418,2170,12158,15184,2880,81,30521,1276,5663,1405,8344,287,164,451
2018-07-07,11,5970,6764,2236,12643,16699,3116,90,32766,1317,6174,1574,9065,243,157,400
2018-07-07,12,6373,7051,2301,13096,18043,3361,99,34817,1297,6392,1613,9302,260,173,433
2018-07-07,13,6735,7285,2346,13498,19349,3590,108,36763,1295,6348,1608,9251,309,203,512
2018-07-07,14,7071,7476,2387,13988,20635,3795,115,38753,1286,6286,1600,9172,400,279,679
2018-07-07,15,7361,7632,2422,14452,21553,3918,121,40260,1273,6194,1592,9059,475,424,899
2018-07-07,16,7587,7776,2483,15132,22199,4021,125,41694,1246,5846,1525,8617,577,812,1389
2018-07-07,17,7647,7849,2542,15927,22467,4180,125,42916,1215,5216,1377,7808,686,1427,2113
2018-07-07,18,7618,7818,2612,16430,22098,4223,125,43093,1106,4283,1124,6513,762,1781,2543
2018-07-07,19,7450,7664,2563,16619,21297,4197,121,42452,780,2417,678,3875,821,1933,2754
2018-07-07,20,7121,7265,2495,16330,20390,4148,113,41199,221,478,170,869,865,2010,2875
2018-07-07,21,6882,7042,2390,15810,19955,4102,104,40188,4,10,7,21,910,2083,2993
2018-07-07,22,6541,6673,2348,15301,18971,3922,95,38505,0,0,0,0,940,2130,3070
2018-07-07,23,6123,6186,2191,14190,17635,3683,85,35810,0,0,0,0,967,2121,3088
2018-07-07,24,5717,5735,2012,13007,16243,3433,78,32979,0,0,0,0,971,2141,3112
2018-07-08,1,5477,5497,1939,11953,13952,2626,71,28813,0,0,0,0,964,2046,3010
2018-07-08,2,5142,5264,1846,11260,12873,2441,67,26851,0,0,0,0,969,1997,2966
2018-07-08,3,4874,5121,1779,10759,12089,2328,63,25450,0,0,0,0,968,1922,2890
2018-07-08,4,4687,5038,1743,10449,11596,2269,61,24584,0,0,0,0,949,1827,2776
2018-07-08,5,4542,5007,1728,10318,11296,2243,60,24128,0,0,0,0,916,1708,2624
2018-07-08,6,4400,4966,1722,10316,11133,2254,60,23973,1,14,0,15,860,1483,2343
2018-07-08,7,4320,5096,1738,10229,10812,2226,61,23538,209,811,150,1170,820,1268,2088
2018-07-08,8,4565,5495,1866,10333,11132,2302,66,24043,851,2947,718,4516,735,1010,1745
2018-07-08,9,4991,5886,2026,10628,12024,2412,74,25355,1169,4663,1173,7005,639,734,1373
2018-07-08,10,5501,6257,2138,10919,13352,2552,84,27123,1269,5547,1397,8213,536,484,1020
2018-07-08,11,5989,6594,2240,11212,14878,2752,94,29149,1307,6017,1557,8881,442,389,831
2018-07-08,12,6445,6945,2333,11626,16547,2947,103,31433,1295,6330,1600,9225,463,484,947
2018-07-08,13,6878,7233,2417,12189,18202,3116,111,33827,1298,6338,1599,9235,499,648,1147
2018-07-08,14,7253,7511,2495,12876,19599,3274,117,36078,1294,6214,1596,9104,579,915,1494
2018-07-08,15,7581,7735,2564,13646,20713,3428,122,38118,1280,6109,1586,8975,685,1498,2183
2018-07-08,16,7805,7910,2653,14492,21582,3579,124,39987,1255,5751,1532,8538,800,2058,2858
2018-07-08,17,7873,7993,2743,15378,21834,3709,126,41255,1221,5213,1374,7808,885,2555,3440
2018-07-08,18,7803,7991,2831,16091,21551,3754,124,41729,1129,4286,1125,6540,953,2683,3636
2018-07-08,19,7619,7838,2814,16473,20822,3699,120,41322,787,2393,685,3865,1011,2705,3716
2018-07-08,20,7296,7440,2747,16330,19726,3545,113,39921,209,424,160,793,1040,2700,3740
2018-07-08,21,7052,7235,2628,15902,19025,3529,104,38769,3,8,8,19,1070,2750,3820
2018-07-08,22,6709,6844,2552,15238,18079,3363,95,36982,0,0,0,0,1072,2790,3862
2018-07-08,23,6245,6310,2345,13931,16507,3049,86,33783,0,0,0,0,1053,2757,3810
2018-07-08,24,5793,5858,2119,12637,14834,2740,78,30500,0,0,0,0,1049,2691,3740
2018-07-09,1,5397,5540,1980,11748,12995,2460,69,27482,0,0,0,0,1011,2727,3738
2018-07-09,2,5079,5330,1877,11125,12078,2345,65,25822,0,0,0,0,1010,2650,3660
2018-07-09,3,4831,5202,1818,10767,11602,2270,62,24911,0,0,0,0,979,2509,3488
2018-07-09,4,4654,5181,1799,10578,11316,2239,60,24404,0,0,0,0,925,2310,3235
2018-07-09,5,4597,5287,1845,10698,11401,2277,60,24646,0,0,0,0,888,2159,3047
2018-07-09,6,4565,5451,1959,11157,11879,2410,62,25719,1,9,0,10,808,1973,2781
2018-07-09,7,4598,5786,2150,11730,12415,2570,64,26988,202,667,137,1006,723,1757,2480
2018-07-09,8,4887,6233,2369,12407,13178,2698,72,28564,851,2541,667,4059,649,1457,2106
2018-07-09,9,5271,6676,2488,12882,14172,2802,80,30147,1183,4123,1134,6440,593,1193,1786
2018-07-09,10,5703,7087,2598,13210,15277,2867,89,31653,1282,4989,1376,7647,522,965,1487
2018-07-09,11,6137,7445,2698,13594,16451,2992,98,33346,1320,5403,1536,8259,438,800,1238
2018-07-09,12,6553,7764,2784,14007,17563,3082,106,34969,1301,5605,1573,8479,413,914,1327
2018-07-09,13,6955,8057,2889,14460,18657,3199,113,36640,1287,5724,1562,8573,439,1121,1560
2018-07-09,14,7286,8286,2993,15209,19781,3310,117,38628,1281,5690,1559,8530,516,1465,1981
2018-07-09,15,7557,8449,3055,15911,20740,3415,118,40394,1266,5599,1539,8404,657,1843,2500
2018-07-09,16,7694,8574,3115,16638,21453,3549,120,41970,1245,5404,1479,8128,794,2165,2959
2018-07-09,17,7676,8527,3182,17281,21672,3664,120,42948,1211,4792,1315,7318,920,2435,3355
2018-07-09,18,7606,8417,3170,17615,21360,3736,118,43041,1113,3917,1066,6096,984,2533,3517
2018-07-09,19,7493,8178,3111,17649,20666,3677,114,42318,769,2036,629,3434,1028,2585,3613
2018-07-09,20,7173,7784,3003,17302,19618,3599,107,40838,205,334,137,676,1059,2581,3640
2018-07-09,21,6957,7549,2847,16716,19027,3482,99,39535,2,2,5,9,1125,2590,3715
2018-07-09,22,6589,7121,2746,16059,18005,3252,91,37617,0,0,0,0,1147,2601,3748
2018-07-09,23,6136,6535,2523,14697,16292,2930,82,34211,0,0,0,0,1149,2549,3698
2018-07-09,24,5672,6041,2270,13378,14626,2625,75,30913,0,0,0,0,1118,2463,3581
2018-07-10,1,5400,5705,2026,12272,13263,2457,70,28273,0,0,0,0,984,2275,3259
2018-07-10,2,5092,5471,1913,11586,12401,2329,66,26593,0,0,0,0,953,2242,3195
2018-07-10,3,4852,5330,1842,11183,11870,2245,63,25571,0,0,0,0,902,2050,2952
2018-07-10,4,4688,5297,1810,10953,11549,2208,61,24981,0,0,0,0,849,1811,2660
2018-07-10,5,4642,5388,1842,11040,11605,2243,60,25158,0,0,0,0,765,1584,2349
2018-07-10,6,4619,5551,1952,11439,12047,2369,61,26126,1,8,0,9,700,1261,1961
2018-07-10,7,4634,5871,2139,12032,12554,2514,63,27372,189,635,124,948,601,900,1501
2018-07-10,8,4900,6274,2332,12723,13326,2653,70,28981,812,2485,632,3929,504,557,1061
2018-07-10,9,5262,6679,2435,13151,14120,2758,77,30316,1151,4074,1108,6333,453,355,808
2018-07-10,10,5651,7064,2514,13459,15108,2832,86,31694,1259,5054,1367,7680,376,229,605
2018-07-10,11,6033,7408,2585,13867,16034,2932,95,33137,1304,5624,1529,8457,298,195,493
2018-07-10,12,6352,7700,2657,14316,17039,3006,103,34675,1294,5799,1571,8664,298,193,491
2018-07-10,13,6662,7997,2736,14797,18047,3101,110,36266,1289,5761,1570,8620,322,224,546
2018-07-10,14,6911,8223,2804,15515,19098,3211,115,38150,1285,5566,1560,8411,372,262,634
2018-07-10,15,7168,8370,2851,16240,19834,3321,118,39723,1268,5329,1538,8135,486,428,914
2018-07-10,16,7342,8472,2891,16960,20448,3446,119,41184,1245,5161,1477,7883,610,638,1248
2018-07-10,17,7329,8475,2940,17669,20690,3551,119,42240,1200,4644,1297,7141,740,980,1720
2018-07-10,18,7273,8356,2974,18024,20439,3608,120,42403,1099,3735,1030,5864,801,1232,2033
2018-07-10,19,7175,8170,2931,18005,19775,3551,115,41657,738,1975,560,3273,836,1406,2242
2018-07-10,20,6913,7742,2855,17606,18828,3453,109,40208,191,334,124,649,892,1528,2420
2018-07-10,21,6754,7526,2726,16958,18277,3401,102,38949,2,0,3,5,952,1512,2464
2018-07-10,22,6442,7095,2643,16283,17376,3214,94,37177,0,0,0,0,1018,1474,2492
2018-07-10,23,5988,6510,2427,14906,15838,2906,85,33944,0,0,0,0,1050,1399,2449
2018-07-10,24,5565,6018,2200,13515,14293,2612,76,30707,0,0,0,0,1070,1212,2282
2018-07-11,1,5113,5607,2066,12435,13197,2483,68,28393,0,0,0,0,1086,1050,2136
2018-07-11,2,4811,5365,1968,11701,12391,2350,64,26714,0,0,0,0,1102,947,2049
2018-07-11,3,4597,5216,1903,11263,11805,2259,61,25597,0,0,0,0,1066,790,1856
2018-07-11,4,4456,5167,1868,11027,11480,2222,59,24997,0,0,0,0,1036,667,1703
2018-07-11,5,4438,5257,1897,11114,11535,2251,58,25168,0,0,0,0,993,558,1551
2018-07-11,6,4427,5395,2011,11521,11989,2373,59,26151,1,7,0,8,909,448,1357
2018-07-11,7,4456,5697,2196,12004,12512,2555,61,27341,171,613,127,911,827,368,1195
2018-07-11,8,4722,6099,2386,12650,13316,2714,68,28956,795,2367,617,3779,718,271,989
2018-07-11,9,5086,6502,2499,13045,14110,2819,75,30258,1126,3813,1090,6029,550,188,738
2018-07-11,10,5474,6880,2577,13263,14954,2899,83,31408,1233,4798,1350,7381,398,170,568
2018-07-11,11,5847,7199,2655,13580,15916,2995,90,32789,1270,5314,1504,8088,256,173,429
2018-07-11,12,6178,7456,2737,13974,16787,3075,97,34141,1244,5498,1561,8303,178,199,377
2018-07-11,13,6485,7693,2832,14429,17692,3158,103,35590,1252,5422,1560,8234,132,225,357
2018-07-11,14,6738,7892,2925,15223,18680,3241,106,37459,1243,5298,1558,8099,132,268,400
2018-07-11,15,7014,8022,3011,15984,19363,3350,108,39014,1228,5182,1535,7945,222,355,577
2018-07-11,16,7222,8130,3083,16738,19862,3452,108,40370,1210,5134,1465,7809,338,505,843
2018-07-11,17,7243,8111,3144,17448,19969,3556,108,41290,1150,4557,1289,6996,489,749,1238
2018-07-11,18,7212,8004,3200,17797,19714,3600,108,41429,1033,3741,1034,5808,563,1045,1608
2018-07-11,19,7157,7815,3157,17850,19080,3579,104,40821,691,1956,575,3222,642,1306,1948
2018-07-11,20,6884,7388,3068,17492,18254,3519,99,39573,170,326,120,616,747,1463,2210
2018-07-11,21,6704,7200,2924,16895,17804,3443,94,38445,2,0,2,4,865,1486,2351
2018-07-11,22,6397,6834,2807,16229,16963,3239,87,36727,0,0,0,0,981,1485,2466
2018-07-11,23,5949,6296,2552,14786,15494,2928,79,33496,0,0,0,0,1058,1455,2513
2018-07-11,24,5526,5837,2303,13509,14079,2627,71,30496,0,0,0,0,1064,1372,2436
2018-07-12,1,5118,5472,2205,12630,13311,2483,68,28702,0,0,0,0,1024,1103,2127
2018-07-12,2,4841,5238,2089,11888,12519,2350,64,27031,0,0,0,0,978,986,1964
2018-07-12,3,4623,5103,2014,11439,11936,2259,61,25904,0,0,0,0,955,844,1799
2018-07-12,4,4489,5062,1980,11199,11665,2222,59,25355,0,0,0,0,938,718,1656
2018-07-12,5,4464,5167,2008,11273,11705,2251,59,25497,0,0,0,0,911,593,1504
2018-07-12,6,4451,5307,2113,11682,12137,2373,60,26463,0,7,0,7,833,433,1266
2018-07-12,7,4479,5600,2287,12254,12672,2555,61,27753,149,633,119,901,738,351,1089
2018-07-12,8,4764,5994,2494,12904,13475,2714,68,29370,711,2415,582,3708,636,241,877
2018-07-12,9,5112,6364,2616,13277,14223,2819,76,30603,995,3960,1026,5981,520,173,693
2018-07-12,10,5477,6723,2736,13541,15036,2899,84,31769,1110,4853,1285,7248,400,153,553
2018-07-12,11,5845,7024,2841,13914,15984,2995,92,33185,1160,5501,1428,8089,289,164,453
2018-07-12,12,6143,7268,2948,14380,16915,3075,99,34678,1189,5715,1495,8399,283,194,477
2018-07-12,13,6438,7514,3072,14878,17866,3158,105,36217,1208,5687,1505,8400,287,232,519
2018-07-12,14,6690,7712,3195,15567,18802,3241,109,37928,1204,5534,1493,8231,363,294,657
2018-07-12,15,6917,7861,3292,16386,19370,3350,111,39426,1173,5387,1483,8043,490,393,883
2018-07-12,16,7079,7971,3374,16909,19817,3452,111,40497,1169,5376,1418,7963,592,594,1186
2018-07-12,17,7073,7986,3432,17511,20001,3556,110,41387,1140,4728,1274,7142,688,860,1548
2018-07-12,18,7017,7919,3475,17811,19832,3600,108,41559,1022,3849,1034,5905,758,1056,1814
2018-07-12,19,6950,7707,3427,17909,19347,3579,105,41150,703,2049,606,3358,865,1148,2013
2018-07-12,20,6727,7338,3318,17591,18495,3519,101,39915,178,348,131,657,936,1213,2149
2018-07-12,21,6573,7156,3154,16940,18047,3443,95,38733,4,0,2,6,983,1383,2366
2018-07-12,22,6288,6761,3016,16279,17277,3239,89,37091,0,0,0,0,1018,1488,2506
2018-07-12,23,5880,6210,2750,14944,15818,2928,80,33980,0,0,0,0,1061,1525,2586
2018-07-12,24,5472,5753,2475,13604,14321,2627,72,30835,0,0,0,0,1065,1503,2568
2018-07-13,1,5246,5411,2285,12619,13306,2486,66,28687,0,0,0,0,1068,1527,2595
2018-07-13,2,4952,5188,2150,11891,12423,2331,62,26918,0,0,0,0,1019,1413,2432
2018-07-13,3,4718,5053,2059,11419,11836,2245,59,25770,0,0,0,0,1022,1377,2399
2018-07-13,4,4581,5021,2004,11195,11509,2185,57,25158,0,0,0,0,1029,1287,2316
2018-07-13,5,4555,5106,2012,11269,11537,2203,57,25276,0,0,0,0,1030,1222,2252
2018-07-13,6,4529,5240,2109,11654,11884,2322,58,26129,0,9,0,9,983,1076,2059
2018-07-13,7,4569,5518,2275,12212,12380,2466,60,27329,171,689,127,987,911,965,1876
2018-07-13,8,4860,5922,2482,12808,13189,2631,66,28903,786,2682,636,4104,838,786,1624
2018-07-13,9,5225,6303,2642,13222,14033,2741,72,30279,1106,4426,1115,6647,740,509,1249
2018-07-13,10,5614,6655,2778,13529,15005,2815,80,31639,1223,5205,1379,7807,653,305,958
2018-07-13,11,5981,6952,2897,13941,16039,2915,88,33193,1271,5728,1535,8534,532,215,747
2018-07-13,12,6327,7194,3015,14336,17056,3025,94,34722,1292,6038,1588,8918,460,207,667
2018-07-13,13,6649,7442,3140,14736,17994,3117,100,36157,1298,6049,1591,8938,411,265,676
2018-07-13,14,6879,7646,3268,15384,18928,3239,104,37865,1292,5842,1590,8724,439,386,825
2018-07-13,15,7073,7794,3360,16082,19682,3362,107,39442,1270,5753,1574,8597,535,691,1226
2018-07-13,16,7187,7875,3427,16737,20182,3472,109,40710,1240,5597,1507,8344,675,1152,1827
2018-07-13,17,7163,7896,3490,17364,20318,3555,108,41554,1183,5057,1336,7576,814,1702,2516
2018-07-13,18,7099,7842,3461,17699,20042,3600,109,41658,1051,4141,1078,6270,918,1966,2884
2018-07-13,19,6996,7569,3385,17696,19387,3535,105,40932,728,2294,631,3653,1007,2152,3159
2018-07-13,20,6781,7200,3244,17321,18477,3403,99,39510,190,449,135,774,1075,2204,3279
2018-07-13,21,6656,7009,3067,16730,17992,3377,93,38401,3,0,1,4,1102,2312,3414
2018-07-13,22,6403,6659,2961,16150,17230,3230,86,36905,0,0,0,0,1118,2428,3546
2018-07-13,23,6017,6163,2745,14952,15871,2966,78,34078,0,0,0,0,1129,2476,3605
2018-07-13,24,5628,5702,2485,13737,14513,2688,71,31219,0,0,0,0,1137,2472,3609
2018-07-14,1,5283,5365,2247,13067,13864,2489,69,29700,0,0,0,0,1126,2487,3613
2018-07-14,2,4996,5136,2099,12247,12899,2336,65,27758,0,0,0,0,1122,2444,3566
2018-07-14,3,4777,4985,2003,11647,12160,2236,61,26313,0,0,0,0,1115,2400,3515
2018-07-14,4,4611,4913,1941,11282,11676,2176,59,25402,0,0,0,0,1099,2346,3445
2018-07-14,5,4524,4915,1932,11153,11466,2158,58,25043,0,0,0,0,1075,2274,3349
2018-07-14,6,4413,4902,1946,11228,11390,2190,58,25075,0,11,0,11,1040,2118,3158
2018-07-14,7,4371,5045,2006,11302,11322,2195,59,25086,180,694,131,1005,1004,1943,2947
2018-07-14,8,4670,5436,2149,11563,11728,2275,65,25842,809,2737,647,4193,955,1711,2666
2018-07-14,9,5100,5828,2325,11894,12581,2369,72,27127,1132,4512,1143,6787,895,1387,2282
2018-07-14,10,5572,6198,2468,12243,13664,2463,80,28661,1243,5343,1402,7988,816,1062,1878
2018-07-14,11,6036,6503,2586,12732,14868,2557,89,30457,1292,5856,1558,8706,721,800,1521
2018-07-14,12,6447,6756,2690,13279,15985,2646,98,32218,1284,6133,1601,9018,698,827,1525
2018-07-14,13,6828,6971,2795,13860,17028,2732,105,33936,1303,6133,1600,9036,706,948,1654
2018-07-14,14,7144,7128,2882,14571,17958,2823,110,35672,1307,6011,1600,8918,722,1182,1904
2018-07-14,15,7421,7266,2955,15282,18639,2918,113,37161,1289,5876,1589,8754,850,1629,2479
2018-07-14,16,7603,7387,3025,15998,19159,3039,117,38521,1269,5618,1519,8406,963,2062,3025
2018-07-14,17,7665,7452,3094,16745,19422,3137,118,39630,1221,5036,1374,7631,1044,2446,3490
2018-07-14,18,7611,7438,3129,17150,19263,3194,118,39933,1091,4055,1102,6248,1104,2571,3675
2018-07-14,19,7443,7312,3084,17277,18782,3187,114,39568,759,2225,648,3632,1145,2600,3745
2018-07-14,20,7152,6931,2991,16951,18013,3119,106,38397,197,429,141,767,1168,2579,3747
2018-07-14,21,6951,6768,2863,16418,17556,3149,99,37431,7,0,1,8,1191,2645,3836
2018-07-14,22,6638,6434,2766,15850,16860,3044,91,36053,0,0,0,0,1207,2696,3903
2018-07-14,23,6251,5999,2564,14685,15642,2834,83,33454,0,0,0,0,1216,2705,3921
2018-07-14,24,5846,5567,2341,13473,14371,2594,76,30723,0,0,0,0,1213,2676,3889
2018-07-15,1,5416,5323,2237,12438,12672,2365,71,27756,0,0,0,0,1215,2690,3905
2018-07-15,2,5138,5105,2097,11673,11818,2222,66,25989,0,0,0,0,1216,2623,3839
2018-07-15,3,4878,4960,2000,11125,11203,2132,63,24733,0,0,0,0,1203,2546,3749
2018-07-15,4,4723,4877,1932,10845,10775,2081,61,23971,0,0,0,0,1187,2433,3620
2018-07-15,5,4593,4840,1905,10693,10520,2068,60,23551,0,0,0,0,1171,2328,3499
2018-07-15,6,4490,4783,1896,10718,10446,2083,60,23516,0,9,0,9,1152,2151,3303
2018-07-15,7,4419,4907,1933,10627,10240,2068,60,23205,175,708,139,1022,1115,1904,3019
2018-07-15,8,4643,5278,2079,10733,10574,2130,67,23712,826,2825,687,4338,1049,1588,2637
2018-07-15,9,5038,5641,2283,10935,11155,2186,74,24558,1163,4617,1171,6951,983,1163,2146
2018-07-15,10,5497,6002,2441,11167,12038,2245,84,25743,1275,5478,1423,8176,896,773,1669
2018-07-15,11,5953,6322,2567,11497,13120,2319,93,27252,1316,5944,1578,8838,779,520,1299
2018-07-15,12,6370,6657,2690,11953,14190,2384,102,28848,1331,6203,1623,9157,748,493,1241
2018-07-15,13,6765,6922,2803,12497,15259,2446,110,30521,1338,6265,1616,9219,730,561,1291
2018-07-15,14,7108,7178,2902,13167,16250,2556,115,32297,1334,6161,1615,9110,753,747,1500
2018-07-15,15,7400,7387,2992,13900,17097,2668,119,33991,1323,5988,1607,8918,862,1148,2010
2018-07-15,16,7583,7558,3087,14762,17753,2787,122,35633,1306,5718,1556,8580,970,1602,2572
2018-07-15,17,7655,7642,3152,15547,18188,2923,121,36988,1264,5096,1404,7764,1041,2036,3077
2018-07-15,18,7632,7611,3195,16174,18240,3035,120,37777,1158,4139,1154,6451,1076,2242,3318
2018-07-15,19,7443,7412,3191,16471,17884,3077,116,37756,827,2284,682,3793,1109,2363,3472
2018-07-15,20,7170,7101,3108,16287,17115,3011,109,36730,223,430,146,799,1133,2425,3558
2018-07-15,21,7002,6973,2969,15871,16779,3064,102,36023,10,0,1,11,1141,2517,3658
2018-07-15,22,6678,6612,2869,15364,16085,2947,94,34698,0,0,0,0,1155,2550,3705
2018-07-15,23,6224,6111,2628,14117,14800,2702,85,31914,0,0,0,0,1156,2560,3716
2018-07-15,24,5775,5672,2373,12868,13440,2455,77,29050,0,0,0,0,1157,2527,3684
2018-07-16,1,5290,5240,2205,12281,13080,2330,71,27973,0,0,0,0,1087,2464,3551
2018-07-16,2,5003,5057,2080,11568,12218,2210,67,26274,0,0,0,0,1084,2431,3515
2018-07-16,3,4771,4943,2003,11080,11618,2132,64,25103,0,0,0,0,1074,2359,3433
2018-07-16,4,4630,4928,1971,10837,11323,2099,62,24531,0,0,0,0,1047,2267,3314
2018-07-16,5,4601,5055,1996,10895,11297,2151,62,24615,0,0,0,0,1012,2174,3186
2018-07-16,6,4580,5227,2107,11321,11760,2276,64,25631,0,9,0,9,924,1932,2856
2018-07-16,7,4618,5549,2306,11925,12318,2410,66,26927,180,587,127,894,850,1742,2592
2018-07-16,8,4911,5956,2525,12560,13196,2558,73,28597,830,2513,656,3999,765,1456,2221
2018-07-16,9,5288,6351,2685,13026,14028,2659,82,30005,1170,4232,1132,6534,678,1205,1883
2018-07-16,10,5718,6710,2830,13328,14981,2734,91,31343,1285,5168,1393,7846,548,936,1484
2018-07-16,11,6175,7016,2965,13738,16020,2782,100,32850,1325,5692,1543,8560,413,732,1145
2018-07-16,12,6627,7280,3092,14206,17038,2829,108,34390,1341,5992,1598,8931,355,753,1108
2018-07-16,13,7083,7533,3230,14733,17971,2891,115,35919,1350,6078,1599,9027,316,849,1165
2018-07-16,14,7461,7734,3352,15526,18910,2985,120,37750,1346,6031,1598,8975,318,1009,1327
2018-07-16,15,7777,7881,3434,16312,19630,3087,122,39357,1334,5871,1591,8796,415,1456,1871
2018-07-16,16,7909,7951,3492,17038,20086,3199,123,40654,1317,5576,1532,8425,561,1875,2436
2018-07-16,17,7883,7966,3541,17778,20289,3312,122,41709,1276,5000,1382,7658,719,2258,2977
2018-07-16,18,7805,7905,3561,18267,20057,3378,120,42029,1171,3992,1137,6300,823,2385,3208
2018-07-16,19,7668,7668,3506,18370,19321,3328,115,41342,820,2141,655,3616,883,2438,3321
2018-07-16,20,7372,7356,3405,18156,18417,3236,108,40125,223,383,140,746,930,2417,3347
2018-07-16,21,7160,7188,3229,17514,18015,3244,101,39082,7,0,1,8,954,2475,3429
2018-07-16,22,6762,6755,3088,16829,17265,3095,93,37489,0,0,0,0,983,2518,3501
2018-07-16,23,6272,6204,2813,15357,15778,2810,84,34238,0,0,0,0,1004,2528,3532
2018-07-16,24,5789,5745,2527,13903,14369,2533,76,31091,0,0,0,0,1009,2488,3497
2018-07-17,1,5397,5452,2287,12603,13448,2411,72,28744,0,0,0,0,1009,2512,3521
2018-07-17,2,5081,5230,2148,11854,12521,2292,67,26943,0,0,0,0,986,2382,3368
2018-07-17,3,4834,5090,2059,11340,11862,2195,64,25672,0,0,0,0,968,2273,3241
2018-07-17,4,4651,5056,2010,11105,11487,2142,62,25006,0,0,0,0,940,2099,3039
2018-07-17,5,4600,5171,2015,11187,11462,2167,62,25089,0,0,0,0,912,1941,2853
2018-07-17,6,4576,5331,2121,11616,11864,2264,64,26018,0,10,0,10,841,1682,2523
2018-07-17,7,4610,5635,2315,12182,12365,2387,65,27209,170,548,119,837,738,1391,2129
2018-07-17,8,4902,6021,2520,12847,13228,2486,72,28844,810,2422,637,3869,625,1080,1705
2018-07-17,9,5332,6383,2661,13274,13984,2621,80,30169,1171,4240,1125,6536,538,712,1250
2018-07-17,10,5792,6734,2793,13582,14976,2685,90,31542,1281,5148,1386,7815,405,413,818
2018-07-17,11,6276,7035,2906,13973,16016,2761,99,33058,1320,5622,1539,8481,295,223,518
2018-07-17,12,6759,7290,3034,14489,16954,2831,108,34590,1335,5896,1600,8831,248,190,438
2018-07-17,13,7232,7547,3166,15110,17836,2912,116,36182,1329,5959,1584,8872,230,222,452
2018-07-17,14,7650,7757,3292,16038,18789,3024,121,38179,1323,5802,1586,8711,259,291,550
2018-07-17,15,8042,7913,3378,16912,19614,3103,124,39958,1311,5709,1572,8592,325,538,863
2018-07-17,16,8281,8019,3449,17763,20162,3266,127,41524,1276,5397,1510,8183,410,907,1317
2018-07-17,17,8273,8060,3508,18540,20273,3413,126,42558,1235,4810,1346,7391,545,1293,1838
2018-07-17,18,8194,8008,3499,19047,20079,3450,125,42907,1111,3802,1100,6013,632,1554,2186
2018-07-17,19,8079,7761,3445,19064,19499,3418,121,42308,775,2014,621,3410,698,1724,2422
2018-07-17,20,7739,7432,3323,18669,18574,3308,114,40872,194,339,130,663,758,1846,2604
2018-07-17,21,7462,7232,3154,17941,18130,3306,106,39690,7,0,1,8,845,1859,2704
2018-07-17,22,7033,6795,3017,17104,17209,3164,97,37781,0,0,0,0,917,1863,2780
2018-07-17,23,6500,6227,2759,15540,15704,2887,87,34427,0,0,0,0,969,1819,2788
2018-07-17,24,5990,5762,2481,14106,14211,2604,78,31209,0,0,0,0,966,1751,2717
2018-07-18,1,5660,5401,2229,12739,13559,2411,72,28990,0,0,0,0,943,1664,2607
2018-07-18,2,5319,5189,2085,11971,12643,2292,68,27184,0,0,0,0,906,1489,2395
2018-07-18,3,5061,5062,1989,11472,12040,2195,65,25982,0,0,0,0,868,1343,2211
2018-07-18,4,4873,5032,1931,11237,11689,2142,63,25340,0,0,0,0,823,1199,2022
2018-07-18,5,4817,5143,1945,11321,11650,2167,63,25411,0,0,0,0,772,1048,1820
2018-07-18,6,4800,5294,2060,11747,12053,2264,65,26338,0,7,0,7,694,754,1448
2018-07-18,7,4796,5592,2244,12299,12585,2387,66,27546,138,467,101,706,603,509,1112
2018-07-18,8,5059,5976,2435,12940,13411,2486,73,29120,688,2061,559,3308,516,301,817
2018-07-18,9,5475,6343,2578,13441,14243,2621,81,30596,1039,3549,1022,5610,375,180,555
2018-07-18,10,5929,6687,2701,13759,15248,2685,90,31991,1162,4650,1273,7085,259,154,413
2018-07-18,11,6398,6990,2816,14173,16342,2761,99,33584,1218,5326,1419,7963,160,172,332
2018-07-18,12,6843,7246,2918,14720,17260,2831,107,35126,1236,5755,1484,8475,134,195,329
2018-07-18,13,7280,7517,3025,15320,18174,2912,114,36729,1245,5846,1483,8574,136,222,358
2018-07-18,14,7654,7737,3127,16256,19150,3024,119,38756,1243,5718,1486,8447,175,241,416
2018-07-18,15,8021,7920,3205,17140,20024,3103,122,40597,1201,5552,1439,8192,293,307,600
2018-07-18,16,8220,8055,3268,17986,20310,3266,122,41894,1154,5326,1334,7814,442,428,870
2018-07-18,17,8184,8107,3300,18763,20425,3413,121,42931,1116,4680,1186,6982,618,615,1233
2018-07-18,18,8131,8011,3313,19233,20017,3450,120,43030,942,3713,947,5602,734,895,1629
2018-07-18,19,8018,7798,3277,19208,19333,3418,116,42284,620,1959,501,3080,800,1138,1938
2018-07-18,20,7701,7464,3172,18758,18452,3308,109,40837,149,320,102,571,860,1406,2266
2018-07-18,21,7460,7236,3027,18057,18047,3306,103,39722,5,0,1,6,908,1389,2297
2018-07-18,22,7056,6797,2905,17233,17268,3164,95,37968,0,0,0,0,936,1306,2242
2018-07-18,23,6529,6221,2660,15661,15901,2887,85,34744,0,0,0,0,946,1188,2134
2018-07-18,24,6037,5761,2392,14148,14475,2604,77,31515,0,0,0,0,951,1093,2044
2018-07-19,1,5666,5355,2126,12793,13125,2388,73,28588,0,0,0,0,1019,693,1712
2018-07-19,2,5327,5141,1990,11996,12287,2258,68,26818,0,0,0,0,987,600,1587
2018-07-19,3,5060,5018,1898,11515,11733,2170,66,25692,0,0,0,0,966,432,1398
2018-07-19,4,4877,4992,1859,11263,11400,2126,64,25062,0,0,0,0,926,345,1271
2018-07-19,5,4826,5110,1888,11320,11411,2154,63,25157,0,0,0,0,870,278,1148
2018-07-19,6,4805,5279,1999,11741,11886,2272,65,26173,0,8,0,8,820,211,1031
2018-07-19,7,4802,5555,2168,12331,12426,2408,66,27439,126,511,94,731,744,168,912
2018-07-19,8,5065,5940,2366,12999,13206,2563,73,29049,666,2418,548,3632,625,155,780
2018-07-19,9,5482,6296,2489,13434,14020,2683,82,30427,1029,4289,1032,6350,524,151,675
2018-07-19,10,5916,6627,2603,13799,14834,2766,91,31699,1155,5396,1304,7855,419,141,560
2018-07-19,11,6374,6917,2704,14203,15773,2847,100,33132,1197,6001,1462,8660,330,140,470
2018-07-19,12,6806,7164,2783,14695,16628,2914,108,34556,1216,6349,1535,9100,334,174,508
2018-07-19,13,7212,7428,2880,15231,17565,2989,115,36111,1246,6410,1547,9203,356,204,560
2018-07-19,14,7576,7638,2974,16080,18589,3080,120,38081,1250,6345,1559,9154,397,238,635
2018-07-19,15,7918,7795,3041,16876,19418,3190,122,39817,1241,6167,1532,8940,531,258,789
2018-07-19,16,8126,7916,3096,17671,19991,3296,123,41290,1222,5932,1456,8610,691,371,1062
2018-07-19,17,8126,7953,3155,18298,20264,3398,122,42291,1173,5281,1298,7752,870,602,1472
2018-07-19,18,8045,7917,3143,18721,20114,3451,121,42616,1043,4119,1052,6214,1013,813,1826
2018-07-19,19,7930,7659,3098,18697,19477,3390,116,41889,721,2184,602,3507,1055,1110,2165
2018-07-19,20,7620,7343,2991,18305,18539,3293,109,40456,180,358,121,659,1094,1393,2487
2018-07-19,21,7384,7113,2859,17643,17975,3309,103,39240,5,0,1,6,1145,1377,2522
2018-07-19,22,7001,6675,2754,16855,17192,3163,95,37514,0,0,0,0,1173,1316,2489
2018-07-19,23,6480,6130,2521,15431,15784,2882,85,34393,0,0,0,0,1188,1249,2437
2018-07-19,24,5993,5683,2269,14013,14354,2605,77,31259,0,0,0,0,1166,1193,2359
2018-07-20,1,5551,5421,2057,12810,12899,2394,71,28385,0,0,0,0,1059,1155,2214
2018-07-20,2,5211,5200,1933,12011,12098,2259,66,26647,0,0,0,0,1003,1095,2098
2018-07-20,3,4965,5069,1853,11517,11562,2171,64,25522,0,0,0,0,948,934,1882
2018-07-20,4,4783,5040,1815,11271,11269,2125,62,24935,0,0,0,0,899,789,1688
2018-07-20,5,4725,5138,1837,11336,11344,2157,61,25107,0,0,0,0,832,657,1489
2018-07-20,6,4691,5293,1931,11761,11753,2275,62,26060,0,9,0,9,738,515,1253
2018-07-20,7,4717,5572,2087,12350,12237,2396,63,27256,132,518,97,747,645,375,1020
2018-07-20,8,4982,5976,2276,12950,12936,2534,69,28699,726,2399,553,3678,537,279,816
2018-07-20,9,5363,6355,2413,13411,13612,2635,77,29943,1100,4301,1055,6456,463,177,640
2018-07-20,10,5779,6705,2508,13724,14371,2676,85,31063,1219,5374,1321,7914,407,152,559
2018-07-20,11,6204,7019,2599,14100,15249,2730,94,32381,1266,5924,1481,8671,334,168,502
2018-07-20,12,6627,7286,2664,14519,16080,2781,101,33693,1280,6271,1539,9090,359,211,570
2018-07-20,13,7012,7558,2736,14912,16777,2831,108,34839,1290,6362,1542,9194,430,277,707
2018-07-20,14,7346,7782,2800,15636,17625,2901,112,36486,1286,6248,1532,9066,544,357,901
2018-07-20,15,7628,7957,2857,16363,18254,3006,115,37950,1269,6074,1501,8844,649,466,1115
2018-07-20,16,7798,8048,2906,17090,18604,3088,117,39111,1248,5825,1411,8484,753,693,1446
2018-07-20,17,7790,8057,2951,17634,18724,3175,117,39861,1214,5185,1259,7658,872,957,1829
2018-07-20,18,7689,7970,2954,18031,18567,3235,116,40159,1110,4057,1024,6191,920,1103,2023
2018-07-20,19,7547,7787,2875,18044,18113,3205,112,39684,815,2111,597,3523,953,1275,2228
2018-07-20,20,7275,7349,2768,17691,17338,3126,106,38470,219,360,125,704,972,1448,2420
2018-07-20,21,7087,7136,2654,17052,16915,3143,99,37419,7,0,1,8,1019,1553,2572
2018-07-20,22,6760,6772,2583,16425,16205,3025,92,35957,0,0,0,0,1062,1702,2764
2018-07-20,23,6318,6267,2395,15215,14966,2804,83,33279,0,0,0,0,1096,1775,2871
2018-07-20,24,5853,5823,2176,13950,13761,2565,75,30563,0,0,0,0,1093,1760,2853
2018-07-21,1,5412,5508,1976,12885,13112,2399,68,28673,0,0,0,0,1005,1555,2560
2018-07-21,2,5104,5279,1864,12100,12249,2259,65,26880,0,0,0,0,946,1477,2423
2018-07-21,3,4877,5127,1788,11514,11694,2166,62,25644,0,0,0,0,870,1421,2291
2018-07-21,4,4699,5047,1744,11149,11278,2115,60,24810,0,0,0,0,801,1369,2170
2018-07-21,5,4595,5040,1732,11040,11122,2104,59,24533,0,0,0,0,731,1332,2063
2018-07-21,6,4495,5068,1755,11127,11162,2138,59,24694,0,9,0,9,670,1168,1838
2018-07-21,7,4440,5237,1798,11281,11008,2149,60,24706,135,512,101,748,641,982,1623
2018-07-21,8,4680,5606,1932,11576,11276,2210,65,25337,760,2385,566,3711,597,807,1404
2018-07-21,9,5091,6013,2099,11922,11892,2299,72,26395,1149,4221,1065,6435,566,618,1184
2018-07-21,10,5567,6401,2213,12271,12688,2371,81,27620,1258,5171,1305,7734,533,466,999
2018-07-21,11,6028,6739,2287,12748,13581,2431,90,29058,1297,5617,1468,8382,496,417,913
2018-07-21,12,6446,7031,2365,13289,14330,2494,98,30420,1309,5939,1538,8786,514,451,965
2018-07-21,13,6799,7276,2426,13787,15194,2552,104,31846,1302,5985,1542,8829,544,534,1078
2018-07-21,14,7095,7479,2476,14444,15891,2619,109,33272,1295,5935,1535,8765,597,687,1284
2018-07-21,15,7341,7654,2537,15070,16633,2709,111,34731,1283,5761,1512,8556,691,886,1577
2018-07-21,16,7480,7811,2608,15768,17123,2820,114,36035,1262,5511,1437,8210,792,1087,1879
2018-07-21,17,7525,7891,2680,16314,17412,2927,115,36977,1225,4888,1281,7394,905,1326,2231
2018-07-21,18,7438,7834,2741,16716,17387,3023,113,37449,1117,3876,1064,6057,1002,1473,2475
2018-07-21,19,7261,7665,2689,16856,16941,3082,109,37197,789,2059,623,3471,1022,1675,2697
2018-07-21,20,6993,7296,2615,16602,16157,3038,102,36107,206,337,135,678,1044,1815,2859
2018-07-21,21,6800,7076,2509,16180,15904,3038,96,35429,6,0,0,6,1061,1923,2984
2018-07-21,22,6486,6706,2436,15652,15225,2932,89,34107,0,0,0,0,1081,2068,3149
2018-07-21,23,6094,6213,2254,14530,14085,2726,81,31631,0,0,0,0,1105,2102,3207
2018-07-21,24,5669,5761,2060,13401,13097,2502,74,29283,0,0,0,0,1090,2149,3239
2018-07-22,1,5271,5287,1946,12507,12386,2377,69,27548,0,0,0,0,1093,1885,2978
2018-07-22,2,4974,5063,1849,11824,11747,2235,65,26081,0,0,0,0,1073,1855,2928
2018-07-22,3,4725,4930,1775,11280,11154,2140,62,24846,0,0,0,0,1016,1803,2819
2018-07-22,4,4553,4863,1738,10949,10738,2087,60,24043,0,0,0,0,965,1732,2697
2018-07-22,5,4435,4835,1722,10807,10521,2071,59,23667,0,0,0,0,926,1626,2552
2018-07-22,6,4340,4809,1726,10818,10459,2084,59,23627,0,11,0,11,894,1425,2319
2018-07-22,7,4240,4915,1740,10785,10219,2064,60,23336,123,563,101,787,858,1269,2127
2018-07-22,8,4467,5263,1863,10908,10536,2108,65,23827,735,2635,609,3979,816,1100,1916
2018-07-22,9,4873,5596,2028,11127,11083,2167,73,24658,1125,4731,1118,6974,741,901,1642
2018-07-22,10,5357,5919,2146,11408,11892,2244,82,25832,1240,5776,1364,8380,638,680,1318
2018-07-22,11,5827,6208,2261,11780,12821,2344,91,27243,1283,6294,1522,9099,514,562,1076
2018-07-22,12,6276,6510,2363,12232,13897,2449,99,28886,1297,6600,1586,9483,466,618,1084
2018-07-22,13,6692,6743,2454,12779,14921,2562,106,30577,1298,6609,1583,9490,460,741,1201
2018-07-22,14,7071,6962,2540,13523,16063,2686,111,32593,1292,6502,1578,9372,492,873,1365
2018-07-22,15,7390,7138,2623,14258,16981,2835,114,34396,1281,6344,1565,9190,611,1256,1867
2018-07-22,16,7625,7276,2717,15083,17780,2987,117,36174,1261,6104,1505,8870,738,1653,2391
2018-07-22,17,7696,7306,2815,15890,18175,3145,116,37534,1226,5567,1359,8152,860,2049,2909
2018-07-22,18,7678,7242,2906,16464,18299,3250,116,38338,1119,4457,1117,6693,921,2229,3150
2018-07-22,19,7484,7113,2889,16697,17975,3252,112,38245,793,2350,649,3792,963,2363,3326
2018-07-22,20,7197,6820,2819,16491,17181,3174,106,37159,203,398,140,741,993,2465,3458
2018-07-22,21,6986,6698,2709,16101,16846,3200,99,36454,5,0,1,6,1020,2589,3609
2018-07-22,22,6648,6348,2610,15537,16041,3063,91,34939,0,0,0,0,1044,2680,3724
2018-07-22,23,6158,5885,2375,14321,14702,2797,83,32112,0,0,0,0,1064,2725,3789
2018-07-22,24,5694,5479,2140,13013,13356,2525,75,29179,0,0,0,0,1067,2682,3749
2018-07-23,1,5159,5150,2051,12608,13294,2424,70,28606,0,0,0,0,1073,2421,3494
2018-07-23,2,4887,4969,1945,11842,12469,2292,66,26880,0,0,0,0,1083,2332,3415
2018-07-23,3,4672,4853,1878,11366,11899,2202,63,25741,0,0,0,0,1053,2229,3282
2018-07-23,4,4524,4837,1855,11116,11630,2158,61,25176,0,0,0,0,1012,2121,3133
2018-07-23,5,4496,4958,1898,11183,11748,2203,62,25407,0,0,0,0,983,2022,3005
2018-07-23,6,4486,5134,2020,11653,12256,2316,64,26499,0,7,0,7,958,1759,2717
2018-07-23,7,4535,5429,2200,12306,12889,2450,66,27922,125,594,100,819,933,1456,2389
2018-07-23,8,4859,5833,2422,12940,13884,2624,74,29734,749,2758,625,4132,907,1135,2042
2018-07-23,9,5257,6214,2566,13391,14899,2756,82,31336,1141,4840,1123,7104,847,768,1615
2018-07-23,10,5709,6555,2693,13649,16045,2878,90,32869,1261,5954,1376,8591,755,432,1187
2018-07-23,11,6164,6840,2807,14040,17366,3008,99,34719,1302,6464,1534,9300,642,242,884
2018-07-23,12,6604,7090,2917,14485,18646,3130,108,36575,1315,6699,1597,9611,620,233,853
2018-07-23,13,7039,7322,3047,15047,19911,3270,115,38549,1324,6752,1598,9674,629,300,929
2018-07-23,14,7415,7528,3165,15877,20776,3422,120,40402,1313,6713,1589,9615,681,454,1135
2018-07-23,15,7736,7663,3262,16653,21893,3587,121,42461,1306,6564,1577,9447,782,884,1666
2018-07-23,16,7926,7775,3337,17297,22620,3761,123,44007,1285,6157,1510,8952,873,1425,2298
2018-07-23,17,7930,7834,3392,17973,22987,3903,122,45191,1247,5604,1363,8214,937,1944,2881
2018-07-23,18,7915,7785,3450,18388,22831,3956,121,45503,1144,4593,1126,6863,1012,2186,3198
2018-07-23,19,7771,7597,3381,18551,22268,3838,116,44980,815,2448,657,3920,1052,2368,3420
2018-07-23,20,7473,7303,3277,18278,21277,3682,109,43553,214,396,142,752,1102,2439,3541
2018-07-23,21,7237,7113,3121,17690,20274,3640,103,41914,3,0,2,5,1142,2455,3597
2018-07-23,22,6838,6663,2970,16907,19371,3440,94,40021,0,0,0,0,1147,2463,3610
2018-07-23,23,6329,6119,2685,15435,17226,3103,85,36059,0,0,0,0,1148,2392,3540
2018-07-23,24,5827,5647,2404,14045,15544,2768,77,32643,0,0,0,0,1148,2358,3506
2018-07-24,1,5422,5295,2231,13323,14467,2568,72,30642,0,0,0,0,1132,2422,3554
2018-07-24,2,5103,5093,2099,12535,13462,2415,68,28692,0,0,0,0,1120,2342,3462
2018-07-24,3,4857,4970,2010,11971,12685,2310,66,27245,0,0,0,0,1114,2264,3378
2018-07-24,4,4694,4942,1956,11602,12284,2254,64,26416,0,0,0,0,1093,2182,3275
2018-07-24,5,4653,5064,1975,11647,12186,2274,64,26383,0,0,0,0,1069,2086,3155
2018-07-24,6,4641,5250,2104,12002,12673,2385,66,27337,0,8,0,8,1018,1879,2897
2018-07-24,7,4663,5551,2282,12575,13415,2513,67,28783,137,645,100,882,954,1615,2569
2018-07-24,8,4951,5918,2485,13192,14179,2686,74,30343,754,2914,634,4302,888,1300,2188
2018-07-24,9,5366,6254,2628,13651,15406,2833,82,32185,1150,4912,1141,7203,818,937,1755
2018-07-24,10,5833,6578,2752,13942,16726,2987,91,33958,1269,5963,1387,8619,735,606,1341
2018-07-24,11,6311,6867,2859,14400,18217,3161,100,36090,1308,6465,1544,9317,633,354,987
2018-07-24,12,6762,7123,2983,14805,19686,3326,109,38138,1322,6710,1612,9644,592,432,1024
2018-07-24,13,7189,7385,3117,15384,20873,3513,118,40099,1330,6694,1613,9637,576,516,1092
2018-07-24,14,7589,7607,3239,16342,22473,3718,123,42868,1320,6651,1604,9575,596,690,1286
2018-07-24,15,7962,7778,3337,17157,23544,3904,127,44943,1311,6537,1592,9440,712,1177,1889
2018-07-24,16,8194,7924,3405,17982,24200,4076,129,46597,1295,6122,1536,8953,850,1684,2534
2018-07-24,17,8197,7981,3461,18649,24542,4227,129,47757,1260,5578,1383,8221,953,2170,3123
2018-07-24,18,8127,7888,3495,19105,24482,4253,128,48179,1156,4565,1141,6862,989,2311,3300
2018-07-24,19,8001,7755,3430,19165,23810,4091,123,47400,826,2438,665,3929,1028,2463,3491
2018-07-24,20,7690,7412,3325,18760,22431,3977,117,45495,215,385,142,742,1074,2512,3586
2018-07-24,21,7432,7156,3166,18080,21790,3855,108,44043,3,0,0,3,1082,2532,3614
2018-07-24,22,7009,6709,3015,17315,20360,3612,99,41596,0,0,0,0,1057,2531,3588
2018-07-24,23,6455,6147,2739,15828,18505,3248,89,37882,0,0,0,0,1022,2483,3505
2018-07-24,24,5940,5675,2458,14426,16757,2892,80,34367,0,0,0,0,1038,2473,3511
2018-07-25,1,5532,5366,2278,12924,14718,2706,73,30634,0,0,0,0,997,2237,3234
2018-07-25,2,5193,5157,2138,12138,13662,2536,69,28618,0,0,0,0,982,2155,3137
2018-07-25,3,4944,5037,2042,11625,12946,2425,66,27274,0,0,0,0,961,2067,3028
2018-07-25,4,4768,5006,1988,11323,12542,2359,64,26501,0,0,0,0,921,1980,2901
2018-07-25,5,4720,5128,1996,11383,12525,2382,64,26567,0,0,0,0,877,1878,2755
2018-07-25,6,4686,5311,2121,11810,12947,2494,66,27529,0,5,0,5,805,1659,2464
2018-07-25,7,4723,5599,2297,12438,13460,2618,68,28797,114,581,101,796,720,1404,2124
2018-07-25,8,4996,5963,2496,13113,14402,2809,75,30613,756,2756,632,4144,635,1066,1701
2018-07-25,9,5410,6308,2644,13501,15545,2976,83,32316,1152,4836,1141,7129,539,729,1268
2018-07-25,10,5871,6627,2772,13878,16926,3152,92,34259,1268,5916,1388,8572,420,425,845
2018-07-25,11,6367,6913,2892,14386,18535,3348,101,36581,1308,6455,1551,9314,305,239,544
2018-07-25,12,6824,7154,3010,14953,20143,3542,110,38960,1323,6744,1611,9678,284,224,508
2018-07-25,13,7291,7393,3138,15602,21760,3745,118,41438,1328,6778,1611,9717,289,267,556
2018-07-25,14,7711,7598,3258,16608,23278,3957,124,44180,1321,6740,1603,9664,338,358,696
2018-07-25,15,8099,7749,3354,17586,24489,4139,128,46553,1312,6595,1593,9500,504,752,1256
2018-07-25,16,8341,7859,3427,18484,25232,4306,129,48363,1292,6257,1537,9086,673,1357,2030
2018-07-25,17,8312,7891,3476,19314,25521,4432,129,49595,1255,5708,1389,8352,822,1994,2816
2018-07-25,18,8298,7805,3523,19728,25156,4453,129,49664,1149,4711,1152,7012,880,2259,3139
2018-07-25,19,8151,7560,3451,19707,24295,4375,123,48699,822,2535,671,4028,905,2364,3269
2018-07-25,20,7827,7271,3342,19250,22887,4144,117,46596,215,418,135,768,945,2379,3324
2018-07-25,21,7564,7066,3187,18475,22004,4043,108,44829,4,0,2,6,982,2446,3428
2018-07-25,22,7116,6641,3041,17531,20633,3801,99,42271,0,0,0,0,1010,2491,3501
2018-07-25,23,6563,6102,2763,15881,18534,3403,89,38120,0,0,0,0,1022,2464,3486
2018-07-25,24,6040,5640,2481,14334,16607,3030,80,34263,0,0,0,0,1014,2424,3438
2018-07-26,1,5592,5354,2293,13322,14291,2739,74,30639,0,0,0,0,995,2306,3301
2018-07-26,2,5251,5138,2151,12539,13273,2560,69,28655,0,0,0,0,986,2194,3180
2018-07-26,3,4982,5008,2054,12026,12573,2415,66,27293,0,0,0,0,957,2106,3063
2018-07-26,4,4797,4969,1999,11625,12169,2332,64,26403,0,0,0,0,910,2006,2916
2018-07-26,5,4740,5073,2005,11670,12147,2332,64,26426,0,0,0,0,884,1903,2787
2018-07-26,6,4726,5244,2129,12024,12560,2465,65,27328,0,5,0,5,837,1673,2510
2018-07-26,7,4734,5523,2301,12633,13131,2566,67,28610,127,540,100,767,765,1409,2174
2018-07-26,8,4995,5887,2498,13281,13906,2735,74,30210,755,2724,628,4107,669,1118,1787
2018-07-26,9,5416,6230,2647,13652,14956,2914,82,31818,1153,4798,1130,7081,627,852,1479
2018-07-26,10,5893,6557,2783,14036,16165,3071,92,33577,1268,5879,1383,8530,574,564,1138
2018-07-26,11,6377,6832,2907,14547,17570,3273,102,35704,1306,6414,1540,9260,500,380,880
2018-07-26,12,6849,7054,3022,15126,18966,3457,111,37872,1324,6684,1615,9623,494,399,893
2018-07-26,13,7324,7275,3151,15702,20245,3589,119,39869,1328,6710,1618,9656,542,452,994
2018-07-26,14,7755,7456,3270,16643,21676,3736,125,42394,1321,6696,1613,9630,649,596,1245
2018-07-26,15,8129,7586,3363,17487,22862,3845,128,44535,1314,6532,1600,9446,770,1054,1824
2018-07-26,16,8346,7698,3430,18317,23649,4031,131,46340,1299,6173,1540,9012,878,1628,2506
2018-07-26,17,8316,7735,3485,19128,23838,4140,131,47437,1264,5618,1395,8277,963,2195,3158
2018-07-26,18,8287,7641,3499,19465,23414,4199,128,47406,1164,4605,1157,6926,994,2403,3397
2018-07-26,19,8135,7414,3439,19420,22555,4093,124,46391,826,2477,669,3972,998,2465,3463
2018-07-26,20,7807,7133,3327,18930,21845,3881,117,44972,213,396,140,749,994,2492,3486
2018-07-26,21,7543,6940,3182,18186,21209,3824,109,43526,4,0,2,6,1040,2570,3610
2018-07-26,22,7096,6534,3033,17240,19691,3597,99,40837,0,0,0,0,1067,2606,3673
2018-07-26,23,6543,5997,2762,15794,17641,3236,90,36974,0,0,0,0,1095,2576,3671
2018-07-26,24,6008,5569,2486,14390,15825,2906,80,33414,0,0,0,0,1108,2582,3690
2018-07-27,1,5631,5254,2274,13276,13825,2564,73,29952,0,0,0,0,1033,2499,3532
2018-07-27,2,5254,5046,2126,12447,12816,2414,69,27958,0,0,0,0,1017,2465,3482
2018-07-27,3,4988,4921,2024,11854,12154,2297,65,26583,0,0,0,0,996,2373,3369
2018-07-27,4,4785,4898,1966,11522,11767,2237,63,25802,0,0,0,0,969,2243,3212
2018-07-27,5,4724,4996,1967,11522,11749,2263,63,25810,0,0,0,0,939,2093,3032
2018-07-27,6,4686,5161,2073,11996,12109,2377,64,26759,0,5,0,5,883,1822,2705
2018-07-27,7,4701,5419,2229,12531,12573,2481,66,27862,123,544,93,760,820,1512,2332
2018-07-27,8,4956,5792,2428,13205,13359,2636,71,29485,745,2829,627,4201,752,1173,1925
2018-07-27,9,5364,6135,2593,13593,14347,2770,79,31002,1156,4963,1139,7258,652,828,1480
2018-07-27,10,5826,6448,2735,13877,15557,2880,88,32613,1275,5957,1406,8638,551,505,1056
2018-07-27,11,6307,6717,2858,14267,16863,3024,98,34463,1315,6497,1565,9377,413,306,719
2018-07-27,12,6766,6945,2970,14736,18170,3165,107,36393,1335,6760,1620,9715,352,283,635
2018-07-27,13,7242,7170,3085,15242,19302,3301,118,38176,1343,6776,1619,9738,331,324,655
2018-07-27,14,7660,7358,3194,16104,20537,3454,124,40433,1336,6754,1613,9703,376,446,822
2018-07-27,15,8021,7511,3274,16962,21549,3618,129,42470,1331,6614,1604,9549,504,830,1334
2018-07-27,16,8242,7601,3330,17832,22241,3744,132,44162,1315,6274,1547,9136,638,1405,2043
2018-07-27,17,8217,7622,3388,18545,22328,3858,134,45064,1279,5724,1415,8418,772,1995,2767
2018-07-27,18,8188,7576,3362,18937,22017,3888,132,45174,1179,4723,1157,7059,821,2226,3047
2018-07-27,19,8009,7302,3286,18917,21190,3767,127,44200,834,2520,654,4008,865,2320,3185
2018-07-27,20,7691,6998,3159,18441,20060,3619,120,42438,211,394,136,741,902,2370,3272
2018-07-27,21,7425,6785,3018,17714,19399,3571,111,40993,3,0,2,5,951,2394,3345
2018-07-27,22,7024,6435,2907,16860,18322,3406,101,38899,0,0,0,0,993,2366,3359
2018-07-27,23,6520,5955,2681,15562,16841,3130,90,35836,0,0,0,0,1019,2314,3333
2018-07-27,24,6017,5519,2423,14359,15384,2844,81,32881,0,0,0,0,1037,2249,3286
2018-07-28,1,5693,5287,2242,12733,13565,2528,71,29110,0,0,0,0,1072,1798,2870
2018-07-28,2,5339,5062,2093,11956,12643,2380,66,27259,0,0,0,0,1073,1709,2782
2018-07-28,3,5080,4919,1987,11386,11946,2276,63,25885,0,0,0,0,1052,1660,2712
2018-07-28,4,4876,4840,1920,11008,11469,2211,61,24961,0,0,0,0,1019,1628,2647
2018-07-28,5,4737,4850,1920,10885,11283,2194,60,24636,0,0,0,0,986,1573,2559
2018-07-28,6,4635,4852,1947,10991,11319,2226,60,24811,0,3,0,3,908,1366,2274
2018-07-28,7,4542,4973,2001,11149,11176,2235,61,24834,109,457,90,656,828,1133,1961
2018-07-28,8,4812,5318,2115,11422,11563,2300,67,25563,732,2593,606,3931,701,901,1602
2018-07-28,9,5256,5700,2311,11756,12331,2408,74,26780,1151,4742,1128,7021,601,603,1204
2018-07-28,10,5759,6045,2469,12144,13296,2522,83,28258,1273,5855,1400,8528,462,310,772
2018-07-28,11,6264,6348,2595,12620,14412,2627,93,29964,1316,6414,1563,9293,331,172,503
2018-07-28,12,6758,6618,2708,13105,15610,2737,103,31767,1336,6664,1618,9618,266,191,457
2018-07-28,13,7208,6831,2822,13750,16636,2833,111,33542,1343,6679,1623,9645,247,250,497
2018-07-28,14,7602,7013,2919,14582,17650,2913,118,35472,1335,6633,1618,9586,268,340,608
2018-07-28,15,7924,7160,3010,15428,18363,3012,122,37133,1331,6480,1608,9419,396,516,912
2018-07-28,16,8120,7323,3087,16292,18815,3128,125,38570,1315,6125,1555,8995,526,766,1292
2018-07-28,17,8184,7407,3155,17056,19118,3231,127,39729,1277,5565,1406,8248,672,1125,1797
2018-07-28,18,8149,7416,3213,17589,18981,3287,125,40180,1175,4557,1143,6875,766,1338,2104
2018-07-28,19,7923,7172,3170,17658,18379,3272,121,39628,822,2371,642,3835,826,1527,2353
2018-07-28,20,7600,6884,3069,17241,17496,3209,113,38257,206,361,133,700,889,1721,2610
2018-07-28,21,7315,6669,2941,16625,16971,3208,105,37107,4,0,2,6,951,1808,2759
2018-07-28,22,6916,6316,2822,15825,16266,3087,96,35484,0,0,0,0,999,1855,2854
2018-07-28,23,6468,5883,2591,14566,15019,2871,86,32755,0,0,0,0,1018,1837,2855
2018-07-28,24,6041,5445,2350,13380,13698,2630,78,29999,0,0,0,0,1029,1708,2737
2018-07-29,1,5689,5149,2192,12291,13014,2452,70,28039,0,0,0,0,947,1569,2516
2018-07-29,2,5378,4926,2054,11568,12225,2306,66,26375,0,0,0,0,937,1480,2417
2018-07-29,3,5106,4796,1960,11053,11589,2202,63,25117,0,0,0,0,913,1449,2362
2018-07-29,4,4913,4717,1898,10728,11157,2148,61,24303,0,0,0,0,881,1400,2281
2018-07-29,5,4763,4684,1879,10594,10922,2132,60,23918,0,0,0,0,845,1319,2164
2018-07-29,6,4660,4652,1885,10625,10850,2148,59,23892,0,3,0,3,784,1126,1910
2018-07-29,7,4549,4736,1917,10525,10429,2128,60,23354,80,379,72,531,713,929,1642
2018-07-29,8,4765,5064,2046,10649,10737,2182,66,23847,615,2297,524,3436,610,737,1347
2018-07-29,9,5183,5390,2251,10897,11381,2252,74,24817,1054,4342,1034,6430,493,505,998
2018-07-29,10,5640,5718,2417,11246,12277,2349,83,26166,1201,5460,1315,7976,362,305,667
2018-07-29,11,6128,6004,2546,11657,13340,2478,93,27779,1244,6017,1478,8739,262,210,472
2018-07-29,12,6610,6313,2668,12195,14501,2601,102,29610,1256,6284,1549,9089,240,212,452
2018-07-29,13,7047,6533,2787,12880,15633,2729,110,31563,1244,6274,1546,9064,228,250,478
2018-07-29,14,7424,6749,2893,13742,16773,2885,116,33727,1231,6152,1532,8915,260,318,578
2018-07-29,15,7737,6941,2997,14680,17696,3015,121,35723,1207,6048,1507,8762,360,468,828
2018-07-29,16,7955,7098,3095,15663,18421,3165,122,37581,1156,5700,1440,8296,500,692,1192
2018-07-29,17,8028,7177,3178,16583,18785,3316,121,39004,1119,5098,1301,7518,655,1017,1672
2018-07-29,18,8007,7144,3264,17209,18733,3409,121,39669,964,4101,1001,6066,723,1299,2022
2018-07-29,19,7817,6923,3234,17396,18256,3404,117,39371,606,2009,523,3138,783,1500,2283
2018-07-29,20,7539,6706,3149,17111,17463,3327,111,38210,130,289,91,510,823,1686,2509
2018-07-29,21,7303,6539,3026,16578,17017,3332,104,37228,1,0,0,1,885,1773,2658
2018-07-29,22,6916,6187,2884,15836,16313,3182,95,35636,0,0,0,0,924,1855,2779
2018-07-29,23,6430,5722,2616,14448,14973,2911,86,32628,0,0,0,0,954,1893,2847
2018-07-29,24,5970,5315,2351,13118,13732,2631,78,29770,0,0,0,0,960,1847,2807
2018-07-30,1,5662,5024,2210,11875,12862,2445,70,27465,0,0,0,0,996,1449,2445
2018-07-30,2,5340,4841,2085,11249,12152,2308,66,25988,0,0,0,0,988,1240,2228
2018-07-30,3,5093,4731,2001,10867,11615,2219,63,24977,0,0,0,0,965,1217,2182
2018-07-30,4,4901,4724,1964,10681,11373,2178,61,24506,0,0,0,0,944,1215,2159
2018-07-30,5,4839,4853,1987,10816,11474,2227,61,24792,0,0,0,0,934,1205,2139
2018-07-30,6,4834,5052,2117,11335,12007,2356,64,25974,0,4,0,4,888,1076,1964
2018-07-30,7,4818,5344,2304,12045,12541,2509,65,27372,70,311,62,443,824,894,1718
2018-07-30,8,5095,5719,2527,12681,13380,2672,73,29016,563,1934,487,2984,757,715,1472
2018-07-30,9,5505,6075,2690,13068,14392,2798,81,30550,1010,3835,1001,5846,674,455,1129
2018-07-30,10,5957,6409,2842,13326,15388,2901,90,31915,1172,4979,1293,7444,547,255,802
2018-07-30,11,6409,6691,2983,13696,16541,3006,99,33552,1223,5465,1461,8149,429,154,583
2018-07-30,12,6866,6935,3118,14124,17623,3107,107,35171,1240,5814,1526,8580,403,135,538
2018-07-30,13,7309,7166,3270,14607,18543,3217,114,36691,1240,5918,1520,8678,400,147,547
2018-07-30,14,7663,7356,3410,15349,19415,3341,118,38435,1233,5802,1509,8544,420,179,599
2018-07-30,15,7943,7521,3517,16164,20103,3483,121,40084,1222,5599,1489,8310,531,274,805
2018-07-30,16,8075,7642,3598,16933,20442,3611,122,41319,1180,5301,1398,7879,643,470,1113
2018-07-30,17,8035,7697,3662,17619,20520,3718,120,42188,1152,4780,1272,7204,762,757,1519
2018-07-30,18,7973,7662,3669,18083,20392,3774,118,42578,981,3800,980,5761,801,1101,1902
2018-07-30,19,7882,7411,3619,18213,19825,3695,115,42059,610,1800,497,2907,796,1445,2241
2018-07-30,20,7626,7134,3499,17878,18942,3578,109,40718,130,260,84,474,830,1696,2526
2018-07-30,21,7372,6926,3336,17306,18522,3538,103,39680,1,0,0,1,893,1724,2617
2018-07-30,22,6958,6487,3156,16385,17503,3342,94,37534,0,0,0,0,986,1731,2717
2018-07-30,23,6453,5949,2850,14915,15882,3027,84,34120,0,0,0,0,1057,1656,2713
2018-07-30,24,5972,5491,2550,13518,14387,2716,76,30908,0,0,0,0,1089,1574,2663
2018-07-31,1,5498,5205,2323,12829,13810,2585,73,29509,0,0,0,0,1059,1494,2553
2018-07-31,2,5190,5005,2177,12095,12909,2436,69,27720,0,0,0,0,1041,1408,2449
2018-07-31,3,4963,4885,2085,11632,12313,2326,65,26547,0,0,0,0,1029,1305,2334
2018-07-31,4,4802,4854,2041,11377,11983,2269,63,25902,0,0,0,0,1010,1192,2202
2018-07-31,5,4761,4990,2047,11427,12021,2293,63,26015,0,0,0,0,980,1065,2045
2018-07-31,6,4758,5186,2182,11836,12496,2408,64,27015,0,2,0,2,906,856,1762
2018-07-31,7,4775,5460,2343,12491,13035,2547,66,28348,60,291,57,408,846,668,1514
2018-07-31,8,5020,5818,2552,13123,13918,2705,73,30030,514,1968,468,2950,775,483,1258
2018-07-31,9,5400,6155,2689,13436,14777,2846,81,31354,966,3952,978,5896,692,266,958
2018-07-31,10,5815,6476,2825,13644,15778,2969,90,32693,1143,5097,1283,7523,579,139,718
2018-07-31,11,6252,6771,2951,13983,16907,3100,99,34301,1209,5646,1460,8315,458,114,572
2018-07-31,12,6647,7035,3090,14351,18025,3222,107,35916,1229,5947,1530,8706,422,133,555
2018-07-31,13,7031,7306,3238,14748,19068,3362,115,37504,1233,5996,1533,8762,409,193,602
2018-07-31,14,7351,7537,3377,15402,19896,3524,120,39153,1228,5929,1526,8683,421,284,705
2018-07-31,15,7629,7729,3480,16077,20816,3665,124,40894,1222,5777,1510,8509,532,437,969
2018-07-31,16,7767,7891,3556,16755,21442,3813,126,42348,1191,5471,1446,8108,658,673,1331
2018-07-31,17,7739,7961,3614,17494,21587,3922,125,43338,1175,4907,1306,7388,814,1007,1821
2018-07-31,18,7663,7921,3609,17987,21363,3955,124,43638,1007,3880,1008,5895,878,1169,2047
2018-07-31,19,7550,7666,3552,18083,20666,3836,120,42916,643,1857,523,3023,937,1405,2342
2018-07-31,20,7311,7373,3426,17728,19723,3697,114,41472,131,259,90,480,971,1650,2621
2018-07-31,21,7111,7105,3268,17186,19192,3649,107,40344,0,0,0,0,1051,1743,2794
2018-07-31,22,6740,6650,3100,16351,18137,3449,97,38245,0,0,0,0,1100,1861,2961
2018-07-31,23,6255,6096,2815,14882,16475,3115,88,34771,0,0,0,0,1134,1879,3013
2018-07-31,24,5785,5636,2524,13504,14853,2795,79,31442,0,0,0,0,1147,1755,2902
2018-08-01,1,5446,5344,2259,12596,13436,2584,72,28900,0,0,0,0,1095,1346,2441
2018-08-01,2,5120,5151,2115,11870,12629,2428,68,27208,0,0,0,0,1095,1246,2341
2018-08-01,3,4900,5032,2021,11407,12014,2322,65,26019,0,0,0,0,1064,1086,2150
2018-08-01,4,4725,5011,1966,11194,11680,2271,62,25418,0,0,0,0,1020,930,1950
2018-08-01,5,4689,5138,1970,11277,11727,2295,62,25571,0,0,0,0,989,779,1768
2018-08-01,6,4680,5336,2090,11733,12251,2420,64,26679,0,1,0,1,956,628,1584
2018-08-01,7,4707,5596,2236,12391,12836,2552,65,28054,94,340,75,509,914,501,1415
2018-08-01,8,4924,5927,2412,12918,13772,2717,72,29689,721,2169,544,3434,846,385,1231
2018-08-01,9,5281,6288,2559,13223,14536,2854,80,30903,1172,4248,1057,6477,771,249,1020
2018-08-01,10,5694,6638,2692,13466,15522,2972,89,32260,1300,5384,1350,8034,681,175,856
2018-08-01,11,6133,6964,2820,13732,16679,3112,99,33833,1346,5978,1524,8848,569,157,726
2018-08-01,12,6574,7243,2925,14035,17691,3261,108,35306,1368,6235,1597,9200,525,185,710
2018-08-01,13,7002,7542,3049,14471,18626,3417,116,36843,1371,6248,1603,9222,505,253,758
2018-08-01,14,7368,7786,3174,15218,19702,3582,122,38836,1367,6183,1599,9149,509,371,880
2018-08-01,15,7671,7987,3262,16017,20610,3751,126,40717,1361,6041,1588,8990,603,577,1180
2018-08-01,16,7845,8171,3319,16770,21283,3881,128,42275,1345,5645,1513,8503,719,805,1524
2018-08-01,17,7775,8132,3383,17403,21588,4002,128,43334,1306,5045,1376,7727,843,1096,1939
2018-08-01,18,7681,7980,3350,17844,21401,4016,125,43599,1192,4025,1101,6318,930,1314,2244
2018-08-01,19,7518,7712,3300,17903,20686,3882,121,42805,805,1985,593,3383,994,1579,2573
2018-08-01,20,7212,7408,3172,17526,19666,3717,113,41233,169,273,104,546,1036,1805,2841
2018-08-01,21,7040,7200,3043,17038,19179,3708,105,40241,1,0,0,1,1091,1931,3022
2018-08-01,22,6653,6736,2906,16189,18081,3491,96,38066,0,0,0,0,1130,2023,3153
2018-08-01,23,6180,6164,2651,14741,16390,3144,86,34573,0,0,0,0,1160,2048,3208
2018-08-01,24,5721,5708,2389,13407,14831,2814,78,31340,0,0,0,0,1164,2046,3210
2018-08-02,1,5376,5365,2128,12428,13387,2601,70,28698,0,0,0,0,1135,1875,3010
2018-08-02,2,5068,5165,1991,11728,12611,2454,66,27071,0,0,0,0,1123,1805,2928
2018-08-02,3,4854,5040,1906,11270,12042,2344,62,25931,0,0,0,0,1106,1756,2862
2018-08-02,4,4681,5002,1868,11090,11780,2288,60,25431,0,0,0,0,1084,1687,2771
2018-08-02,5,4636,5120,1898,11178,11842,2313,60,25606,0,0,0,0,1048,1610,2658
2018-08-02,6,4648,5310,2016,11652,12374,2437,62,26737,0,1,0,1,991,1395,2386
2018-08-02,7,4639,5537,2162,12329,12963,2586,63,28153,90,341,69,500,946,1178,2124
2018-08-02,8,4877,5906,2333,12846,13718,2738,70,29583,706,2202,511,3419,886,971,1857
2018-08-02,9,5233,6255,2449,13061,14401,2872,77,30622,1161,4280,1019,6460,810,792,1602
2018-08-02,10,5638,6605,2566,13204,15358,2971,86,31829,1307,5449,1323,8079,721,649,1370
2018-08-02,11,6055,6917,2672,13401,16505,3092,96,33303,1352,6054,1502,8908,629,539,1168
2018-08-02,12,6470,7167,2751,13632,17522,3207,105,34676,1373,6339,1569,9281,599,595,1194
2018-08-02,13,6858,7429,2857,13995,18444,3339,112,36102,1383,6438,1585,9406,594,710,1304
2018-08-02,14,7197,7652,2960,14687,19519,3471,117,38006,1379,6311,1583,9273,619,870,1489
2018-08-02,15,7476,7804,3025,15332,20354,3651,121,39669,1374,6210,1573,9157,723,1190,1913
2018-08-02,16,7640,7931,3075,16034,21017,3774,123,41159,1359,5849,1521,8729,824,1553,2377
2018-08-02,17,7575,7957,3105,16693,21321,3861,121,42206,1319,5263,1380,7962,943,1902,2845
2018-08-02,18,7488,7723,3075,17218,21104,3901,119,42553,1212,4217,1114,6543,987,2054,3041
2018-08-02,19,7313,7441,3023,17420,20341,3808,114,41894,808,2060,601,3469,1008,2147,3155
2018-08-02,20,7007,7191,2912,17136,19342,3708,106,40504,171,298,106,575,1013,2223,3236
2018-08-02,21,6849,7002,2805,16723,18870,3647,100,39550,0,0,0,0,1040,2345,3385
2018-08-02,22,6475,6588,2691,15984,17852,3444,91,37582,0,0,0,0,1051,2420,3471
2018-08-02,23,6028,6056,2466,14636,16269,3117,82,34315,0,0,0,0,1050,2434,3484
2018-08-02,24,5574,5622,2239,13359,14738,2807,74,31190,0,0,0,0,1045,2391,3436
2018-08-03,1,5339,5308,2034,12462,13516,2563,70,28828,0,0,0,0,997,2689,3686
2018-08-03,2,5034,5102,1918,11762,12654,2413,65,27112,0,0,0,0,989,2670,3659
2018-08-03,3,4810,4981,1848,11370,12121,2305,62,26074,0,0,0,0,942,2604,3546
2018-08-03,4,4646,4958,1812,11163,11756,2251,59,25445,0,0,0,0,908,2543,3451
2018-08-03,5,4591,5050,1836,11262,11803,2270,59,25610,0,0,0,0,889,2455,3344
2018-08-03,6,4573,5233,1943,11725,12272,2390,60,26664,0,1,0,1,827,2293,3120
2018-08-03,7,4609,5466,2082,12379,12669,2521,61,27845,91,360,70,521,731,2103,2834
2018-08-03,8,4855,5791,2243,12981,13456,2669,67,29385,713,2408,542,3663,601,1845,2446
2018-08-03,9,5210,6142,2368,13256,14344,2799,74,30685,1168,4735,1069,6972,486,1717,2203
2018-08-03,10,5608,6472,2465,13295,15227,2893,82,31715,1311,5841,1360,8512,359,1576,1935
2018-08-03,11,6002,6766,2540,13308,16303,3008,92,32928,1354,6452,1538,9344,239,1471,1710
2018-08-03,12,6372,6996,2596,13490,17324,3120,100,34253,1374,6706,1596,9676,190,1633,1823
2018-08-03,13,6731,7232,2673,13738,18349,3249,108,35663,1384,6744,1603,9731,166,1848,2014
2018-08-03,14,7029,7426,2748,14393,19416,3384,113,37524,1378,6674,1601,9653,187,2079,2266
2018-08-03,15,7304,7573,2801,15102,20348,3520,115,39303,1372,6566,1593,9531,263,2370,2633
2018-08-03,16,7444,7639,2829,15794,21060,3653,117,40843,1357,6232,1539,9128,392,2587,2979
2018-08-03,17,7419,7656,2891,16400,21414,3762,118,41913,1320,5686,1397,8403,555,2811,3366
2018-08-03,18,7380,7529,2844,16823,21260,3799,116,42217,1214,4511,1114,6839,660,2907,3567
2018-08-03,19,7186,7183,2775,16947,20477,3678,111,41431,810,2250,602,3662,733,2941,3674
2018-08-03,20,6867,6896,2654,16621,19350,3516,103,39807,172,314,109,595,792,2925,3717
2018-08-03,21,6684,6735,2558,16288,18779,3489,96,38869,1,0,0,1,857,2947,3804
2018-08-03,22,6332,6361,2498,15623,17722,3317,88,36966,0,0,0,0,908,2945,3853
2018-08-03,23,5942,5897,2323,14470,16203,3049,80,34020,0,0,0,0,954,2889,3843
2018-08-03,24,5526,5475,2134,13365,14802,2764,72,31221,0,0,0,0,957,2871,3828
2018-08-04,1,5269,5023,1979,13118,13461,2600,65,29456,0,0,0,0,796,2901,3697
2018-08-04,2,4946,4824,1876,12415,12601,2430,61,27720,0,0,0,0,751,2852,3603
2018-08-04,3,4709,4692,1805,11877,11922,2324,58,26394,0,0,0,0,691,2787,3478
2018-08-04,4,4506,4621,1762,11482,11425,2257,56,25433,0,0,0,0,626,2693,3319
2018-08-04,5,4384,4617,1754,11314,11237,2237,55,25057,0,0,0,0,568,2608,3176
2018-08-04,6,4306,4598,1786,11432,11224,2257,55,25181,0,1,0,1,511,2540,3051
2018-08-04,7,4185,4638,1814,11616,11182,2248,54,25311,91,457,70,618,464,2387,2851
2018-08-04,8,4412,4939,1909,11778,11615,2319,59,25988,733,2702,551,3986,417,2212,2629
2018-08-04,9,4792,5262,2087,11979,12388,2446,66,27094,1190,5073,1090,7353,364,2116,2480
2018-08-04,10,5216,5574,2205,12105,13217,2560,75,28172,1320,6118,1374,8812,296,2003,2299
2018-08-04,11,5646,5832,2280,12293,14195,2691,85,29480,1358,6642,1550,9550,234,1889,2123
2018-08-04,12,6054,6060,2346,12560,15240,2829,94,30940,1377,6891,1609,9877,259,2055,2314
2018-08-04,13,6414,6262,2416,13065,16297,2968,102,32651,1382,6922,1612,9916,327,2267,2594
2018-08-04,14,6763,6411,2483,13720,17226,3101,108,34373,1377,6880,1608,9865,454,2543,2997
2018-08-04,15,7087,6557,2545,14517,18024,3257,112,36128,1371,6780,1600,9751,552,2846,3398
2018-08-04,16,7322,6686,2608,15317,18727,3413,116,37785,1355,6445,1541,9341,642,3037,3679
2018-08-04,17,7456,6796,2690,16074,19116,3545,117,39065,1312,5876,1392,8580,751,3147,3898
2018-08-04,18,7423,6775,2698,16752,19139,3604,114,39822,1197,4737,1098,7032,804,3185,3989
2018-08-04,19,7145,6544,2707,17077,18793,3533,110,39725,760,2329,573,3662,838,3150,3988
2018-08-04,20,6782,6318,2609,16869,17946,3404,101,38531,156,313,94,563,874,3109,3983
2018-08-04,21,6561,6166,2515,16413,17325,3403,94,37445,1,0,0,1,921,3079,4000
2018-08-04,22,6181,5848,2427,15777,16667,3242,85,35980,0,0,0,0,938,3044,3982
2018-08-04,23,5780,5451,2238,14639,15504,2998,77,33430,0,0,0,0,952,2991,3943
2018-08-04,24,5374,5071,2058,13501,14299,2731,70,30812,0,0,0,0,896,2961,3857
2018-08-05,1,5097,4861,1956,12652,12563,2388,64,27879,0,0,0,0,955,2987,3942
2018-08-05,2,4791,4670,1859,11947,11855,2285,60,26359,0,0,0,0,915,2940,3855
2018-08-05,3,4556,4548,1790,11438,11203,2169,57,25079,0,0,0,0,868,2866,3734
2018-08-05,4,4383,4473,1752,11098,10828,2108,55,24302,0,0,0,0,829,2773,3602
2018-08-05,5,4254,4442,1740,10915,10608,2085,54,23875,0,0,0,0,811,2625,3436
2018-08-05,6,4152,4408,1752,10947,10573,2102,54,23887,0,0,0,0,776,2453,3229
2018-08-05,7,4017,4452,1743,10883,10409,2103,54,23660,73,423,58,554,733,2176,2909
2018-08-05,8,4185,4742,1847,10947,10694,2123,58,24035,687,2628,529,3844,683,1862,2545
2018-08-05,9,4538,5005,2014,11078,11228,2264,65,24845,1200,5002,1093,7295,577,1619,2196
2018-08-05,10,4929,5314,2134,11298,12059,2350,74,25990,1331,6029,1377,8737,422,1389,1811
2018-08-05,11,5350,5575,2248,11475,13041,2408,83,27216,1365,6561,1546,9472,308,1238,1546
2018-08-05,12,5742,5876,2351,11815,14173,2566,92,28856,1376,6814,1608,9798,268,1321,1589
2018-08-05,13,6125,6091,2455,12270,15214,2770,100,30565,1371,6869,1612,9852,260,1452,1712
2018-08-05,14,6476,6310,2553,12894,16357,3029,106,32598,1369,6841,1608,9818,257,1669,1926
2018-08-05,15,6792,6522,2644,13601,17398,3234,112,34555,1364,6717,1606,9687,333,1993,2326
2018-08-05,16,7044,6693,2730,14307,18163,3400,115,36196,1350,6399,1558,9307,425,2263,2688
2018-08-05,17,7146,6785,2823,15098,18676,3498,116,37586,1314,5855,1416,8585,555,2500,3055
2018-08-05,18,7171,6734,2902,15813,18868,3629,115,38624,1178,4785,1148,7111,661,2578,3239
2018-08-05,19,6924,6489,2887,16296,18674,3679,112,38960,738,2398,611,3747,747,2617,3364
2018-08-05,20,6623,6271,2810,16299,17982,3586,103,38170,148,320,96,564,814,2643,3457
2018-08-05,21,6436,6162,2718,15918,17473,3510,96,37194,1,0,0,1,853,2645,3498
2018-08-05,22,6041,5819,2595,15408,16749,3318,86,35770,0,0,0,0,885,2603,3488
2018-08-05,23,5592,5377,2356,14191,15405,3049,77,32932,0,0,0,0,897,2547,3444
2018-08-05,24,5181,5007,2135,12992,14081,2757,69,30110,0,0,0,0,889,2534,3423
2018-08-06,1,4814,4800,2040,11840,12905,2481,62,27501,0,0,0,0,965,2535,3500
2018-08-06,2,4515,4646,1940,11280,12117,2333,58,26001,0,0,0,0,935,2511,3446
2018-08-06,3,4290,4557,1879,10914,11535,2248,56,24965,0,0,0,0,911,2430,3341
2018-08-06,4,4125,4574,1859,10794,11213,2199,54,24473,0,0,0,0,866,2338,3204
2018-08-06,5,4090,4726,1903,10921,11284,2237,55,24709,0,0,0,0,822,2221,3043
2018-08-06,6,4130,4940,2032,11485,11794,2349,57,25897,0,0,0,0,761,2075,2836
2018-08-06,7,4146,5179,2194,12147,12421,2485,58,27324,72,421,56,549,708,1885,2593
2018-08-06,8,4380,5512,2386,12819,13408,2661,64,29165,690,2679,531,3900,627,1666,2293
2018-08-06,9,4740,5815,2517,13122,14420,2828,71,30654,1203,5148,1094,7445,501,1397,1898
2018-08-06,10,5170,6099,2641,13260,15679,2985,79,32215,1332,6147,1371,8850,352,1090,1442
2018-08-06,11,5606,6364,2760,13483,17056,3157,87,33996,1366,6679,1535,9580,240,820,1060
2018-08-06,12,6041,6585,2866,13719,18402,3352,95,35780,1377,6948,1596,9921,238,766,1004
2018-08-06,13,6455,6819,3000,14086,19867,3541,102,37808,1371,7013,1597,9981,243,761,1004
2018-08-06,14,6873,7029,3125,14645,21224,3742,107,39930,1368,6979,1593,9940,282,798,1080
2018-08-06,15,7263,7198,3220,15405,22363,3977,111,42067,1364,6848,1592,9804,414,1109,1523
2018-08-06,16,7585,7322,3298,16140,23032,4151,113,43647,1350,6518,1544,9412,585,1444,2029
2018-08-06,17,7721,7398,3359,16833,23329,4292,114,44779,1314,6007,1403,8724,761,1784,2545
2018-08-06,18,7664,7313,3399,17349,23297,4318,113,45289,1182,4825,1140,7147,836,1991,2827
2018-08-06,19,7488,7015,3358,17473,22702,4202,110,44698,742,2401,607,3750,895,2134,3029
2018-08-06,20,7149,6778,3236,17239,21902,4026,102,43481,146,330,94,570,956,2233,3189
2018-08-06,21,6859,6611,3102,16843,21382,3924,95,42455,1,0,0,1,994,2254,3248
2018-08-06,22,6382,6169,2931,16057,20417,3643,86,40413,0,0,0,0,1019,2231,3250
2018-08-06,23,5855,5649,2638,14856,18647,3262,77,37053,0,0,0,0,1044,2158,3202
2018-08-06,24,5350,5221,2374,13573,16882,2901,69,33638,0,0,0,0,1030,2086,3116
2018-08-07,1,5037,4946,2265,11811,13514,2589,64,28190,0,0,0,0,1040,2181,3221
2018-08-07,2,4717,4780,2138,11164,12646,2416,60,26499,0,0,0,0,1031,2045,3076
2018-08-07,3,4488,4692,2046,10756,12021,2309,58,25355,0,0,0,0,1003,1868,2871
2018-08-07,4,4319,4698,2004,10591,11697,2250,57,24806,0,0,0,0,973,1674,2647
2018-08-07,5,4263,4843,2029,10698,11655,2276,57,24897,0,0,0,0,952,1461,2413
2018-08-07,6,4270,5056,2158,11203,12142,2381,60,25996,0,0,0,0,921,1156,2077
2018-08-07,7,4301,5281,2309,11860,12561,2525,61,27215,70,402,59,531,883,839,1722
2018-08-07,8,4562,5582,2491,12542,13533,2691,67,29046,684,2686,554,3924,829,580,1409
2018-08-07,9,4945,5861,2625,12857,14429,2853,73,30425,1201,5184,1136,7521,751,346,1097
2018-08-07,10,5400,6136,2759,13015,15485,3017,80,31811,1331,6150,1419,8900,662,181,843
2018-08-07,11,5877,6409,2880,13223,16938,3212,89,33675,1367,6675,1579,9621,544,137,681
2018-08-07,12,6369,6650,3015,13497,18358,3414,98,35579,1379,6942,1632,9953,519,148,667
2018-08-07,13,6808,6909,3167,13894,19745,3647,105,37603,1370,6999,1631,10000,521,172,693
2018-08-07,14,7242,7144,3318,14590,21083,3877,111,39873,1370,6970,1629,9969,536,243,779
2018-08-07,15,7638,7340,3431,15325,22405,4092,116,42148,1366,6842,1624,9832,613,350,963
2018-08-07,16,7935,7495,3525,16152,23265,4277,118,44023,1358,6464,1579,9401,727,507,1234
2018-08-07,17,8013,7576,3598,16874,23411,4415,120,45031,1323,5906,1441,8670,839,742,1581
2018-08-07,18,7979,7500,3617,17363,23369,4421,118,45483,1201,4763,1166,7130,914,964,1878
2018-08-07,19,7837,7225,3577,17497,22576,4219,114,44617,737,2342,618,3697,960,1216,2176
2018-08-07,20,7500,6969,3446,17125,21511,4021,106,42975,124,311,95,530,1005,1427,2432
2018-08-07,21,7212,6758,3292,16723,21100,3964,98,42096,1,0,0,1,1043,1420,2463
2018-08-07,22,6727,6288,3105,15827,20060,3707,89,39894,0,0,0,0,1061,1355,2416
2018-08-07,23,6176,5758,2793,14441,18285,3317,80,36335,0,0,0,0,1069,1252,2321
2018-08-07,24,5669,5330,2516,13160,16489,2943,73,32876,0,0,0,0,1064,1121,2185
2018-08-08,1,5349,5030,2374,11949,13920,2681,67,28827,0,0,0,0,1107,1144,2251
2018-08-08,2,5028,4853,2238,11324,13040,2506,63,27144,0,0,0,0,1089,1024,2113
2018-08-08,3,4778,4744,2141,10901,12366,2386,61,25924,0,0,0,0,1034,873,1907
2018-08-08,4,4612,4748,2084,10721,11979,2310,59,25279,0,0,0,0,990,709,1699
2018-08-08,5,4554,4892,2096,10831,12037,2334,60,25471,0,0,0,0,943,561,1504
2018-08-08,6,4569,5108,2227,11309,12429,2463,62,26473,0,0,0,0,880,484,1364
2018-08-08,7,4570,5334,2379,12027,12990,2598,64,27888,48,283,42,373,820,401,1221
2018-08-08,8,4827,5645,2552,12489,13854,2762,69,29384,636,2374,509,3519,731,341,1072
2018-08-08,9,5227,5932,2710,12801,14777,2914,76,30778,1188,4877,1108,7173,594,274,868
2018-08-08,10,5714,6237,2857,12976,15792,3050,84,32111,1327,5895,1392,8614,448,257,705
2018-08-08,11,6227,6526,2997,13217,16986,3208,93,33713,1363,6468,1553,9384,320,297,617
2018-08-08,12,6742,6780,3145,13517,18061,3373,102,35263,1374,6735,1608,9717,272,331,603
2018-08-08,13,7228,7061,3312,13966,19165,3559,110,37011,1366,6748,1606,9720,242,391,633
2018-08-08,14,7687,7313,3483,14752,20384,3744,116,39206,1366,6710,1603,9679,240,462,702
2018-08-08,15,8108,7536,3617,15573,21291,3924,122,41121,1365,6543,1598,9506,320,595,915
2018-08-08,16,8383,7696,3719,16381,21987,4070,122,42759,1353,6152,1552,9057,414,730,1144
2018-08-08,17,8390,7780,3788,17091,22294,4180,122,43885,1318,5546,1413,8277,552,898,1450
2018-08-08,18,8369,7666,3809,17613,22002,4188,120,44122,1182,4399,1132,6713,644,977,1621
2018-08-08,19,8222,7404,3754,17730,21384,4074,116,43502,688,2004,562,3254,716,1111,1827
2018-08-08,20,7890,7141,3609,17415,20471,3950,108,42142,97,223,75,395,767,1232,1999
2018-08-08,21,7592,6912,3454,16983,20347,3901,101,41530,0,0,0,0,801,1268,2069
2018-08-08,22,7100,6436,3249,16097,18988,3681,92,39054,0,0,0,0,841,1332,2173
2018-08-08,23,6540,5880,2926,14703,17263,3308,82,35566,0,0,0,0,868,1385,2253
2018-08-08,24,6010,5434,2636,13373,15611,2964,75,32232,0,0,0,0,884,1348,2232
2018-08-09,1,5654,5150,2405,11984,13968,2741,68,28971,0,0,0,0,953,1034,1987
2018-08-09,2,5334,4964,2260,11367,12980,2587,64,27207,0,0,0,0,908,924,1832
2018-08-09,3,5082,4842,2166,10939,12267,2466,61,25942,0,0,0,0,855,781,1636
2018-08-09,4,4893,4828,2115,10728,11830,2381,59,25207,0,0,0,0,796,640,1436
2018-08-09,5,4829,4958,2122,10827,11826,2411,60,25333,0,0,0,0,734,516,1250
2018-08-09,6,4847,5175,2249,11311,12255,2532,61,26368,0,0,0,0,662,401,1063
2018-08-09,7,4824,5396,2397,12049,12806,2665,62,27792,31,195,32,258,599,319,918
2018-08-09,8,5062,5722,2563,12627,13586,2829,68,29319,494,1896,432,2822,544,263,807
2018-08-09,9,5461,6044,2716,12939,14565,2989,76,30777,1032,4305,1009,6346,440,192,632
2018-08-09,10,5918,6376,2874,13151,15727,3111,84,32283,1224,5472,1310,8006,315,128,443
2018-08-09,11,6401,6679,3024,13359,16948,3275,94,33885,1282,6036,1481,8799,226,119,345
2018-08-09,12,6881,6945,3168,13695,18197,3450,103,35654,1294,6339,1540,9173,219,145,364
2018-08-09,13,7298,7242,3331,14150,19339,3640,111,37449,1287,6293,1534,9114,226,181,407
2018-08-09,14,7692,7503,3502,14819,20493,3845,116,39483,1291,6272,1527,9090,242,215,457
2018-08-09,15,8013,7709,3626,15764,21496,4014,121,41606,1282,6133,1513,8928,324,290,614
2018-08-09,16,8225,7865,3722,16554,22260,4178,122,43326,1258,5781,1443,8482,430,441,871
2018-08-09,17,8179,7926,3784,17328,22656,4308,123,44615,1233,5159,1299,7691,532,687,1219
2018-08-09,18,8120,7801,3772,17844,22437,4364,120,44964,1028,3971,985,5984,576,942,1518
2018-08-09,19,7950,7517,3719,17956,21608,4252,116,44131,560,1692,463,2715,622,1137,1759
2018-08-09,20,7661,7257,3580,17625,20671,4111,109,42714,77,166,56,299,668,1433,2101
2018-08-09,21,7412,7010,3432,17181,20255,4034,102,41770,0,0,0,0,738,1493,2231
2018-08-09,22,6969,6531,3230,16290,19096,3788,93,39464,0,0,0,0,778,1522,2300
2018-08-09,23,6439,5978,2919,14784,17258,3401,83,35735,0,0,0,0,806,1484,2290
2018-08-09,24,5962,5529,2624,13451,15615,3040,75,32391,0,0,0,0,842,1442,2284
2018-08-10,1,5444,5286,2370,12778,13726,2762,69,29544,0,0,0,0,842,1372,2214
2018-08-10,2,5130,5084,2215,12026,12804,2597,64,27701,0,0,0,0,821,1332,2153
2018-08-10,3,4895,4958,2120,11517,12165,2467,62,26421,0,0,0,0,817,1304,2121
2018-08-10,4,4730,4933,2076,11264,11781,2395,60,25710,0,0,0,0,795,1285,2080
2018-08-10,5,4679,5039,2071,11315,11784,2414,60,25782,0,0,0,0,792,1237,2029
2018-08-10,6,4704,5241,2188,11753,12232,2540,62,26797,0,0,0,0,779,1005,1784
2018-08-10,7,4686,5450,2313,12451,12720,2684,63,28127,41,155,35,231,724,828,1552
2018-08-10,8,4919,5815,2473,13009,13491,2867,68,29643,571,1777,467,2815,646,625,1271
2018-08-10,9,5289,6171,2633,13324,14442,3060,74,31110,1109,4080,1067,6256,504,428,932
2018-08-10,10,5707,6531,2792,13604,15424,3239,82,32560,1203,5304,1303,7810,373,283,656
2018-08-10,11,6139,6860,2939,13904,16671,3435,91,34311,1270,5940,1489,8699,277,202,479
2018-08-10,12,6568,7152,3070,14276,17684,3609,100,35878,1280,6270,1549,9099,282,213,495
2018-08-10,13,6995,7457,3214,14648,18593,3787,108,37345,1250,6239,1539,9028,322,278,600
2018-08-10,14,7382,7713,3360,15375,19628,3959,113,39284,1255,6209,1533,8997,417,385,802
2018-08-10,15,7709,7931,3462,16108,20465,4130,116,41029,1239,6074,1516,8829,546,685,1231
2018-08-10,16,7885,8055,3545,16801,20994,4288,118,42398,1206,5720,1462,8388,715,1089,1804
2018-08-10,17,7859,8084,3541,17466,21254,4372,118,43407,1191,5162,1340,7693,887,1592,2479
2018-08-10,18,7769,7977,3515,17827,20959,4364,117,43463,977,3910,1004,5891,906,1841,2747
2018-08-10,19,7577,7659,3407,17906,20215,4179,111,42609,584,1649,464,2697,902,2003,2905
2018-08-10,20,7268,7317,3247,17530,19228,3984,104,41044,78,173,54,305,915,2131,3046
2018-08-10,21,7035,7066,3107,17024,18650,3917,97,39885,0,0,0,0,953,2232,3185
2018-08-10,22,6630,6641,2970,16282,17729,3712,89,38008,0,0,0,0,998,2309,3307
2018-08-10,23,6202,6123,2730,15026,16236,3407,80,34957,0,0,0,0,1011,2341,3352
2018-08-10,24,5756,5673,2469,13790,14828,3075,73,31976,0,0,0,0,1001,2297,3298
2018-08-11,1,5214,5403,2138,12623,13606,2832,66,29343,0,0,0,0,926,2153,3079
2018-08-11,2,4924,5187,1982,11867,12730,2653,61,27510,0,0,0,0,885,1971,2856
2018-08-11,3,4692,5043,1876,11316,12034,2532,59,26140,0,0,0,0,881,1904,2785
2018-08-11,4,4527,4962,1806,10990,11573,2456,57,25280,0,0,0,0,880,1826,2706
2018-08-11,5,4425,4973,1789,10879,11375,2424,56,24944,0,0,0,0,862,1742,2604
2018-08-11,6,4378,5018,1837,10979,11455,2448,56,25125,0,0,0,0,833,1574,2407
2018-08-11,7,4243,5112,1899,11162,11369,2458,56,25254,23,159,23,205,802,1389,2191
2018-08-11,8,4417,5455,2012,11411,11661,2538,60,25879,407,1595,366,2368,725,1229,1954
2018-08-11,9,4784,5859,2137,11762,12325,2656,67,27020,922,3784,942,5648,650,983,1633
2018-08-11,10,5215,6270,2281,12004,13339,2800,76,28429,1144,5027,1266,7437,573,724,1297
2018-08-11,11,5662,6646,2401,12334,14438,2956,86,30023,1233,5718,1444,8395,476,541,1017
2018-08-11,12,6127,6984,2488,12768,15431,3111,95,31614,1240,6025,1514,8779,477,465,942
2018-08-11,13,6558,7281,2558,13248,16401,3269,102,33231,1238,6121,1516,8875,501,451,952
2018-08-11,14,6957,7538,2614,13889,17221,3422,107,34863,1233,6057,1510,8800,551,509,1060
2018-08-11,15,7299,7752,2652,14513,17878,3576,111,36291,1213,5806,1494,8513,646,734,1380
2018-08-11,16,7529,7954,2697,15227,18385,3710,114,37617,1184,5488,1411,8083,757,1009,1766
2018-08-11,17,7642,8056,2691,15840,18521,3814,116,38463,1152,4945,1261,7358,876,1321,2197
2018-08-11,18,7569,7988,2695,16239,18305,3887,113,38720,902,3693,942,5537,968,1517,2485
2018-08-11,19,7312,7643,2657,16344,17674,3815,108,38118,464,1483,416,2363,992,1706,2698
2018-08-11,20,6971,7339,2553,16201,16906,3716,100,37096,62,142,46,250,998,1834,2832
2018-08-11,21,6719,7079,2495,15764,16612,3662,93,36305,0,0,0,0,1016,1868,2884
2018-08-11,22,6324,6631,2394,15136,15766,3491,85,34686,0,0,0,0,1046,1916,2962
2018-08-11,23,5896,6137,2237,14120,14540,3225,77,32215,0,0,0,0,1058,1910,2968
2018-08-11,24,5499,5687,2060,13002,13367,2937,70,29630,0,0,0,0,1051,1889,2940
2018-08-12,1,5358,5296,1960,12148,12378,2618,64,27425,0,0,0,0,1037,1912,2949
2018-08-12,2,5040,5084,1852,11427,11614,2446,61,25746,0,0,0,0,1012,1781,2793
2018-08-12,3,4797,4948,1757,10968,11099,2340,58,24664,0,0,0,0,955,1716,2671
2018-08-12,4,4610,4872,1717,10643,10601,2273,56,23778,0,0,0,0,936,1658,2594
2018-08-12,5,4481,4859,1700,10495,10386,2238,56,23386,0,0,0,0,898,1587,2485
2018-08-12,6,4416,4887,1725,10580,10505,2242,56,23569,0,0,0,0,841,1403,2244
2018-08-12,7,4267,4930,1744,10567,10138,2234,56,23203,22,170,22,214,780,1247,2027
2018-08-12,8,4398,5264,1826,10608,10406,2282,61,23568,377,1842,354,2573,710,1101,1811
2018-08-12,9,4775,5602,1987,10772,11010,2399,67,24460,889,4115,921,5925,629,936,1565
2018-08-12,10,5225,5973,2102,10939,11870,2527,76,25640,1100,5338,1256,7694,525,771,1296
2018-08-12,11,5686,6314,2164,11102,12910,2656,84,27002,1200,6021,1441,8662,395,632,1027
2018-08-12,12,6145,6673,2267,11427,13962,2807,93,28549,1205,6320,1514,9039,397,641,1038
2018-08-12,13,6602,6967,2363,11860,14877,2968,101,30033,1207,6336,1523,9066,442,690,1132
2018-08-12,14,7030,7252,2442,12516,15805,3138,107,31821,1206,6312,1520,9038,508,811,1319
2018-08-12,15,7418,7488,2523,13252,16608,3311,112,33534,1195,6148,1510,8853,634,1129,1763
2018-08-12,16,7710,7679,2610,13977,17253,3484,115,35054,1169,5750,1440,8359,739,1398,2137
2018-08-12,17,7794,7767,2695,14696,17575,3614,115,36184,1134,5145,1290,7569,861,1711,2572
2018-08-12,18,7763,7693,2758,15245,17580,3676,115,36812,898,3843,960,5701,908,1917,2825
2018-08-12,19,7522,7379,2749,15557,17181,3616,110,36670,460,1546,429,2435,923,2080,3003
2018-08-12,20,7206,7132,2677,15407,16480,3522,103,35719,57,138,42,237,961,2188,3149
2018-08-12,21,6972,6926,2629,15264,16267,3507,95,35355,0,0,0,0,1035,2175,3210
2018-08-12,22,6537,6490,2498,14667,15407,3315,86,33692,0,0,0,0,1087,2164,3251
2018-08-12,23,6058,5982,2265,13545,14122,3009,76,31008,0,0,0,0,1121,2135,3256
2018-08-12,24,5610,5568,2058,12403,12830,2713,69,28270,0,0,0,0,1119,2079,3198
2018-08-13,1,5038,5198,1963,11942,12317,2487,63,27019,0,0,0,0,1121,1825,2946
2018-08-13,2,4742,5016,1873,11299,11543,2342,59,25442,0,0,0,0,1103,1673,2776
2018-08-13,3,4547,4908,1820,10893,11133,2253,57,24532,0,0,0,0,1052,1565,2617
2018-08-13,4,4381,4894,1803,10636,10705,2215,55,23815,0,0,0,0,1013,1459,2472
2018-08-13,5,4336,5028,1849,10708,10859,2261,56,24094,0,0,0,0,966,1341,2307
2018-08-13,6,4402,5278,1994,11218,11645,2378,58,25486,0,0,0,0,913,1280,2193
2018-08-13,7,4392,5545,2178,11950,12088,2524,60,26831,21,186,23,230,856,1182,2038
2018-08-13,8,4626,5856,2353,12544,12813,2652,66,28285,389,1998,378,2765,779,1066,1845
2018-08-13,9,4987,6231,2472,12824,13580,2763,73,29452,902,4400,952,6254,716,919,1635
2018-08-13,10,5418,6590,2569,12961,14387,2853,81,30511,1127,5604,1298,8029,648,763,1411
2018-08-13,11,5859,6907,2669,13081,15305,2934,89,31658,1229,6206,1486,8921,567,637,1204
2018-08-13,12,6306,7187,2762,13288,16087,3022,97,32753,1237,6512,1554,9303,556,649,1205
2018-08-13,13,6747,7445,2885,13594,16803,3141,104,33915,1253,6580,1575,9408,582,722,1304
2018-08-13,14,7171,7670,3001,14252,17617,3302,109,35551,1257,6520,1569,9346,664,849,1513
2018-08-13,15,7535,7809,3095,14890,18275,3470,112,37013,1249,6399,1563,9211,773,1093,1866
2018-08-13,16,7788,7919,3172,15583,18921,3599,114,38441,1239,5994,1522,8755,878,1326,2204
2018-08-13,17,7787,7937,3236,16244,19275,3714,115,39531,1203,5404,1371,7978,991,1566,2557
2018-08-13,18,7723,7824,3260,16713,19149,3753,113,39921,992,4115,1065,6172,1040,1778,2818
2018-08-13,19,7551,7509,3216,16884,18660,3655,108,39508,547,1712,511,2770,1065,1971,3036
2018-08-13,20,7244,7270,3098,16514,17779,3553,102,38152,62,151,55,268,1104,2117,3221
2018-08-13,21,6976,7047,3001,16223,17374,3531,95,37443,0,0,0,0,1155,2151,3306
2018-08-13,22,6516,6559,2815,15288,16583,3305,86,35487,0,0,0,0,1199,2196,3395
2018-08-13,23,6000,6013,2519,13952,15281,2973,77,32511,0,0,0,0,1219,2172,3391
2018-08-13,24,5514,5570,2271,12691,13774,2667,69,29438,0,0,0,0,1219,2129,3348
2018-08-14,1,5012,5262,2121,11793,12555,2455,64,27069,0,0,0,0,1168,1972,3140
2018-08-14,2,4725,5062,2016,11217,11840,2313,60,25627,0,0,0,0,1152,1871,3023
2018-08-14,3,4517,4936,1946,10801,11297,2214,58,24568,0,0,0,0,1125,1765,2890
2018-08-14,4,4373,4914,1912,10628,11044,2168,56,24118,0,0,0,0,1097,1634,2731
2018-08-14,5,4329,5037,1942,10745,11139,2197,57,24351,0,0,0,0,1067,1477,2544
2018-08-14,6,4386,5268,2078,11251,11694,2314,59,25508,0,0,0,0,1015,1306,2321
2018-08-14,7,4374,5478,2255,12055,12264,2472,60,27058,23,187,27,237,976,1150,2126
2018-08-14,8,4602,5803,2417,12622,12872,2600,65,28364,425,1997,416,2838,927,946,1873
2018-08-14,9,4939,6129,2528,12852,13472,2706,72,29307,944,4396,1007,6347,847,684,1531
2018-08-14,10,5332,6460,2623,12896,14212,2788,79,30187,1158,5492,1334,7984,750,443,1193
2018-08-14,11,5750,6762,2717,13008,15051,2872,88,31234,1251,6128,1510,8889,625,291,916
2018-08-14,12,6176,7025,2829,13157,15875,2968,95,32298,1258,6436,1577,9271,567,278,845
2018-08-14,13,6577,7297,2958,13430,16720,3086,102,33539,1270,6442,1586,9298,531,348,879
2018-08-14,14,6959,7531,3089,14041,17625,3230,106,35213,1275,6391,1579,9245,556,487,1043
2018-08-14,15,7269,7711,3190,14700,18469,3379,110,36865,1267,6228,1571,9066,656,675,1331
2018-08-14,16,7461,7844,3279,15386,19164,3518,111,38387,1247,5863,1524,8634,767,895,1662
2018-08-14,17,7450,7885,3353,16069,19549,3627,112,39564,1208,5260,1370,7838,878,1185,2063
2018-08-14,18,7370,7778,3374,16502,19286,3665,111,39768,1016,3937,1073,6026,949,1399,2348
2018-08-14,19,7205,7461,3331,16601,18632,3564,106,39112,533,1566,489,2588,1002,1598,2600
2018-08-14,20,6950,7224,3207,16359,17927,3483,99,38072,57,120,50,227,1052,1762,2814
2018-08-14,21,6747,6999,3100,16172,17668,3471,94,37616,0,0,0,0,1118,1850,2968
2018-08-14,22,6318,6508,2903,15248,16578,3262,85,35384,0,0,0,0,1155,1898,3053
2018-08-14,23,5827,5969,2600,13861,15078,2940,77,32182,0,0,0,0,1177,1906,3083
2018-08-14,24,5376,5530,2345,12673,13690,2644,70,29290,0,0,0,0,1183,1816,2999
2018-08-15,1,5075,5213,2203,11696,12366,2616,65,27018,0,0,0,0,1181,1706,2887
2018-08-15,2,4798,5016,2085,11127,11741,2444,61,25643,0,0,0,0,1155,1563,2718
2018-08-15,3,4586,4896,2006,10745,11241,2393,58,24703,0,0,0,0,1114,1388,2502
2018-08-15,4,4427,4864,1969,10583,10986,2350,57,24240,0,0,0,0,1075,1215,2290
2018-08-15,5,4388,4987,1998,10724,11104,2362,58,24459,0,0,0,0,1032,1074,2106
2018-08-15,6,4443,5211,2136,11213,11673,2472,60,25616,0,0,0,0,977,881,1858
2018-08-15,7,4434,5429,2305,12061,12303,2618,62,27240,29,190,31,250,911,726,1637
2018-08-15,8,4649,5750,2467,12651,13072,2782,67,28776,484,2023,451,2958,844,550,1394
2018-08-15,9,4992,6072,2586,12876,13710,2911,74,29777,1002,4376,1052,6430,779,346,1125
2018-08-15,10,5387,6406,2700,12962,14516,3021,81,30788,1206,5491,1359,8056,708,183,891
2018-08-15,11,5817,6709,2814,13073,15392,3094,89,31858,1290,6123,1527,8940,625,151,776
2018-08-15,12,6250,6977,2929,13281,16256,3127,97,32963,1299,6403,1594,9296,603,169,772
2018-08-15,13,6659,7253,3067,13528,17059,3268,104,34162,1312,6371,1601,9284,598,228,826
2018-08-15,14,7036,7493,3207,14131,18014,3390,109,35854,1313,6316,1595,9224,654,319,973
2018-08-15,15,7356,7681,3325,14814,18915,3505,112,37548,1309,6161,1587,9057,751,453,1204
2018-08-15,16,7567,7821,3416,15459,19482,3618,114,38879,1292,5747,1545,8584,846,635,1481
2018-08-15,17,7524,7861,3493,16039,19537,3683,113,39560,1242,5111,1391,7744,952,908,1860
2018-08-15,18,7476,7774,3510,16514,19345,3731,111,39888,1078,3802,1101,5981,993,1185,2178
2018-08-15,19,7309,7449,3451,16642,18682,3581,107,39199,601,1472,510,2583,1003,1423,2426
2018-08-15,20,7059,7208,3326,16351,17938,3476,101,38054,63,99,53,215,1013,1641,2654
2018-08-15,21,6843,6990,3224,16121,17609,3471,95,37491,0,0,0,0,1071,1690,2761
2018-08-15,22,6421,6496,3019,15340,16575,3432,87,35627,0,0,0,0,1102,1687,2789
2018-08-15,23,5943,5963,2712,13977,15089,3093,78,32445,0,0,0,0,1122,1659,2781
2018-08-15,24,5498,5525,2441,12773,13644,2684,71,29443,0,0,0,0,1131,1565,2696
2018-08-16,1,5148,5225,2226,11759,12766,2488,65,27291,0,0,0,0,1096,1384,2480
2018-08-16,2,4886,5031,2095,11209,12052,2359,62,25894,0,0,0,0,1083,1247,2330
2018-08-16,3,4693,4909,2007,10836,11520,2268,59,24896,0,0,0,0,1051,1083,2134
2018-08-16,4,4547,4884,1959,10678,11248,2219,58,24414,0,0,0,0,1022,934,1956
2018-08-16,5,4522,5021,1988,10787,11351,2256,58,24663,0,0,0,0,966,813,1779
2018-08-16,6,4587,5257,2133,11292,11932,2377,60,25872,0,0,0,0,878,655,1533
2018-08-16,7,4571,5468,2308,12120,12512,2527,62,27430,24,162,30,216,797,512,1309
2018-08-16,8,4808,5787,2458,12585,13092,2673,68,28623,455,1840,430,2725,702,384,1086
2018-08-16,9,5120,6111,2580,12776,13724,2775,74,29574,1002,4059,1037,6098,648,216,864
2018-08-16,10,5483,6447,2709,12832,14513,2852,81,30483,1214,5218,1345,7777,599,124,723
2018-08-16,11,5855,6759,2829,12935,15414,2940,90,31584,1306,5929,1522,8757,503,100,603
2018-08-16,12,6226,7031,2942,13124,16234,2995,98,32661,1324,6196,1595,9115,453,123,576
2018-08-16,13,6545,7320,3077,13378,17082,3094,104,33866,1313,6214,1596,9123,439,158,597
2018-08-16,14,6819,7572,3210,14026,17998,3210,109,35504,1302,6091,1590,8983,496,183,679
2018-08-16,15,7030,7760,3312,14730,18850,3328,113,37231,1298,5928,1582,8808,571,261,832
2018-08-16,16,7151,7901,3390,15511,19458,3446,112,38739,1280,5527,1524,8331,665,475,1140
2018-08-16,17,7114,7905,3420,16169,19741,3529,111,39763,1210,4912,1339,7461,760,829,1589
2018-08-16,18,7054,7829,3427,16645,19462,3611,110,40040,998,3608,1011,5617,807,1155,1962
2018-08-16,19,6915,7490,3363,16738,18741,3539,106,39335,473,1322,419,2214,827,1455,2282
2018-08-16,20,6709,7272,3246,16430,18112,3478,100,38331,46,71,37,154,846,1718,2564
2018-08-16,21,6572,7026,3162,16258,17757,3457,95,37777,0,0,0,0,901,1745,2646
2018-08-16,22,6211,6542,2960,15360,16701,3269,87,35626,0,0,0,0,927,1725,2652
2018-08-16,23,5779,6009,2672,14009,15234,2962,78,32494,0,0,0,0,937,1692,2629
2018-08-16,24,5401,5570,2411,12843,13907,2681,71,29713,0,0,0,0,916,1674,2590
2018-08-17,1,5112,5188,2150,11936,13189,2513,67,27915,0,0,0,0,928,1508,2436
2018-08-17,2,4848,4993,2012,11333,12385,2385,63,26377,0,0,0,0,909,1494,2403
2018-08-17,3,4642,4873,1920,10922,11825,2280,61,25298,0,0,0,0,869,1428,2297
2018-08-17,4,4502,4847,1875,10711,11519,2232,59,24732,0,0,0,0,832,1368,2200
2018-08-17,5,4467,4959,1899,10799,11601,2261,59,24930,0,0,0,0,779,1287,2066
2018-08-17,6,4523,5191,2022,11278,12118,2384,61,26049,0,0,0,0,705,1077,1782
2018-08-17,7,4513,5401,2181,12089,12691,2550,62,27601,18,146,21,185,632,867,1499
2018-08-17,8,4785,5699,2330,12618,13330,2690,68,28915,394,1796,366,2556,533,679,1212
2018-08-17,9,5129,6041,2460,12843,14121,2817,74,30065,963,4181,977,6121,408,440,848
2018-08-17,10,5533,6370,2584,12911,14971,2915,81,31088,1182,5412,1293,7887,276,228,504
2018-08-17,11,5934,6676,2692,13087,16009,3011,89,32406,1277,6060,1481,8818,198,113,311
2018-08-17,12,6348,6944,2779,13352,17015,3093,97,33768,1284,6350,1553,9187,168,119,287
2018-08-17,13,6730,7215,2878,13713,17949,3190,104,35166,1283,6368,1552,9203,155,166,321
2018-08-17,14,7080,7461,2976,14450,18893,3309,108,36969,1277,6296,1545,9118,163,250,413
2018-08-17,15,7384,7643,3049,15204,19755,3446,110,38725,1275,6123,1542,8940,203,526,729
2018-08-17,16,7556,7760,3105,15930,20373,3556,111,40180,1257,5759,1482,8498,253,998,1251
2018-08-17,17,7529,7780,3159,16667,20494,3641,111,41123,1194,5177,1318,7689,339,1596,1935
2018-08-17,18,7485,7603,3118,17095,20224,3674,111,41313,991,3788,977,5756,405,1877,2282
2018-08-17,19,7283,7297,3035,17091,19382,3567,106,40355,463,1385,396,2244,495,2033,2528
2018-08-17,20,7007,7038,2883,16679,18675,3478,99,39141,41,99,33,173,591,2142,2733
2018-08-17,21,6794,6820,2815,16368,18121,3454,94,38247,0,0,0,0,649,2247,2896
2018-08-17,22,6399,6405,2672,15463,17025,3275,86,36059,0,0,0,0,676,2315,2991
2018-08-17,23,5993,5940,2452,14184,15629,3022,77,33122,0,0,0,0,709,2329,3038
2018-08-17,24,5585,5505,2236,13017,14397,2756,70,30451,0,0,0,0,709,2344,3053
2018-08-18,1,5278,5088,2065,12984,13647,2573,64,29478,0,0,0,0,713,2237,2950
2018-08-18,2,4982,4882,1952,12225,12704,2414,60,27613,0,0,0,0,677,2207,2884
2018-08-18,3,4752,4752,1867,11640,11966,2314,58,26189,0,0,0,0,663,2157,2820
2018-08-18,4,4557,4689,1823,11259,11517,2251,56,25295,0,0,0,0,641,2083,2724
2018-08-18,5,4454,4707,1803,11106,11328,2233,56,24934,0,0,0,0,610,1991,2601
2018-08-18,6,4420,4773,1850,11205,11442,2266,57,25180,0,0,0,0,541,1827,2368
2018-08-18,7,4313,4845,1899,11405,11486,2310,57,25468,20,194,21,235,469,1622,2091
2018-08-18,8,4541,5065,2013,11558,11710,2373,61,25911,407,2082,369,2858,389,1364,1753
2018-08-18,9,4922,5413,2171,11859,12286,2473,68,26894,986,4624,987,6597,284,1029,1313
2018-08-18,10,5377,5737,2282,12125,13165,2564,76,28139,1194,5772,1313,8279,174,711,885
2018-08-18,11,5827,6032,2386,12511,14176,2656,85,29636,1283,6342,1495,9120,122,462,584
2018-08-18,12,6240,6301,2477,12959,15185,2750,94,31196,1289,6613,1563,9465,103,534,637
2018-08-18,13,6621,6538,2560,13495,16189,2858,101,32854,1281,6575,1564,9420,97,646,743
2018-08-18,14,6966,6721,2647,14214,17060,2957,106,34547,1276,6520,1557,9353,109,848,957
2018-08-18,15,7279,6891,2738,14913,17883,3081,110,36195,1281,6328,1552,9161,169,1406,1575
2018-08-18,16,7506,7021,2827,15580,18611,3215,112,37728,1263,5930,1496,8689,285,1953,2238
2018-08-18,17,7598,7079,2910,16134,18948,3331,113,38735,1194,5351,1333,7878,462,2449,2911
2018-08-18,18,7574,7037,2959,16621,18908,3416,112,39265,991,3932,996,5919,616,2601,3217
2018-08-18,19,7336,6767,2909,16764,18395,3390,106,38864,460,1422,399,2281,713,2648,3361
2018-08-18,20,7040,6568,2794,16478,17642,3344,98,37772,39,96,34,169,831,2655,3486
2018-08-18,21,6785,6359,2737,16062,17062,3308,92,36733,0,0,0,0,904,2701,3605
2018-08-18,22,6370,5976,2565,15375,16161,3149,84,34977,0,0,0,0,938,2701,3639
2018-08-18,23,6008,5566,2336,14240,15000,2915,75,32441,0,0,0,0,948,2679,3627
2018-08-18,24,5583,5173,2137,13153,13849,2674,69,29955,0,0,0,0,958,2625,3583
2018-08-19,1,5280,4792,1969,12324,12892,2549,65,28042,0,0,0,0,975,2575,3550
2018-08-19,2,4980,4607,1872,11600,12068,2394,61,26335,0,0,0,0,956,2510,3466
2018-08-19,3,4742,4499,1802,11115,11498,2293,59,25176,0,0,0,0,929,2365,3294
2018-08-19,4,4556,4447,1763,10788,11066,2222,57,24343,0,0,0,0,907,2212,3119
2018-08-19,5,4437,4441,1751,10606,10841,2195,56,23908,0,0,0,0,889,2053,2942
2018-08-19,6,4361,4479,1778,10673,10762,2211,56,23913,0,0,0,0,836,1834,2670
2018-08-19,7,4225,4531,1805,10718,10605,2192,57,23783,21,192,23,236,787,1560,2347
2018-08-19,8,4391,4769,1888,10680,10779,2250,61,23980,429,2169,383,2981,682,1251,1933
2018-08-19,9,4771,5004,2032,10817,11316,2309,68,24720,1017,4833,1008,6858,598,924,1522
2018-08-19,10,5234,5262,2163,10954,12027,2375,76,25641,1213,5948,1335,8496,488,616,1104
2018-08-19,11,5719,5540,2288,11286,13061,2451,85,27093,1306,6494,1514,9314,384,392,776
2018-08-19,12,6193,5877,2396,11777,14138,2553,94,28772,1312,6753,1580,9645,347,354,701
2018-08-19,13,6657,6116,2503,12383,15296,2676,102,30667,1303,6707,1579,9589,340,381,721
2018-08-19,14,7090,6374,2610,13141,16382,2830,108,32670,1295,6616,1579,9490,376,475,851
2018-08-19,15,7470,6604,2716,13966,17326,2992,112,34607,1300,6463,1571,9334,453,796,1249
2018-08-19,16,7739,6809,2823,14836,18365,3160,116,36688,1287,5972,1521,8780,575,1239,1814
2018-08-19,17,7858,6927,2916,15565,18826,3298,118,38017,1216,5370,1348,7934,721,1799,2520
2018-08-19,18,7788,6854,2977,16252,18774,3440,118,38794,1010,3974,1024,6008,780,2032,2812
2018-08-19,19,7533,6625,2934,16591,18230,3452,113,38596,475,1402,401,2278,835,2182,3017
2018-08-19,20,7238,6466,2843,16376,17651,3391,105,37732,40,89,32,161,887,2273,3160
2018-08-19,21,6982,6265,2798,16020,17153,3375,98,36855,0,0,0,0,950,2302,3252
2018-08-19,22,6519,5864,2613,15251,16111,3202,89,34863,0,0,0,0,1005,2264,3269
2018-08-19,23,6042,5415,2351,14003,14840,2925,79,32057,0,0,0,0,1039,2206,3245
2018-08-19,24,5598,5047,2133,12761,13622,2656,70,29319,0,0,0,0,1027,2101,3128
2018-08-20,1,5214,4778,1955,12755,12584,2456,64,28070,0,0,0,0,959,1826,2785
2018-08-20,2,4909,4643,1855,11956,11888,2320,60,26435,0,0,0,0,907,1610,2517
2018-08-20,3,4677,4572,1793,11481,11405,2244,58,25397,0,0,0,0,877,1409,2286
2018-08-20,4,4514,4601,1774,11268,11168,2211,56,24912,0,0,0,0,867,1239,2106
2018-08-20,5,4446,4767,1825,11271,11319,2255,57,25110,0,0,0,0,840,1077,1917
2018-08-20,6,4506,5052,1975,11680,11889,2389,60,26227,0,0,0,0,788,947,1735
2018-08-20,7,4525,5289,2168,12394,12642,2583,62,27889,20,173,20,213,716,809,1525
2018-08-20,8,4756,5579,2333,12870,13371,2723,67,29240,409,2035,361,2805,650,659,1309
2018-08-20,9,5127,5863,2450,13094,14193,2848,74,30417,991,4618,977,6586,544,528,1072
2018-08-20,10,5573,6159,2556,13202,15075,2936,82,31504,1202,5783,1319,8304,401,427,828
2018-08-20,11,6031,6448,2658,13402,16078,3031,91,32811,1292,6341,1499,9132,266,430,696
2018-08-20,12,6483,6734,2744,13541,17037,3131,100,34017,1300,6570,1570,9440,225,545,770
2018-08-20,13,6925,7013,2856,13826,18006,3252,107,35400,1298,6496,1572,9366,219,730,949
2018-08-20,14,7321,7264,2959,14539,19028,3393,114,37283,1292,6382,1572,9246,250,968,1218
2018-08-20,15,7648,7464,3041,15264,19892,3533,118,39017,1295,6210,1564,9069,338,1158,1496
2018-08-20,16,7851,7623,3117,16062,20438,3658,121,40489,1280,5694,1502,8476,460,1323,1783
2018-08-20,17,7798,7683,3143,16690,20585,3763,120,41367,1208,5024,1331,7563,649,1561,2210
2018-08-20,18,7721,7531,3148,17161,20344,3801,118,41633,1006,3647,1001,5654,792,1646,2438
2018-08-20,19,7550,7225,3114,17553,19671,3699,113,41246,436,1251,380,2067,874,1689,2563
2018-08-20,20,7286,7047,2996,17173,18941,3629,106,40059,32,68,27,127,959,1738,2697
2018-08-20,21,7013,6794,2945,16750,18504,3579,98,39141,0,0,0,0,1036,1722,2758
2018-08-20,22,6536,6291,2741,15984,17315,3343,89,36941,0,0,0,0,1094,1673,2767
2018-08-20,23,6029,5764,2457,14668,15694,3010,79,33662,0,0,0,0,1122,1552,2674
2018-08-20,24,5568,5337,2218,13480,14201,2695,71,30657,0,0,0,0,1138,1400,2538
2018-08-21,1,5224,4874,2040,11642,12875,2447,65,27240,0,0,0,0,1154,1181,2335
2018-08-21,2,4930,4703,1934,11029,12071,2309,61,25680,0,0,0,0,1147,1059,2206
2018-08-21,3,4704,4603,1864,10642,11545,2208,59,24663,0,0,0,0,1133,964,2097
2018-08-21,4,4535,4608,1831,10479,11255,2175,57,24176,0,0,0,0,1117,886,2003
2018-08-21,5,4483,4768,1867,10606,11348,2212,57,24434,0,0,0,0,1078,799,1877
2018-08-21,6,4529,5055,2014,11129,11855,2350,60,25603,0,0,0,0,1018,707,1725
2018-08-21,7,4543,5274,2209,11957,12436,2539,61,27202,17,144,18,179,939,619,1558
2018-08-21,8,4737,5498,2356,12500,13190,2664,66,28628,395,1799,362,2556,850,515,1365
2018-08-21,9,5067,5738,2454,12646,13942,2763,73,29632,973,4147,975,6095,758,431,1189
2018-08-21,10,5466,5990,2537,12656,14809,2841,80,30594,1169,5400,1316,7885,637,397,1034
2018-08-21,11,5878,6234,2607,12734,15682,2905,89,31619,1272,5981,1502,8755,517,433,950
2018-08-21,12,6284,6452,2692,12863,16542,2970,96,32680,1280,6251,1573,9104,458,532,990
2018-08-21,13,6657,6671,2796,13101,17346,3061,103,33820,1271,6262,1575,9108,441,661,1102
2018-08-21,14,7000,6883,2890,13675,18298,3163,107,35454,1266,6146,1572,8984,463,812,1275
2018-08-21,15,7276,7040,2973,14311,19237,3283,110,37151,1266,6003,1567,8836,559,966,1525
2018-08-21,16,7452,7180,3039,14995,19785,3380,112,38482,1244,5587,1503,8334,659,1093,1752
2018-08-21,17,7402,7237,3093,15637,20031,3481,112,39472,1165,4950,1338,7453,798,1243,2041
2018-08-21,18,7315,7093,3126,16069,19801,3521,109,39712,948,3683,1003,5634,888,1340,2228
2018-08-21,19,7146,6806,3062,16223,19132,3446,104,39117,423,1277,396,2096,943,1410,2353
2018-08-21,20,6940,6668,2951,16016,18218,3420,97,37961,29,77,29,135,978,1474,2452
2018-08-21,21,6703,6452,2900,15853,17770,3390,92,37315,0,0,0,0,1045,1462,2507
2018-08-21,22,6277,5979,2698,14909,16753,3179,84,35135,0,0,0,0,1082,1489,2571
2018-08-21,23,5809,5504,2421,13603,15327,2859,75,32074,0,0,0,0,1106,1471,2577
2018-08-21,24,5382,5116,2199,12417,13752,2583,68,29032,0,0,0,0,1082,1416,2498
2018-08-22,1,5143,4757,2053,11525,12322,2423,62,26543,0,0,0,0,1038,1224,2262
2018-08-22,2,4866,4613,1959,10921,11609,2286,59,25086,0,0,0,0,1005,1124,2129
2018-08-22,3,4649,4538,1888,10542,11111,2189,57,24111,0,0,0,0,947,1050,1997
2018-08-22,4,4503,4553,1853,10376,10841,2153,55,23636,0,0,0,0,875,998,1873
2018-08-22,5,4461,4711,1887,10503,10925,2188,56,23882,0,0,0,0,797,921,1718
2018-08-22,6,4509,4998,2037,11059,11511,2318,58,25157,0,1,0,1,733,802,1535
2018-08-22,7,4539,5211,2238,12068,12187,2514,60,27038,15,142,18,175,646,673,1319
2018-08-22,8,4730,5413,2379,12717,12813,2641,64,28443,383,1883,360,2626,553,544,1097
2018-08-22,9,5042,5636,2475,12927,13312,2735,70,29251,965,4481,988,6434,470,411,881
2018-08-22,10,5419,5863,2554,12761,13924,2797,77,29767,1188,5693,1335,8216,389,316,705
2018-08-22,11,5798,6086,2624,12745,14612,2860,85,30509,1281,6289,1511,9081,308,293,601
2018-08-22,12,6169,6305,2708,12753,15370,2928,92,31351,1288,6560,1584,9432,273,396,669
2018-08-22,13,6476,6533,2816,12837,16175,3017,98,32334,1296,6560,1590,9446,266,552,818
2018-08-22,14,6762,6755,2922,13410,17071,3117,102,33910,1290,6507,1584,9381,307,752,1059
2018-08-22,15,7004,6921,3026,14044,17941,3230,106,35529,1291,6358,1579,9228,414,1005,1419
2018-08-22,16,7181,7044,3118,14695,18563,3335,107,36910,1278,5930,1519,8727,532,1248,1780
2018-08-22,17,7135,7082,3184,15329,18867,3432,108,37946,1209,5307,1355,7871,691,1508,2199
2018-08-22,18,7069,6997,3213,15757,18611,3467,105,38149,1011,3913,1026,5950,775,1625,2400
2018-08-22,19,6914,6787,3153,15900,17947,3399,100,37556,462,1373,419,2254,859,1760,2619
2018-08-22,20,6723,6603,3034,15713,17338,3371,94,36725,35,73,32,140,920,1837,2757
2018-08-22,21,6512,6385,2981,15521,16988,3349,88,36155,0,0,0,0,988,1889,2877
2018-08-22,22,6126,5911,2770,14648,15830,3138,80,33906,0,0,0,0,1038,1922,2960
2018-08-22,23,5676,5415,2476,13351,14400,2835,72,30868,0,0,0,0,1070,1901,2971
2018-08-22,24,5266,5031,2229,12193,13061,2564,65,28093,0,0,0,0,1077,1866,2943
2018-08-23,1,5044,4825,2063,11752,12280,2433,59,26733,0,0,0,0,1065,1864,2929
2018-08-23,2,4761,4668,1952,11199,11523,2303,56,25291,0,0,0,0,1038,1801,2839
2018-08-23,3,4539,4589,1883,10833,10992,2213,54,24302,0,0,0,0,1001,1720,2721
2018-08-23,4,4397,4600,1853,10665,10688,2171,53,23787,0,0,0,0,957,1611,2568
2018-08-23,5,4354,4752,1887,10782,10779,2203,53,24028,0,0,0,0,899,1495,2394
2018-08-23,6,4405,5035,2034,11273,11365,2328,56,25232,0,1,0,1,842,1298,2140
2018-08-23,7,4438,5246,2231,12218,12011,2483,58,26978,14,163,15,192,786,1074,1860
2018-08-23,8,4624,5462,2371,12811,12604,2627,62,28313,423,2123,373,2919,710,883,1593
2018-08-23,9,4942,5702,2466,12914,13233,2720,68,29142,1042,4865,1024,6931,676,706,1382
2018-08-23,10,5311,5947,2553,12952,13912,2771,74,29918,1258,6004,1366,8628,608,543,1151
2018-08-23,11,5680,6192,2631,12903,14543,2823,81,30558,1327,6546,1538,9411,533,461,994
2018-08-23,12,6038,6420,2711,12795,15285,2895,88,31272,1326,6795,1600,9721,515,557,1072
2018-08-23,13,6350,6660,2814,12738,16101,2976,95,32117,1319,6844,1606,9769,512,734,1246
2018-08-23,14,6646,6881,2918,13144,17142,3093,98,33685,1315,6816,1596,9727,538,995,1533
2018-08-23,15,6890,7070,3007,13767,17927,3213,101,35216,1315,6696,1590,9601,613,1331,1944
2018-08-23,16,7066,7221,3073,14459,18647,3330,103,36748,1301,6338,1532,9171,708,1646,2354
2018-08-23,17,7039,7241,3134,15059,18923,3428,104,37722,1224,5716,1373,8313,829,2089,2918
2018-08-23,18,6970,7119,3093,15520,18794,3495,102,38119,1031,4234,1030,6295,895,2270,3165
2018-08-23,19,6804,6869,3030,15634,18218,3420,97,37578,467,1509,419,2395,933,2334,3267
2018-08-23,20,6621,6704,2904,15455,17463,3346,91,36563,34,102,31,167,970,2371,3341
2018-08-23,21,6410,6477,2857,15290,17203,3332,85,36118,0,0,0,0,1032,2445,3477
2018-08-23,22,6010,5999,2674,14585,16201,3152,78,34224,0,0,0,0,1083,2489,3572
2018-08-23,23,5552,5498,2424,13425,14770,2860,70,31334,0,0,0,0,1087,2490,3577
2018-08-23,24,5134,5114,2203,12336,13368,2586,63,28562,0,0,0,0,1080,2461,3541
2018-08-24,1,4810,4755,1972,11393,12021,2390,59,26071,0,0,0,0,1048,2416,3464
2018-08-24,2,4547,4614,1868,10886,11286,2265,56,24701,0,0,0,0,1024,2360,3384
2018-08-24,3,4336,4537,1801,10561,10785,2175,53,23782,0,0,0,0,988,2311,3299
2018-08-24,4,4206,4559,1768,10441,10510,2130,52,23341,0,0,0,0,946,2254,3200
2018-08-24,5,4171,4706,1799,10590,10585,2161,53,23596,0,0,0,0,896,2181,3077
2018-08-24,6,4224,4993,1936,11080,11118,2276,55,24736,0,0,0,0,821,2077,2898
2018-08-24,7,4262,5201,2136,11946,11755,2430,57,26395,15,158,13,186,746,1911,2657
2018-08-24,8,4434,5417,2268,12543,12245,2555,60,27612,413,2068,364,2845,690,1721,2411
2018-08-24,9,4728,5645,2362,12657,12821,2647,66,28400,1027,4774,998,6799,627,1553,2180
2018-08-24,10,5058,5889,2452,12642,13414,2693,72,29031,1250,5931,1345,8526,508,1358,1866
2018-08-24,11,5384,6125,2507,12556,14049,2738,79,29630,1321,6522,1513,9356,384,1179,1563
2018-08-24,12,5704,6351,2544,12443,14700,2780,86,30218,1320,6771,1588,9679,306,1234,1540
2018-08-24,13,5999,6603,2585,12433,15405,2851,92,30990,1315,6794,1601,9710,254,1366,1620
2018-08-24,14,6260,6826,2631,12823,16372,2949,95,32448,1312,6772,1591,9675,237,1603,1840
2018-08-24,15,6494,7006,2678,13355,17141,3068,98,33869,1314,6654,1581,9549,297,1963,2260
2018-08-24,16,6618,7141,2711,13940,17848,3184,100,35279,1300,6235,1513,9048,403,2210,2613
2018-08-24,17,6598,7114,2771,14460,18199,3279,101,36245,1223,5571,1356,8150,561,2442,3003
2018-08-24,18,6553,7034,2723,14848,17986,3326,99,36465,1031,4067,1010,6108,695,2528,3223
2018-08-24,19,6348,6750,2632,14914,17356,3240,94,35810,462,1392,411,2265,769,2538,3307
2018-08-24,20,6176,6564,2544,14724,16724,3190,89,34932,31,68,29,128,840,2544,3384
2018-08-24,21,5971,6331,2531,14569,16386,3179,83,34423,0,0,0,0,880,2527,3407
2018-08-24,22,5632,5887,2395,13925,15447,3025,76,32680,0,0,0,0,906,2486,3392
2018-08-24,23,5239,5446,2238,12922,14151,2785,69,30134,0,0,0,0,915,2437,3352
2018-08-24,24,4875,5059,2065,11924,12883,2544,62,27621,0,0,0,0,916,2378,3294
2018-08-25,1,4733,4779,1849,11486,11832,2440,56,26024,0,0,0,0,875,2113,2988
2018-08-25,2,4444,4612,1757,10925,11093,2315,52,24595,0,0,0,0,847,2041,2888
2018-08-25,3,4238,4511,1703,10620,10574,2205,51,23659,0,0,0,0,804,1929,2733
2018-08-25,4,4096,4463,1682,10423,10266,2146,50,23095,0,0,0,0,751,1803,2554
2018-08-25,5,4011,4512,1697,10479,10190,2135,49,23063,0,0,0,0,718,1665,2383
2018-08-25,6,3984,4615,1762,10654,10293,2174,51,23381,0,0,0,0,639,1494,2133
2018-08-25,7,3923,4673,1846,11069,10268,2224,51,23821,13,162,12,187,549,1277,1826
2018-08-25,8,4051,4873,1927,11250,10391,2260,54,24162,402,2108,362,2872,476,1075,1551
2018-08-25,9,4371,5132,2042,11263,10866,2300,59,24695,1020,4892,1011,6923,406,804,1210
2018-08-25,10,4742,5385,2150,11289,11435,2323,65,25320,1239,5979,1360,8578,319,530,849
2018-08-25,11,5123,5641,2218,11302,12086,2347,73,26015,1324,6500,1529,9353,226,355,581
2018-08-25,12,5514,5889,2226,11266,12691,2375,80,26620,1324,6740,1603,9667,192,348,540
2018-08-25,13,5865,6108,2234,11389,13401,2430,86,27513,1318,6799,1611,9728,164,425,589
2018-08-25,14,6214,6304,2254,11707,14274,2509,91,28788,1316,6773,1605,9694,175,564,739
2018-08-25,15,6530,6490,2284,12261,15084,2611,95,30258,1314,6685,1597,9596,246,817,1063
2018-08-25,16,6785,6679,2345,12972,15796,2744,98,31817,1298,6481,1531,9310,368,1128,1496
2018-08-25,17,6930,6793,2393,13666,16256,2872,101,33103,1218,5846,1369,8433,523,1475,1998
2018-08-25,18,6935,6706,2405,14272,16229,2982,99,33789,1006,4301,1017,6324,639,1618,2257
2018-08-25,19,6696,6487,2376,14486,15776,2996,94,33559,444,1460,399,2303,785,1717,2502
2018-08-25,20,6433,6343,2326,14356,15235,2996,87,32882,28,92,26,146,893,1875,2768
2018-08-25,21,6173,6093,2327,14168,14950,2999,81,32405,0,0,0,0,946,1934,2880
2018-08-25,22,5757,5681,2202,13529,14159,2866,73,30834,0,0,0,0,985,1947,2932
2018-08-25,23,5329,5291,2030,12570,13135,2654,66,28634,0,0,0,0,1009,1920,2929
2018-08-25,24,4959,4941,1873,11623,12128,2443,60,26462,0,0,0,0,1019,1851,2870
2018-08-26,1,4707,4721,1745,11033,11638,2328,55,25265,0,0,0,0,988,1985,2973
2018-08-26,2,4451,4552,1662,10501,10936,2197,52,23896,0,0,0,0,970,1902,2872
2018-08-26,3,4256,4440,1610,10168,10407,2126,50,22961,0,0,0,0,913,1828,2741
2018-08-26,4,4116,4390,1590,9972,10033,2077,49,22342,0,0,0,0,872,1743,2615
2018-08-26,5,4018,4380,1603,9947,9864,2064,49,22134,0,0,0,0,830,1663,2493
2018-08-26,6,3974,4435,1648,10117,9874,2120,50,22372,0,0,0,0,791,1570,2361
2018-08-26,7,3876,4485,1691,10355,9779,2211,51,22604,12,158,11,181,734,1447,2181
2018-08-26,8,3987,4694,1766,10470,9759,2268,54,22753,411,2084,366,2861,678,1309,1987
2018-08-26,9,4319,4889,1893,10591,10110,2337,59,23297,1034,4849,1023,6906,589,1138,1727
2018-08-26,10,4690,5173,2027,10572,10515,2371,65,23729,1261,6060,1371,8692,485,932,1417
2018-08-26,11,5067,5426,2090,10563,11247,2376,71,24459,1323,6601,1537,9461,373,768,1141
2018-08-26,12,5451,5742,2107,10666,12034,2300,79,25288,1322,6858,1606,9786,362,898,1260
2018-08-26,13,5809,5963,2129,10704,12820,2320,85,26137,1314,6889,1612,9815,375,1113,1488
2018-08-26,14,6142,6203,2152,11212,13538,2412,90,27462,1312,6874,1606,9792,410,1438,1848
2018-08-26,15,6458,6416,2184,11799,14207,2529,95,28840,1310,6783,1601,9694,510,1781,2291
2018-08-26,16,6709,6604,2236,12416,14976,2696,98,30395,1292,6442,1545,9279,632,2094,2726
2018-08-26,17,6797,6710,2333,13079,15663,2836,101,31888,1218,5792,1387,8397,761,2343,3104
2018-08-26,18,6767,6595,2346,13778,15699,2942,101,32729,1016,4252,1039,6307,843,2441,3284
2018-08-26,19,6538,6360,2339,14172,15390,2974,97,32842,436,1417,411,2264,891,2463,3354
2018-08-26,20,6322,6266,2307,14152,15000,3020,91,32471,27,91,25,143,940,2482,3422
2018-08-26,21,6103,6043,2325,14078,14746,3018,83,32134,0,0,0,0,1002,2501,3503
2018-08-26,22,5710,5637,2187,13345,13903,2845,75,30376,0,0,0,0,1044,2499,3543
2018-08-26,23,5267,5211,1995,12291,12709,2596,66,27870,0,0,0,0,1074,2445,3519
2018-08-26,24,4873,4857,1834,11307,11738,2366,59,25679,0,0,0,0,1073,2379,3452
2018-08-27,1,4543,4467,1737,11470,10897,2349,54,24981,0,0,0,0,1037,2425,3462
2018-08-27,2,4283,4330,1670,10936,10334,2208,52,23740,0,0,0,0,1007,2359,3366
2018-08-27,3,4104,4266,1635,10570,9987,2115,50,22933,0,0,0,0,967,2297,3264
2018-08-27,4,3976,4310,1635,10354,9835,2069,49,22517,0,0,0,0,920,2270,3190
2018-08-27,5,3955,4489,1703,10500,10061,2099,51,22921,0,0,0,0,873,2226,3099
2018-08-27,6,4039,4824,1891,10886,10739,2220,54,24109,0,0,0,0,777,2124,2901
2018-08-27,7,4104,5047,2149,11801,11505,2403,56,25974,10,157,11,178,696,2037,2733
2018-08-27,8,4256,5240,2293,12365,12058,2525,60,27217,409,2140,367,2916,621,1893,2514
2018-08-27,9,4540,5434,2327,12576,12558,2588,65,27998,1034,4902,1026,6962,536,1776,2312
2018-08-27,10,4879,5633,2391,12626,13007,2626,70,28542,1256,6123,1370,8749,429,1642,2071
2018-08-27,11,5211,5798,2435,12472,13518,2634,77,28911,1311,6646,1540,9497,312,1558,1870
2018-08-27,12,5544,5931,2462,12481,14068,2665,85,29509,1312,6901,1606,9819,262,1735,1997
2018-08-27,13,5844,6051,2510,12582,14588,2748,91,30219,1306,6926,1610,9842,225,1963,2188
2018-08-27,14,6124,6168,2557,12787,15415,2859,95,31366,1304,6916,1604,9824,220,2255,2475
2018-08-27,15,6346,6250,2600,13309,16106,2973,99,32696,1294,6827,1599,9720,287,2496,2783
2018-08-27,16,6539,6325,2645,14002,16692,3095,102,34100,1285,6454,1545,9284,352,2636,2988
2018-08-27,17,6589,6319,2699,14560,17143,3209,101,35223,1217,5753,1382,8352,449,2728,3177
2018-08-27,18,6506,6167,2715,15012,16941,3265,101,35527,1011,4182,1033,6226,567,2677,3244
2018-08-27,19,6352,5952,2677,15210,16440,3210,97,35164,426,1330,410,2166,693,2536,3229
2018-08-27,20,6199,5908,2623,15088,16062,3194,91,34643,25,62,26,113,799,2421,3220
2018-08-27,21,5963,5715,2605,14867,15716,3185,84,34060,0,0,0,0,887,2398,3285
2018-08-27,22,5568,5311,2427,14005,14681,2991,76,31962,0,0,0,0,972,2348,3320
2018-08-27,23,5098,4931,2188,12845,13282,2709,67,29113,0,0,0,0,1033,2305,3338
2018-08-27,24,4703,4664,2003,11808,12236,2444,60,26758,0,0,0,0,1061,2261,3322
2018-08-28,1,4434,4509,1881,10951,11322,2268,56,24806,0,0,0,0,1029,2319,3348
2018-08-28,2,4187,4386,1801,10472,10723,2152,53,23610,0,0,0,0,1033,2269,3302
2018-08-28,3,4006,4332,1758,10156,10337,2074,52,22828,0,0,0,0,1019,2192,3211
2018-08-28,4,3893,4358,1748,10043,10179,2043,50,22526,0,0,0,0,994,2129,3123
2018-08-28,5,3876,4524,1803,10202,10341,2081,51,22885,0,0,0,0,969,2060,3029
2018-08-28,6,3957,4851,1989,10763,10967,2210,54,24205,0,0,0,0,928,1916,2844
2018-08-28,7,4030,5060,2252,11648,11728,2406,56,26047,10,138,10,158,879,1775,2654
2018-08-28,8,4167,5219,2387,12228,12289,2511,59,27298,421,2026,367,2814,811,1582,2393
2018-08-28,9,4449,5349,2394,12392,12706,2565,64,27940,1054,4757,1024,6835,728,1318,2046
2018-08-28,10,4764,5508,2443,12371,13180,2619,70,28453,1269,6011,1369,8649,601,1041,1642
2018-08-28,11,5103,5662,2466,12351,13702,2652,77,28994,1326,6577,1538,9441,446,839,1285
2018-08-28,12,5452,5775,2503,12349,14267,2686,84,29599,1326,6825,1609,9760,398,856,1254
2018-08-28,13,5776,5900,2559,12456,14783,2759,90,30300,1312,6882,1609,9803,381,934,1315
2018-08-28,14,6076,6054,2615,12882,15741,2855,94,31783,1312,6857,1600,9769,396,1099,1495
2018-08-28,15,6358,6199,2682,13296,16461,2974,97,33039,1301,6745,1595,9641,478,1400,1878
2018-08-28,16,6570,6347,2748,13875,17170,3100,100,34455,1292,6370,1532,9194,586,1656,2242
2018-08-28,17,6619,6398,2800,14510,17408,3207,101,35435,1222,5702,1373,8297,714,1924,2638
2018-08-28,18,6558,6382,2827,14941,17278,3252,100,35778,1011,4151,1016,6178,846,1998,2844
2018-08-28,19,6419,6155,2798,15134,16687,3187,95,35312,421,1322,401,2144,926,1995,2921
2018-08-28,20,6264,6083,2725,15092,16357,3212,90,34960,27,75,27,129,1013,2011,3024
2018-08-28,21,6038,5869,2686,14926,16072,3188,84,34479,0,0,0,0,1066,2017,3083
2018-08-28,22,5648,5418,2493,14091,15013,2984,76,32372,0,0,0,0,1093,1992,3085
2018-08-28,23,5180,5018,2242,12902,13635,2695,68,29509,0,0,0,0,1095,1898,2993
2018-08-28,24,4762,4729,2040,11825,12390,2444,61,26930,0,0,0,0,1050,1778,2828
2018-08-29,1,4410,4594,1953,10951,11413,2311,55,24941,0,0,0,0,964,1883,2847
2018-08-29,2,4162,4484,1868,10484,10821,2181,53,23749,0,0,0,0,922,1684,2606
2018-08-29,3,3968,4432,1810,10171,10442,2098,51,22971,0,0,0,0,911,1560,2471
2018-08-29,4,3856,4462,1784,10055,10258,2057,50,22630,0,0,0,0,882,1463,2345
2018-08-29,5,3836,4626,1822,10227,10418,2089,51,22994,0,0,0,0,841,1367,2208
2018-08-29,6,3914,4951,1991,10774,11075,2231,55,24343,0,0,0,0,784,1252,2036
2018-08-29,7,3980,5160,2235,11647,11840,2433,57,26186,8,130,8,146,731,1132,1863
2018-08-29,8,4149,5320,2364,12183,12332,2562,61,27347,379,1944,315,2638,686,988,1674
2018-08-29,9,4438,5471,2415,12314,12781,2637,65,28009,1043,4622,943,6608,662,793,1455
2018-08-29,10,4783,5653,2481,12291,13353,2716,70,28642,1256,5921,1313,8490,594,597,1191
2018-08-29,11,5160,5845,2527,12255,14000,2786,77,29329,1322,6522,1491,9335,502,500,1002
2018-08-29,12,5537,6037,2576,12269,14554,2862,84,29982,1307,6755,1584,9646,453,599,1052
2018-08-29,13,5886,6265,2665,12364,15341,2966,91,30974,1290,6803,1593,9686,430,784,1214
2018-08-29,14,6211,6494,2756,12770,16267,3073,95,32416,1290,6726,1582,9598,458,1050,1508
2018-08-29,15,6519,6708,2849,13284,17047,3200,98,33839,1274,6603,1577,9454,533,1324,1857
2018-08-29,16,6753,6903,2925,13848,17733,3331,100,35222,1266,6311,1504,9081,624,1576,2200
2018-08-29,17,6797,6973,2965,14451,18172,3449,102,36382,1190,5611,1339,8140,740,1779,2519
2018-08-29,18,6743,6896,2957,14896,17935,3488,100,36629,965,4054,967,5986,845,1806,2651
2018-08-29,19,6590,6673,2904,15080,17269,3402,96,36055,374,1262,365,2001,899,1739,2638
2018-08-29,20,6421,6540,2824,15046,16796,3406,90,35546,22,74,23,119,937,1730,2667
2018-08-29,21,6184,6260,2759,14872,16538,3352,84,35055,0,0,0,0,950,1757,2707
2018-08-29,22,5772,5742,2575,14023,15449,3131,76,32888,0,0,0,0,969,1749,2718
2018-08-29,23,5294,5276,2321,12860,14010,2817,68,29963,0,0,0,0,956,1759,2715
2018-08-29,24,4871,4910,2106,11787,12737,2541,61,27335,0,0,0,0,914,1759,2673
2018-08-30,1,4465,4669,1966,11116,11761,2372,55,25512,0,0,0,0,780,1731,2511
2018-08-30,2,4221,4544,1871,10603,11072,2241,52,24179,0,0,0,0,680,1678,2358
2018-08-30,3,4044,4481,1810,10257,10611,2145,51,23273,0,0,0,0,594,1633,2227
2018-08-30,4,3933,4514,1781,10130,10370,2104,50,22863,0,0,0,0,552,1596,2148
2018-08-30,5,3906,4682,1818,10293,10468,2139,51,23160,0,0,0,0,457,1532,1989
2018-08-30,6,4004,5016,1974,10827,11062,2268,54,24420,0,0,0,0,387,1466,1853
2018-08-30,7,4084,5219,2192,11776,11832,2466,56,26339,7,130,7,144,319,1413,1732
2018-08-30,8,4244,5395,2329,12367,12318,2588,59,27541,350,1981,333,2664,256,1333,1589
2018-08-30,9,4515,5582,2400,12521,12813,2683,64,28290,985,4783,983,6751,235,1252,1487
2018-08-30,10,4832,5791,2477,12576,13349,2768,70,28971,1211,5935,1335,8481,214,1162,1376
2018-08-30,11,5179,6006,2529,12531,14031,2841,77,29689,1276,6495,1523,9294,201,1124,1325
2018-08-30,12,5526,6230,2569,12439,14654,2921,84,30306,1281,6772,1585,9638,215,1306,1521
2018-08-30,13,5826,6474,2641,12348,15415,3032,90,31094,1267,6842,1588,9697,214,1538,1752
2018-08-30,14,6113,6716,2712,12665,16476,3153,94,32596,1271,6819,1580,9670,225,1797,2022
2018-08-30,15,6357,6917,2770,13041,17294,3285,97,33925,1261,6708,1570,9539,254,2023,2277
2018-08-30,16,6541,7109,2824,13561,17997,3423,99,35288,1242,6353,1505,9100,301,2229,2530
2018-08-30,17,6541,7105,2846,14165,18362,3529,100,36364,1171,5669,1328,8168,397,2411,2808
2018-08-30,18,6471,7001,2809,14520,18059,3565,98,36450,944,4000,964,5908,516,2493,3009
2018-08-30,19,6287,6726,2744,14873,17427,3468,93,36071,355,1190,360,1905,598,2496,3094
2018-08-30,20,6136,6605,2687,14915,16958,3464,88,35634,20,63,20,103,680,2501,3181
2018-08-30,21,5934,6317,2665,14818,16658,3408,82,35175,0,0,0,0,758,2549,3307
2018-08-30,22,5553,5791,2498,14063,15565,3184,74,33094,0,0,0,0,793,2567,3360
2018-08-30,23,5119,5309,2279,12879,14103,2859,66,30117,0,0,0,0,826,2531,3357
2018-08-30,24,4722,4927,2088,11880,12734,2578,60,27461,0,0,0,0,797,2536,3333
2018-08-31,1,4418,4704,1900,11150,11887,2408,56,25709,0,0,0,0,879,2532,3411
2018-08-31,2,4196,4552,1809,10644,11217,2278,53,24401,0,0,0,0,859,2519,3378
2018-08-31,3,4010,4472,1750,10311,10783,2185,51,23539,0,0,0,0,818,2497,3315
2018-08-31,4,3909,4492,1727,10171,10555,2132,50,23117,0,0,0,0,780,2452,3232
2018-08-31,5,3894,4642,1767,10306,10639,2164,51,23368,0,0,0,0,741,2384,3125
2018-08-31,6,3974,4950,1925,10808,11152,2277,54,24499,0,0,0,0,701,2298,2999
2018-08-31,7,4052,5152,2157,11662,11848,2463,56,26237,7,127,7,141,650,2180,2830
2018-08-31,8,4207,5336,2301,12245,12319,2587,59,27419,351,2084,328,2763,584,2009,2593
2018-08-31,9,4485,5556,2339,12400,12852,2700,64,28226,997,4980,992,6969,476,1838,2314
2018-08-31,10,4796,5772,2410,12390,13482,2802,70,28951,1227,6049,1360,8636,309,1634,1943
2018-08-31,11,5104,5966,2452,12365,14235,2878,76,29764,1296,6604,1528,9428,189,1407,1596
2018-08-31,12,5440,6151,2473,12386,14839,2937,83,30454,1298,6860,1591,9749,136,1484,1620
2018-08-31,13,5752,6342,2502,12471,15660,3042,89,31470,1279,6883,1595,9757,109,1632,1741
2018-08-31,14,6030,6523,2539,12958,16671,3162,93,33091,1278,6856,1589,9723,114,1869,1983
2018-08-31,15,6300,6687,2579,13558,17473,3306,97,34641,1265,6753,1580,9598,198,2214,2412
2018-08-31,16,6472,6784,2621,14189,18148,3440,99,36083,1249,6391,1531,9171,347,2538,2885
2018-08-31,17,6466,6808,2664,14810,18450,3534,100,37102,1166,5728,1352,8246,560,2865,3425
2018-08-31,18,6403,6630,2667,15203,18288,3561,98,37359,917,4080,963,5960,678,2976,3654
2018-08-31,19,6218,6345,2586,15326,17509,3445,93,36582,326,1190,343,1859,762,3038,3800
2018-08-31,20,6054,6240,2527,15198,17007,3418,88,35920,14,50,13,77,882,3091,3973
2018-08-31,21,5828,6009,2489,14883,16570,3354,82,35096,0,0,0,0,906,3117,4023
2018-08-31,22,5464,5584,2340,14112,15549,3157,75,33101,0,0,0,0,920,3107,4027
2018-08-31,23,5054,5187,2160,13007,14224,2892,67,30397,0,0,0,0,927,3051,3978
2018-08-31,24,4688,4845,1996,12035,13051,2636,60,27990,0,0,0,0,928,2998,3926
2018-09-01,1,4369,4640,1837,11207,11894,2330,53,25694,0,0,0,0,945,3059,4004
2018-09-01,2,4112,4491,1752,10625,11215,2188,49,24286,0,0,0,0,893,2988,3881
2018-09-01,3,3929,4401,1691,10242,10693,2107,48,23298,0,0,0,0,819,2878,3697
2018-09-01,4,3784,4368,1666,10050,10377,2056,47,22738,0,0,0,0,793,2716,3509
2018-09-01,5,3724,4401,1677,10017,10346,2050,47,22668,0,0,0,0,768,2529,3297
2018-09-01,6,3723,4536,1735,10182,10414,2086,47,22937,0,0,0,0,782,2339,3121
2018-09-01,7,3656,4625,1819,10456,10459,2143,47,23313,6,118,6,130,774,2094,2868
2018-09-01,8,3769,4789,1900,10612,10563,2203,49,23634,341,2037,333,2711,749,1760,2509
2018-09-01,9,4073,5041,2025,10862,11079,2318,54,24521,987,4853,997,6837,680,1336,2016
2018-09-01,10,4433,5250,2140,10992,11698,2396,59,25354,1231,6049,1369,8649,552,916,1468
2018-09-01,11,4802,5410,2194,11106,12334,2456,66,26170,1295,6613,1532,9440,417,615,1032
2018-09-01,12,5170,5574,2224,11202,12848,2522,73,26853,1312,6847,1598,9757,383,574,957
2018-09-01,13,5516,5770,2243,11463,13536,2602,80,27889,1304,6865,1599,9768,407,639,1046
2018-09-01,14,5873,5969,2275,11922,14333,2678,86,29227,1299,6839,1595,9733,459,826,1285
2018-09-01,15,6200,6174,2326,12462,15024,2783,90,30568,1296,6720,1587,9603,568,1172,1740
2018-09-01,16,6467,6334,2391,13134,15706,2922,94,32063,1284,6349,1539,9172,677,1623,2300
2018-09-01,17,6625,6482,2469,13756,16149,3043,95,33252,1219,5682,1361,8262,791,2076,2867
2018-09-01,18,6576,6380,2487,14317,16140,3116,95,33875,981,4032,976,5989,852,2390,3242
2018-09-01,19,6311,6124,2452,14501,15606,3081,89,33486,366,1179,340,1885,887,2544,3431
2018-09-01,20,6132,6111,2392,14476,15306,3145,84,33218,13,51,11,75,938,2629,3567
2018-09-01,21,5864,5842,2380,14325,15059,3083,77,32752,0,0,0,0,996,2591,3587
2018-09-01,22,5506,5446,2215,13622,14285,2937,71,31123,0,0,0,0,1031,2447,3478
2018-09-01,23,5133,5085,2035,12644,13306,2722,64,28945,0,0,0,0,1043,2256,3299
2018-09-01,24,4753,4755,1874,11722,12354,2491,59,26834,0,0,0,0,1060,2084,3144
2018-09-02,1,4416,4528,1786,10977,11244,2243,52,24725,0,0,0,0,1100,1906,3006
2018-09-02,2,4171,4386,1703,10418,10619,2114,49,23410,0,0,0,0,1091,1708,2799
2018-09-02,3,3966,4310,1640,10036,10151,2037,48,22480,0,0,0,0,996,1413,2409
2018-09-02,4,3842,4274,1612,9823,9869,1998,47,21947,0,0,0,0,891,1166,2057
2018-09-02,5,3771,4293,1617,9756,9784,1985,47,21782,0,0,0,0,801,920,1721
2018-09-02,6,3754,4409,1656,9843,9847,2014,48,21962,0,0,0,0,710,694,1404
2018-09-02,7,3644,4481,1715,9989,9812,2041,48,22099,6,118,7,131,631,523,1154
2018-09-02,8,3744,4656,1789,9964,9797,2079,51,22099,361,2038,347,2746,549,388,937
2018-09-02,9,4079,4863,1933,10161,10185,2167,56,22778,1044,4912,1025,6981,480,255,735
2018-09-02,10,4456,5064,2073,10234,10682,2207,61,23394,1271,6112,1392,8775,382,237,619
2018-09-02,11,4873,5198,2103,10344,11227,2238,67,24086,1333,6636,1556,9525,299,250,549
2018-09-02,12,5283,5451,2138,10592,11827,2281,74,24984,1337,6875,1610,9822,246,264,510
2018-09-02,13,5646,5663,2192,10991,12494,2337,81,26113,1323,6866,1608,9797,230,266,496
2018-09-02,14,5977,5937,2268,11600,13390,2414,88,27701,1313,6820,1604,9737,239,261,500
2018-09-02,15,6273,6186,2347,12306,14066,2524,92,29197,1313,6701,1598,9612,320,250,570
2018-09-02,16,6507,6393,2433,13145,14693,2657,95,30791,1308,6408,1555,9271,421,281,702
2018-09-02,17,6649,6569,2530,13883,15177,2782,97,32141,1239,5789,1381,8409,573,320,893
2018-09-02,18,6582,6477,2592,14560,15321,2875,95,33057,983,4115,995,6093,684,333,1017
2018-09-02,19,6346,6246,2570,14869,15032,2892,91,33093,344,1138,339,1821,816,567,1383
2018-09-02,20,6211,6200,2537,14841,14888,2998,86,33022,11,52,11,74,908,1030,1938
2018-09-02,21,5953,5927,2510,14676,14682,2954,79,32599,0,0,0,0,936,1209,2145
2018-09-02,22,5589,5494,2323,13759,13925,2775,72,30738,0,0,0,0,964,1214,2178
2018-09-02,23,5184,5071,2095,12528,12906,2544,65,28251,0,0,0,0,996,1213,2209
2018-09-02,24,4795,4757,1890,11474,11835,2331,58,25906,0,0,0,0,991,1039,2030
2018-09-03,1,4572,4573,1729,10722,11153,2226,54,24364,0,0,0,0,997,1092,2089
2018-09-03,2,4313,4451,1648,10182,10578,2113,51,23133,0,0,0,0,988,984,1972
2018-09-03,3,4107,4372,1589,9851,10168,2042,49,22320,0,0,0,0,917,753,1670
2018-09-03,4,3964,4352,1566,9665,9950,1999,48,21872,0,0,0,0,843,561,1404
2018-09-03,5,3919,4402,1567,9670,9934,2010,48,21872,0,0,0,0,763,416,1179
2018-09-03,6,3904,4489,1617,9908,10070,2059,50,22296,0,0,0,0,672,292,964
2018-09-03,7,3817,4516,1666,10223,10140,2116,50,22738,5,114,6,125,569,221,790
2018-09-03,8,3947,4701,1731,10300,10113,2112,53,22787,351,1983,346,2680,462,188,650
2018-09-03,9,4238,4995,1908,10449,10506,2142,58,23367,1028,4800,1018,6846,356,165,521
2018-09-03,10,4614,5212,2044,10698,11143,2185,65,24303,1217,6005,1380,8602,266,204,470
2018-09-03,11,5034,5387,2100,10949,11816,2234,72,25282,1284,6559,1543,9386,191,232,423
2018-09-03,12,5420,5661,2167,11254,12439,2294,79,26279,1293,6785,1599,9677,156,262,418
2018-09-03,13,5743,5919,2262,11629,13336,2351,86,27613,1286,6742,1599,9627,140,279,419
2018-09-03,14,6055,6165,2347,12229,14395,2404,92,29330,1278,6668,1596,9542,131,272,403
2018-09-03,15,6341,6414,2431,13002,15272,2519,96,31100,1278,6510,1590,9378,198,246,444
2018-09-03,16,6545,6645,2520,13950,15900,2662,98,32820,1300,6228,1552,9080,327,247,574
2018-09-03,17,6640,6791,2605,14755,16326,2789,100,34180,1232,5571,1378,8181,499,233,732
2018-09-03,18,6656,6812,2626,15360,16425,2881,98,34974,975,3930,989,5894,679,321,1000
2018-09-03,19,6442,6585,2576,15539,15935,2879,92,34656,318,1080,331,1729,807,765,1572
2018-09-03,20,6325,6518,2536,15433,15522,2984,85,34234,10,52,10,72,912,1204,2116
2018-09-03,21,6113,6213,2507,15231,15343,2979,80,33842,0,0,0,0,933,1289,2222
2018-09-03,22,5715,5695,2329,14156,14432,2782,72,31652,0,0,0,0,972,1358,2330
2018-09-03,23,5246,5204,2096,12794,13143,2527,64,28738,0,0,0,0,1004,1414,2418
2018-09-03,24,4818,4858,1905,11741,12159,2313,58,26480,0,0,0,0,1006,1245,2251
2018-09-04,1,4392,4595,1791,11286,11418,2230,57,25201,0,0,0,0,1008,1041,2049
2018-09-04,2,4149,4468,1718,10799,11007,2143,55,24214,0,0,0,0,998,892,1890
2018-09-04,3,3976,4403,1659,10440,10632,2072,53,23406,0,0,0,0,956,707,1663
2018-09-04,4,3859,4419,1636,10280,10470,2042,52,23053,0,0,0,0,885,532,1417
2018-09-04,5,3829,4590,1675,10423,10656,2077,53,23418,0,0,0,0,807,400,1207
2018-09-04,6,3917,4933,1836,10996,11276,2210,56,24746,0,0,0,0,725,298,1023
2018-09-04,7,3997,5175,2095,11984,12070,2450,58,26771,4,104,6,114,616,223,839
2018-09-04,8,4157,5334,2216,12488,12554,2553,61,27865,345,1974,343,2662,497,209,706
2018-09-04,9,4441,5509,2272,12541,12930,2595,65,28341,1019,4848,1022,6889,413,194,607
2018-09-04,10,4736,5690,2328,12496,13306,2619,70,28702,1266,6007,1389,8662,308,244,552
2018-09-04,11,5060,5854,2352,12517,13774,2633,76,29211,1325,6491,1552,9368,212,267,479
2018-09-04,12,5380,6021,2395,12669,14304,2643,83,29911,1329,6682,1607,9618,179,306,485
2018-09-04,13,5688,6229,2475,12976,14819,2678,89,30773,1319,6617,1605,9541,167,329,496
2018-09-04,14,5981,6443,2554,13583,15529,2743,93,32160,1309,6553,1602,9464,166,318,484
2018-09-04,15,6261,6629,2621,14196,16148,2839,97,33490,1310,6397,1594,9301,246,278,524
2018-09-04,16,6427,6768,2678,14935,16633,2925,98,34801,1305,6080,1551,8936,368,274,642
2018-09-04,17,6459,6842,2746,15607,16919,3020,99,35854,1237,5453,1377,8067,505,249,754
2018-09-04,18,6376,6675,2730,15989,16665,3059,96,36018,979,3792,985,5756,557,274,831
2018-09-04,19,6183,6440,2693,16120,16107,3018,90,35544,333,1011,327,1671,615,380,995
2018-09-04,20,6114,6379,2641,16091,16069,3132,86,35588,10,51,9,70,677,836,1513
2018-09-04,21,5857,6081,2590,15751,15648,3073,80,34761,0,0,0,0,766,917,1683
2018-09-04,22,5490,5587,2376,14670,14671,2871,72,32494,0,0,0,0,862,956,1818
2018-09-04,23,5061,5134,2126,13340,13406,2597,65,29618,0,0,0,0,939,848,1787
2018-09-04,24,4670,4807,1933,12225,12209,2363,60,27066,0,0,0,0,938,739,1677
2018-09-05,1,4364,4602,1904,11430,11420,2232,57,25349,0,0,0,0,882,761,1643
2018-09-05,2,4137,4486,1825,10916,10890,2130,54,24202,0,0,0,0,859,616,1475
2018-09-05,3,3963,4418,1763,10530,10473,2061,53,23328,0,0,0,0,805,479,1284
2018-09-05,4,3848,4429,1738,10362,10278,2034,52,22937,0,0,0,0,749,359,1108
2018-09-05,5,3818,4597,1774,10503,10452,2071,53,23289,0,0,0,0,687,268,955
2018-09-05,6,3905,4929,1939,11057,11046,2212,55,24581,0,0,0,0,626,182,808
2018-09-05,7,3984,5173,2192,12047,11854,2441,58,26609,4,104,5,113,576,144,720
2018-09-05,8,4151,5332,2319,12649,12485,2544,61,27949,351,1966,339,2656,498,135,633
2018-09-05,9,4435,5507,2377,12851,12922,2592,65,28640,1032,4842,1017,6891,409,125,534
2018-09-05,10,4755,5689,2441,13009,13406,2624,71,29320,1244,6040,1376,8660,346,163,509
2018-09-05,11,5096,5855,2485,13052,13946,2641,77,29927,1306,6569,1540,9415,277,166,443
2018-09-05,12,5431,6024,2545,13110,14470,2649,84,30523,1312,6776,1592,9680,266,202,468
2018-09-05,13,5762,6230,2631,13377,15044,2686,90,31408,1284,6695,1586,9565,285,224,509
2018-09-05,14,6087,6458,2725,14009,15752,2750,95,32816,1276,6627,1582,9485,306,215,521
2018-09-05,15,6397,6643,2811,14605,16331,2840,98,34085,1276,6473,1575,9324,389,190,579
2018-09-05,16,6622,6789,2880,15348,16834,2926,101,35416,1268,6170,1526,8964,546,204,750
2018-09-05,17,6688,6894,2948,16015,17128,3012,102,36467,1195,5525,1351,8071,699,197,896
2018-09-05,18,6644,6715,2947,16407,16924,3049,99,36689,931,3851,956,5738,730,295,1025
2018-09-05,19,6428,6483,2899,16486,16353,2999,93,36141,307,1007,320,1634,779,647,1426
2018-09-05,20,6345,6410,2841,16394,16320,3122,88,36134,8,35,8,51,793,1125,1918
2018-09-05,21,6066,6119,2773,15990,15900,3057,82,35237,0,0,0,0,826,1321,2147
2018-09-05,22,5681,5638,2545,14912,14865,2857,74,32918,0,0,0,0,873,1300,2173
2018-09-05,23,5240,5186,2285,13517,13496,2590,67,29879,0,0,0,0,921,1268,2189
2018-09-05,24,4817,4845,2069,12340,12249,2353,61,27213,0,0,0,0,946,1073,2019
2018-09-06,1,4493,4706,1960,11319,11645,2269,58,25503,0,0,0,0,871,1243,2114
2018-09-06,2,4254,4576,1875,10803,10965,2170,55,24205,0,0,0,0,870,1124,1994
2018-09-06,3,4069,4502,1811,10429,10468,2090,53,23252,0,0,0,0,826,967,1793
2018-09-06,4,3935,4515,1783,10268,10244,2050,52,22825,0,0,0,0,752,789,1541
2018-09-06,5,3898,4685,1817,10408,10407,2082,53,23162,0,0,0,0,700,640,1340
2018-09-06,6,3993,5027,1971,10938,11004,2219,56,24428,0,0,0,0,633,466,1099
2018-09-06,7,4080,5274,2211,11929,11813,2437,58,26448,4,109,5,118,586,331,917
2018-09-06,8,4239,5441,2333,12650,12340,2544,61,27805,346,2030,337,2713,519,208,727
2018-09-06,9,4541,5643,2413,12701,12770,2606,65,28353,1023,4937,1014,6974,434,86,520
2018-09-06,10,4878,5851,2488,12690,13231,2644,71,28848,1265,6075,1387,8727,308,90,398
2018-09-06,11,5234,6054,2541,12663,13851,2674,78,29478,1324,6551,1550,9425,201,103,304
2018-09-06,12,5589,6259,2617,12689,14480,2697,85,30163,1329,6740,1605,9674,151,125,276
2018-09-06,13,5931,6499,2715,12874,15155,2750,91,31082,1318,6849,1605,9772,149,130,279
2018-09-06,14,6278,6730,2818,13424,16006,2834,96,32572,1309,6753,1602,9664,161,122,283
2018-09-06,15,6584,6926,2901,14111,16790,2940,100,34152,1311,6608,1594,9513,210,129,339
2018-09-06,16,6811,7059,2969,14870,17644,3042,102,35869,1307,6299,1546,9152,256,195,451
2018-09-06,17,6884,7136,3044,15564,18038,3137,103,37052,1236,5646,1372,8254,359,461,820
2018-09-06,18,6779,6901,3016,16130,17881,3167,100,37489,974,3911,972,5857,459,983,1442
2018-09-06,19,6561,6687,2970,16211,17300,3105,94,36922,305,1017,318,1640,532,1419,1951
2018-09-06,20,6459,6570,2915,16015,16774,3216,90,36306,7,29,7,43,614,1719,2333
2018-09-06,21,6187,6247,2832,15715,16425,3147,83,35581,0,0,0,0,619,1754,2373
2018-09-06,22,5768,5769,2602,14685,15368,2937,75,33276,0,0,0,0,625,1848,2473
2018-09-06,23,5320,5311,2340,13320,13831,2659,68,30088,0,0,0,0,628,1799,2427
2018-09-06,24,4909,4950,2119,12168,12549,2416,62,27406,0,0,0,0,593,1759,2352
2018-09-07,1,4639,4818,1969,11395,12324,2282,58,26270,0,0,0,0,577,1428,2005
2018-09-07,2,4390,4668,1871,10843,11537,2174,55,24820,0,0,0,0,549,1298,1847
2018-09-07,3,4174,4581,1804,10476,10967,2097,53,23804,0,0,0,0,503,1105,1608
2018-09-07,4,4048,4582,1772,10317,10704,2062,52,23347,0,0,0,0,423,901,1324
2018-09-07,5,4024,4731,1798,10448,10730,2095,53,23536,0,0,0,0,373,729,1102
2018-09-07,6,4105,5042,1931,10968,11137,2224,55,24594,0,0,0,0,338,541,879
2018-09-07,7,4188,5288,2143,11906,11959,2442,57,26574,4,107,6,117,290,388,678
2018-09-07,8,4354,5488,2279,12463,12597,2565,60,27896,340,2100,341,2781,256,256,512
2018-09-07,9,4654,5733,2380,12551,13507,2633,64,28967,1027,5138,1028,7193,215,137,352
2018-09-07,10,5012,5965,2463,12560,14143,2695,69,29679,1265,6348,1402,9015,156,86,242
2018-09-07,11,5375,6191,2522,12674,15013,2756,76,30732,1325,6809,1561,9695,122,94,216
2018-09-07,12,5729,6408,2593,12922,15893,2810,84,31922,1335,6994,1612,9941,105,111,216
2018-09-07,13,6055,6649,2677,13272,16695,2891,91,33162,1317,7009,1607,9933,93,121,214
2018-09-07,14,6403,6888,2769,13970,17749,3002,96,35030,1308,6991,1607,9906,106,126,232
2018-09-07,15,6723,7077,2840,14691,18629,3118,100,36751,1310,6935,1597,9842,175,141,316
2018-09-07,16,6985,7176,2904,15419,19215,3225,102,38172,1306,6614,1550,9470,275,235,510
2018-09-07,17,7080,7238,2974,16120,19506,3321,103,39262,1236,5924,1367,8527,425,477,902
2018-09-07,18,6985,7017,2935,16487,19263,3338,101,39399,967,4057,952,5976,562,980,1542
2018-09-07,19,6715,6774,2864,16463,18410,3240,96,38419,326,1050,292,1668,667,1476,2143
2018-09-07,20,6564,6632,2787,16325,17528,3307,90,37460,7,31,7,45,789,1815,2604
2018-09-07,21,6234,6308,2703,15884,16938,3221,83,36335,0,0,0,0,822,1851,2673
2018-09-07,22,5828,5879,2500,14924,16006,3036,75,34250,0,0,0,0,847,1883,2730
2018-09-07,23,5430,5451,2282,13716,14682,2793,68,31468,0,0,0,0,863,1808,2671
2018-09-07,24,5011,5084,2073,12549,13478,2558,62,28856,0,0,0,0,889,1799,2688
2018-09-08,1,4613,4795,1849,11561,12830,2450,58,27110,0,0,0,0,912,1860,2772
2018-09-08,2,4339,4628,1749,10918,12027,2315,54,25524,0,0,0,0,864,1832,2696
2018-09-08,3,4129,4526,1678,10481,11419,2218,52,24381,0,0,0,0,800,1741,2541
2018-09-08,4,3978,4480,1641,10234,11024,2152,51,23672,0,0,0,0,752,1641,2393
2018-09-08,5,3899,4532,1633,10173,10904,2138,51,23477,0,0,0,0,723,1517,2240
2018-09-08,6,3894,4675,1686,10339,11032,2169,52,23802,0,0,0,0,671,1376,2047
2018-09-08,7,3852,4783,1772,10662,11083,2235,52,24241,4,105,6,115,612,1258,1870
2018-09-08,8,3957,4961,1877,10867,11334,2291,55,24757,338,2054,334,2726,554,1061,1615
2018-09-08,9,4297,5218,2023,11115,11989,2404,59,25778,1027,5078,1026,7131,455,831,1286
2018-09-08,10,4704,5453,2134,11235,12781,2507,66,26802,1267,6208,1393,8868,345,589,934
2018-09-08,11,5141,5705,2191,11404,13803,2610,74,28103,1328,6665,1555,9548,256,446,702
2018-09-08,12,5575,5957,2226,11662,14879,2731,83,29567,1340,6871,1611,9822,216,543,759
2018-09-08,13,5990,6181,2250,12040,15925,2880,92,31149,1321,6900,1603,9824,201,736,937
2018-09-08,14,6407,6404,2293,12612,16966,3013,100,32904,1310,6869,1604,9783,208,1015,1223
2018-09-08,15,6791,6604,2334,13283,17875,3167,105,34643,1309,6783,1596,9688,304,1466,1770
2018-09-08,16,7052,6785,2380,13968,18579,3341,110,36209,1305,6606,1544,9455,484,1934,2418
2018-09-08,17,7166,6892,2460,14649,19007,3478,111,37457,1233,5897,1358,8488,689,2275,2964
2018-09-08,18,7070,6730,2446,15116,18928,3535,108,37897,948,4013,925,5886,808,2427,3235
2018-09-08,19,6738,6516,2406,15236,18246,3476,101,37269,282,985,273,1540,873,2487,3360
2018-09-08,20,6508,6400,2381,15164,17814,3508,95,36790,5,27,4,36,922,2520,3442
2018-09-08,21,6139,6091,2340,14779,17030,3391,86,35495,0,0,0,0,948,2524,3472
2018-09-08,22,5702,5701,2174,13973,16096,3192,79,33547,0,0,0,0,959,2505,3464
2018-09-08,23,5272,5313,2009,12922,14902,2937,71,31041,0,0,0,0,957,2480,3437
2018-09-08,24,4881,4953,1851,11905,13653,2674,64,28506,0,0,0,0,960,2441,3401
2018-09-09,1,4608,4617,1728,11138,12109,2444,58,25959,0,0,0,0,921,2391,3312
2018-09-09,2,4343,4454,1643,10542,11364,2280,54,24451,0,0,0,0,892,2334,3226
2018-09-09,3,4143,4362,1585,10122,10826,2192,52,23404,0,0,0,0,861,2221,3082
2018-09-09,4,3993,4316,1566,9899,10479,2128,50,22768,0,0,0,0,803,2078,2881
2018-09-09,5,3911,4324,1573,9816,10310,2096,50,22483,0,0,0,0,738,1913,2651
2018-09-09,6,3867,4429,1618,9872,10305,2113,50,22552,0,0,0,0,682,1689,2371
2018-09-09,7,3792,4503,1700,10035,10256,2125,51,22679,4,97,5,106,638,1458,2096
2018-09-09,8,3842,4672,1787,10002,10175,2162,53,22602,320,1977,320,2617,576,1180,1756
2018-09-09,9,4167,4882,1905,10167,10685,2251,59,23371,1011,5016,995,7022,478,813,1291
2018-09-09,10,4542,5088,2022,10221,11418,2357,66,24273,1253,6285,1375,8913,355,544,899
2018-09-09,11,4956,5246,2068,10228,12451,2477,74,25440,1316,6761,1547,9624,246,409,655
2018-09-09,12,5381,5536,2082,10397,13616,2613,82,26918,1331,6963,1600,9894,219,500,719
2018-09-09,13,5773,5737,2105,10735,15008,2783,90,28829,1309,7012,1596,9917,229,675,904
2018-09-09,14,6139,5973,2137,11318,16574,2944,97,31144,1301,6988,1595,9884,274,976,1250
2018-09-09,15,6437,6190,2192,12009,17426,3116,102,32862,1303,6896,1588,9787,363,1352,1715
2018-09-09,16,6671,6353,2267,12839,18059,3307,105,34519,1293,6610,1534,9437,486,1776,2262
2018-09-09,17,6700,6484,2367,13554,18692,3460,107,36023,1220,5843,1349,8412,663,2071,2734
2018-09-09,18,6611,6369,2406,14190,18706,3577,105,36789,934,3913,920,5767,793,2150,2943
2018-09-09,19,6357,6195,2396,14466,18027,3564,98,36367,279,957,257,1493,875,2170,3045
2018-09-09,20,6221,6130,2388,14519,17807,3541,92,36169,4,23,3,30,967,2238,3205
2018-09-09,21,5917,5830,2376,14201,17008,3467,84,34969,0,0,0,0,1002,2279,3281
2018-09-09,22,5524,5439,2189,13315,15822,3257,76,32680,0,0,0,0,1030,2254,3284
2018-09-09,23,5138,5052,1982,12194,14142,2954,68,29568,0,0,0,0,1036,2234,3270
2018-09-09,24,4739,4755,1810,11248,12887,2652,61,27059,0,0,0,0,1038,2268,3306
2018-09-10,1,4312,4547,1681,10570,11773,2352,55,24960,0,0,0,0,1064,2481,3545
2018-09-10,2,4067,4439,1615,10102,11125,2231,52,23720,0,0,0,0,1051,2443,3494
2018-09-10,3,3898,4382,1578,9815,10716,2157,50,22950,0,0,0,0,987,2399,3386
2018-09-10,4,3789,4407,1580,9733,10502,2122,49,22618,0,0,0,0,912,2326,3238
2018-09-10,5,3789,4585,1649,9933,10676,2164,50,23035,0,0,0,0,860,2262,3122
2018-09-10,6,3887,4932,1840,10491,11335,2300,53,24391,0,0,0,0,794,2116,2910
2018-09-10,7,3984,5204,2125,11504,12219,2518,56,26508,4,93,5,102,734,1974,2708
2018-09-10,8,4090,5392,2276,12093,12626,2651,59,27638,321,1963,299,2583,624,1777,2401
2018-09-10,9,4387,5614,2294,12231,13288,2734,65,28527,1015,4992,981,6988,511,1618,2129
2018-09-10,10,4706,5822,2339,12192,13972,2802,72,29250,1256,6265,1354,8875,369,1416,1785
2018-09-10,11,5073,6011,2378,12180,14790,2855,80,30115,1312,6740,1526,9578,268,1239,1507
2018-09-10,12,5412,6224,2402,12270,15502,2919,87,30988,1320,6939,1581,9840,207,1408,1615
2018-09-10,13,5762,6453,2439,12477,16272,3002,93,32057,1304,6977,1573,9854,176,1642,1818
2018-09-10,14,6110,6681,2480,13052,17198,3087,99,33646,1295,6957,1572,9824,198,1944,2142
2018-09-10,15,6439,6872,2503,13649,17778,3186,104,34926,1301,6870,1569,9740,302,2236,2538
2018-09-10,16,6651,7012,2535,14375,18206,3278,107,36176,1291,6548,1513,9352,432,2493,2925
2018-09-10,17,6706,7071,2534,15014,18246,3362,108,36941,1217,5795,1328,8340,627,2683,3310
2018-09-10,18,6606,6945,2540,15433,17881,3394,106,37025,919,3857,889,5665,786,2718,3504
2018-09-10,19,6366,6766,2523,15587,17247,3332,99,36476,261,931,231,1423,879,2681,3560
2018-09-10,20,6273,6590,2533,15661,17165,3430,94,36560,4,25,2,31,966,2679,3645
2018-09-10,21,5950,6240,2487,15216,16520,3285,86,35316,0,0,0,0,993,2693,3686
2018-09-10,22,5516,5750,2320,14149,15397,3033,78,32866,0,0,0,0,987,2718,3705
2018-09-10,23,5044,5285,2117,12806,13902,2714,70,29702,0,0,0,0,976,2744,3720
2018-09-10,24,4647,4927,1933,11732,12635,2444,64,27085,0,0,0,0,987,2738,3725
2018-09-11,1,4431,4759,1794,10984,11315,2152,56,24719,0,0,0,0,1019,2852,3871
2018-09-11,2,4184,4622,1723,10448,10700,2052,53,23465,0,0,0,0,966,2836,3802
2018-09-11,3,3998,4543,1682,10114,10272,1983,51,22632,0,0,0,0,912,2783,3695
2018-09-11,4,3871,4555,1675,9982,10092,1952,50,22288,0,0,0,0,859,2705,3564
2018-09-11,5,3841,4726,1736,10140,10263,1983,51,22649,0,0,0,0,801,2631,3432
2018-09-11,6,3925,5071,1930,10686,10861,2121,54,23933,0,0,0,0,750,2550,3300
2018-09-11,7,4023,5333,2231,11685,11692,2351,57,25996,3,91,3,97,715,2419,3134
2018-09-11,8,4134,5494,2370,12239,12200,2448,59,27158,324,1927,299,2550,659,2261,2920
2018-09-11,9,4404,5710,2362,12329,12729,2500,63,27833,1031,4953,997,6981,568,2164,2732
2018-09-11,10,4712,5923,2362,12254,13177,2531,68,28244,1268,6240,1371,8879,474,2095,2569
2018-09-11,11,5045,6123,2374,12178,13680,2549,75,28694,1299,6719,1524,9542,363,1987,2350
2018-09-11,12,5380,6331,2401,12196,14221,2557,81,29267,1292,6917,1576,9785,354,2144,2498
2018-09-11,13,5702,6559,2424,12349,14797,2600,88,30046,1278,6937,1572,9787,372,2305,2677
2018-09-11,14,6025,6783,2448,12859,15552,2678,94,31393,1272,6923,1568,9763,468,2481,2949
2018-09-11,15,6324,6962,2459,13419,16311,2779,98,32818,1271,6832,1570,9673,591,2660,3251
2018-09-11,16,6552,7081,2463,14001,16903,2870,102,34086,1263,6504,1510,9277,763,2808,3571
2018-09-11,17,6624,7147,2501,14614,17396,2968,102,35290,1195,5723,1324,8242,921,2903,3824
2018-09-11,18,6527,6971,2505,15027,17300,3006,101,35644,896,3682,880,5458,982,2881,3863
2018-09-11,19,6326,6780,2494,15204,16762,2956,94,35226,249,807,213,1269,1026,2787,3813
2018-09-11,20,6229,6635,2503,15277,16427,3105,89,35108,3,22,2,27,1067,2702,3769
2018-09-11,21,5940,6288,2493,14939,15951,3024,81,34205,0,0,0,0,1057,2684,3741
2018-09-11,22,5522,5813,2319,13935,14922,2806,73,31946,0,0,0,0,1047,2678,3725
2018-09-11,23,5073,5357,2115,12714,13592,2527,66,29109,0,0,0,0,1038,2659,3697
2018-09-11,24,4661,4997,1946,11636,12338,2281,59,26526,0,0,0,0,1009,2642,3651
2018-09-12,1,4327,4710,1803,10798,10897,2081,55,24042,0,0,0,0,985,2551,3536
2018-09-12,2,4107,4569,1737,10291,10313,1977,53,22846,0,0,0,0,940,2486,3426
2018-09-12,3,3935,4495,1701,9982,9938,1929,51,22112,0,0,0,0,892,2434,3326
2018-09-12,4,3833,4505,1701,9864,9791,1902,50,21819,0,0,0,0,844,2398,3242
2018-09-12,5,3819,4672,1764,10027,9972,1934,51,22196,0,0,0,0,782,2340,3122
2018-09-12,6,3922,5007,1971,10581,10603,2066,54,23515,0,0,0,0,701,2223,2924
2018-09-12,7,4011,5265,2285,11563,11429,2301,57,25561,2,84,3,89,636,2057,2693
2018-09-12,8,4096,5419,2419,12310,11934,2392,59,26908,313,1828,287,2428,594,1854,2448
2018-09-12,9,4325,5616,2397,12397,12290,2431,63,27393,1000,4917,988,6905,543,1642,2185
2018-09-12,10,4586,5811,2377,12322,12664,2450,68,27717,1247,6248,1369,8864,469,1463,1932
2018-09-12,11,4846,5994,2366,12179,13041,2465,74,27972,1276,6724,1521,9521,404,1298,1702
2018-09-12,12,5121,6164,2372,12010,13486,2475,80,28265,1266,6923,1568,9757,397,1423,1820
2018-09-12,13,5393,6363,2387,11923,14118,2523,87,28865,1245,6948,1561,9754,414,1676,2090
2018-09-12,14,5647,6577,2403,12167,14839,2603,92,29914,1234,6926,1557,9717,473,1879,2352
2018-09-12,15,5889,6749,2415,12465,15464,2714,95,30951,1232,6853,1560,9645,565,2009,2574
2018-09-12,16,6087,6886,2429,12837,16119,2820,99,32086,1220,6530,1494,9244,697,2104,2801
2018-09-12,17,6109,6861,2471,13355,16522,2924,98,33110,1148,5741,1307,8196,835,2196,3031
2018-09-12,18,6037,6697,2475,13728,16493,2975,96,33503,845,3619,844,5308,910,2215,3125
2018-09-12,19,5863,6498,2462,13951,15957,2929,90,33138,190,732,190,1112,959,2128,3087
2018-09-12,20,5802,6387,2473,14164,15873,3078,85,33411,2,14,1,17,1003,2060,3063
2018-09-12,21,5563,6075,2470,13970,15533,2998,79,32791,0,0,0,0,989,2014,3003
2018-09-12,22,5205,5651,2296,13138,14579,2777,71,30776,0,0,0,0,987,2034,3021
2018-09-12,23,4824,5222,2089,12066,13242,2508,64,28091,0,0,0,0,949,2008,2957
2018-09-12,24,4453,4897,1926,11107,11997,2269,58,25642,0,0,0,0,908,2014,2922
2018-09-13,1,4198,4593,1799,10440,11307,2192,54,24204,0,0,0,0,857,2009,2866
2018-09-13,2,3995,4465,1737,10002,10645,2083,51,22993,0,0,0,0,828,1887,2715
2018-09-13,3,3848,4401,1702,9725,10204,2007,50,22198,0,0,0,0,794,1783,2577
2018-09-13,4,3758,4415,1700,9626,9987,1973,49,21846,0,0,0,0,774,1676,2450
2018-09-13,5,3757,4581,1765,9811,10080,2006,49,22158,0,0,0,0,735,1557,2292
2018-09-13,6,3853,4917,1970,10379,10670,2130,52,23442,0,0,0,0,677,1403,2080
2018-09-13,7,3950,5170,2272,11394,11589,2307,54,25553,2,76,3,81,567,1219,1786
2018-09-13,8,4035,5311,2421,11929,12134,2398,56,26728,313,1807,282,2402,483,1036,1519
2018-09-13,9,4254,5469,2390,11894,12488,2444,60,27097,997,4965,989,6951,412,832,1244
2018-09-13,10,4504,5634,2369,11750,12868,2482,65,27378,1242,6254,1371,8867,322,689,1011
2018-09-13,11,4730,5787,2354,11509,13240,2519,71,27554,1261,6729,1525,9515,243,634,877
2018-09-13,12,4950,5918,2353,11331,13774,2555,76,27948,1253,6929,1568,9750,215,741,956
2018-09-13,13,5173,6080,2365,11276,14337,2614,82,28521,1240,6948,1560,9748,196,857,1053
2018-09-13,14,5414,6264,2382,11527,15160,2715,87,29701,1234,6920,1557,9711,200,973,1173
2018-09-13,15,5632,6422,2385,11835,15920,2847,90,30904,1236,6839,1560,9635,274,1105,1379
2018-09-13,16,5807,6523,2396,12320,16701,3000,93,32325,1232,6507,1490,9229,387,1261,1648
2018-09-13,17,5849,6538,2430,12793,17157,3146,94,33402,1160,5702,1300,8162,533,1417,1950
2018-09-13,18,5770,6439,2426,13166,17086,3237,92,33791,859,3563,839,5261,654,1470,2124
2018-09-13,19,5618,6207,2414,13442,16457,3227,86,33422,197,691,188,1076,738,1476,2214
2018-09-13,20,5569,6152,2432,13726,16212,3196,82,33425,2,11,1,14,805,1473,2278
2018-09-13,21,5355,5883,2428,13588,15711,3166,75,32751,0,0,0,0,788,1416,2204
2018-09-13,22,5016,5487,2258,12844,14693,2976,69,30792,0,0,0,0,775,1340,2115
2018-09-13,23,4657,5076,2064,11859,13355,2687,62,28174,0,0,0,0,770,1259,2029
2018-09-13,24,4308,4774,1913,10973,12133,2428,56,25802,0,0,0,0,782,1264,2046
2018-09-14,1,4147,4589,1810,10387,11465,2218,51,24332,0,0,0,0,804,1180,1984
2018-09-14,2,3947,4468,1750,9972,10789,2083,49,23103,0,0,0,0,791,1152,1943
2018-09-14,3,3780,4403,1717,9716,10326,2012,47,22310,0,0,0,0,765,1027,1792
2018-09-14,4,3690,4416,1718,9643,10096,1976,46,21971,0,0,0,0,731,921,1652
2018-09-14,5,3692,4569,1781,9839,10198,2000,47,22293,0,0,0,0,697,829,1526
2018-09-14,6,3799,4888,1974,10391,10752,2124,49,23526,0,0,0,0,656,739,1395
2018-09-14,7,3882,5140,2264,11390,11585,2338,52,25575,1,60,2,63,590,622,1212
2018-09-14,8,3989,5287,2398,11851,12082,2449,54,26644,328,1747,277,2352,542,506,1048
2018-09-14,9,4232,5450,2381,11789,12393,2514,57,26963,1042,4928,984,6954,461,301,762
2018-09-14,10,4507,5609,2356,11676,12898,2561,62,27408,1281,6203,1361,8845,360,184,544
2018-09-14,11,4772,5765,2339,11423,13574,2603,67,27878,1290,6687,1511,9488,257,179,436
2018-09-14,12,5011,5911,2330,11236,14298,2647,73,28465,1280,6874,1559,9713,215,240,455
2018-09-14,13,5248,6094,2327,11205,15356,2724,79,29576,1268,6889,1551,9708,197,343,540
2018-09-14,14,5508,6302,2344,11544,16146,2838,83,30822,1258,6855,1549,9662,218,511,729
2018-09-14,15,5765,6500,2343,11953,16884,2943,87,32079,1269,6779,1551,9599,297,647,944
2018-09-14,16,5984,6610,2353,12401,17484,3060,90,33245,1263,6453,1478,9194,394,768,1162
2018-09-14,17,6109,6651,2387,12928,17849,3172,91,34250,1200,5529,1281,8010,578,941,1519
2018-09-14,18,6017,6529,2374,13336,17763,3276,90,34676,887,3403,818,5108,697,987,1684
2018-09-14,19,5824,6361,2341,13462,17088,3199,85,34045,201,651,183,1035,804,1036,1840
2018-09-14,20,5703,6200,2342,13664,16330,3183,80,33468,2,9,3,14,886,1122,2008
2018-09-14,21,5424,5897,2310,13499,16032,3100,74,32915,0,0,0,0,896,1150,2046
2018-09-14,22,5095,5530,2163,12817,15113,2932,67,31139,0,0,0,0,889,1096,1985
2018-09-14,23,4757,5152,2004,12027,13967,2686,61,28950,0,0,0,0,890,1033,1923
2018-09-14,24,4422,4824,1867,11157,12822,2453,56,26698,0,0,0,0,908,1013,1921
2018-09-15,1,4177,4611,1749,10447,11442,2257,50,24404,0,0,0,0,930,922,1852
2018-09-15,2,3968,4482,1683,9984,10781,2127,46,23148,0,0,0,0,962,900,1862
2018-09-15,3,3821,4400,1643,9681,10285,2047,45,22268,0,0,0,0,969,869,1838
2018-09-15,4,3710,4373,1630,9524,9984,2000,44,21763,0,0,0,0,977,858,1835
2018-09-15,5,3649,4425,1648,9553,9908,1994,44,21710,0,0,0,0,969,847,1816
2018-09-15,6,3672,4569,1722,9756,10113,2034,46,22159,0,0,0,0,951,813,1764
2018-09-15,7,3646,4677,1846,10124,10328,2123,47,22830,1,50,2,53,935,751,1686
2018-09-15,8,3726,4823,1952,10307,10417,2169,48,23151,302,1673,270,2245,876,684,1560
2018-09-15,9,4015,5056,2052,10500,10828,2255,50,23845,991,4847,969,6807,848,606,1454
2018-09-15,10,4342,5247,2089,10479,11298,2296,55,24340,1270,6241,1378,8889,783,611,1394
2018-09-15,11,4650,5417,2103,10334,11767,2313,61,24686,1286,6716,1541,9543,714,674,1388
2018-09-15,12,4941,5625,2095,10246,12341,2345,68,25212,1278,6901,1575,9754,694,770,1464
2018-09-15,13,5225,5847,2077,10261,12989,2417,75,25953,1278,6900,1571,9749,690,880,1570
2018-09-15,14,5507,6068,2068,10460,13704,2490,81,26946,1267,6865,1566,9698,709,989,1698
2018-09-15,15,5788,6294,2066,10773,14482,2601,87,28153,1280,6762,1566,9608,753,1074,1827
2018-09-15,16,6003,6492,2085,11267,15204,2745,91,29516,1277,6418,1502,9197,828,1120,1948
2018-09-15,17,6064,6626,2128,11743,15598,2862,92,30503,1214,5629,1307,8150,899,1252,2151
2018-09-15,18,5998,6539,2139,12194,15640,2930,90,31063,886,3391,831,5108,961,1312,2273
2018-09-15,19,5782,6390,2127,12406,15178,2933,83,30811,201,628,180,1009,992,1386,2378
2018-09-15,20,5639,6281,2154,12743,14903,3034,79,30968,2,14,3,19,1036,1467,2503
2018-09-15,21,5389,5949,2148,12655,14534,2939,72,30410,0,0,0,0,1027,1462,2489
2018-09-15,22,5082,5551,2013,12058,13751,2774,66,28859,0,0,0,0,1015,1426,2441
2018-09-15,23,4818,5158,1884,11352,12818,2562,59,27001,0,0,0,0,968,1350,2318
2018-09-15,24,4502,4824,1766,10620,11800,2349,54,25032,0,0,0,0,964,1348,2312
2018-09-16,1,4237,4584,1676,10348,10970,2204,50,23788,0,0,0,0,936,1409,2345
2018-09-16,2,4028,4433,1616,9956,10422,2077,48,22720,0,0,0,0,903,1362,2265
2018-09-16,3,3858,4336,1585,9648,9960,2000,46,21871,0,0,0,0,844,1274,2118
2018-09-16,4,3751,4296,1579,9531,9732,1955,45,21481,0,0,0,0,791,1174,1965
2018-09-16,5,3687,4308,1598,9501,9602,1944,45,21310,0,0,0,0,720,1040,1760
2018-09-16,6,3686,4411,1655,9636,9658,1972,46,21529,0,0,0,0,643,906,1549
2018-09-16,7,3621,4496,1751,9847,9715,2015,46,21841,1,56,2,59,548,796,1344
2018-09-16,8,3671,4649,1845,9763,9687,2041,48,21755,314,1705,280,2299,455,665,1120
2018-09-16,9,3948,4854,1956,9761,9871,2099,52,21995,1066,4949,995,7010,358,500,858
2018-09-16,10,4297,5047,2009,9743,10204,2141,57,22359,1284,6239,1394,8917,273,399,672
2018-09-16,11,4627,5192,2015,9576,10622,2163,63,22638,1311,6713,1554,9578,199,390,589
2018-09-16,12,4944,5482,2026,9485,11178,2208,69,23155,1300,6892,1581,9773,165,495,660
2018-09-16,13,5280,5694,2038,9573,11902,2284,75,24051,1284,6904,1572,9760,134,621,755
2018-09-16,14,5570,5934,2038,9885,12724,2382,81,25289,1275,6879,1567,9721,130,795,925
2018-09-16,15,5816,6142,2032,10361,13609,2511,86,26784,1282,6791,1567,9640,158,933,1091
2018-09-16,16,6055,6331,2052,11015,14430,2669,89,28418,1285,6465,1511,9261,225,1052,1277
2018-09-16,17,6101,6396,2100,11665,14947,2807,91,29726,1220,5648,1312,8180,370,1215,1585
2018-09-16,18,6022,6302,2151,12375,15116,2905,90,30703,888,3386,832,5106,533,1293,1826
2018-09-16,19,5851,6173,2167,12777,14805,2935,85,30818,197,588,174,959,652,1392,2044
2018-09-16,20,5736,6086,2233,13121,14596,3047,80,31060,1,21,3,25,800,1555,2355
2018-09-16,21,5474,5759,2234,13030,14282,2953,72,30553,0,0,0,0,797,1544,2341
2018-09-16,22,5127,5374,2076,12329,13485,2756,65,28850,0,0,0,0,790,1494,2284
2018-09-16,23,4768,4993,1905,11438,12341,2508,58,26561,0,0,0,0,790,1410,2200
2018-09-16,24,4411,4695,1768,10551,11221,2275,53,24316,0,0,0,0,798,1365,2163
2018-09-17,1,4148,4564,1660,10735,11339,2207,47,24545,0,0,0,0,851,1354,2205
2018-09-17,2,3942,4452,1617,10289,10672,2104,45,23328,0,0,0,0,867,1319,2186
2018-09-17,3,3788,4389,1599,9991,10349,2028,44,22630,0,0,0,0,852,1274,2126
2018-09-17,4,3707,4413,1619,9894,10185,1989,44,22330,0,0,0,0,835,1231,2066
2018-09-17,5,3721,4587,1703,10036,10302,2031,45,22632,0,0,0,0,789,1183,1972
2018-09-17,6,3832,4930,1924,10535,10910,2154,49,23865,0,0,0,0,740,1067,1807
2018-09-17,7,3945,5217,2258,11557,11685,2343,52,25853,2,60,2,64,668,950,1618
2018-09-17,8,4053,5397,2423,12185,12125,2428,54,27004,309,1733,280,2322,635,849,1484
2018-09-17,9,4304,5612,2398,12167,12553,2477,58,27474,1066,5003,997,7066,578,695,1273
2018-09-17,10,4587,5820,2368,11975,13014,2516,62,27788,1285,6281,1398,8964,480,568,1048
2018-09-17,11,4875,6001,2342,11768,13420,2527,68,28003,1321,6749,1559,9629,371,511,882
2018-09-17,12,5167,6190,2331,11610,13916,2553,73,28373,1306,6933,1581,9820,354,602,956
2018-09-17,13,5460,6412,2340,11534,14444,2639,78,28914,1284,6943,1574,9801,351,744,1095
2018-09-17,14,5748,6614,2355,11810,15208,2764,82,30083,1275,6918,1568,9761,386,911,1297
2018-09-17,15,6007,6775,2360,12179,15875,2897,86,31256,1282,6831,1568,9681,469,1108,1577
2018-09-17,16,6180,6881,2375,12659,16573,3036,89,32574,1287,6497,1515,9299,596,1285,1881
2018-09-17,17,6244,6928,2411,13118,16982,3163,91,33570,1223,5671,1314,8208,755,1465,2220
2018-09-17,18,6153,6794,2433,13443,16951,3265,89,33965,884,3366,830,5080,813,1521,2334
2018-09-17,19,5987,6639,2433,13681,16389,3237,84,33610,202,649,176,1027,865,1599,2464
2018-09-17,20,5902,6504,2477,13948,16044,3214,80,33503,1,1,2,4,926,1703,2629
2018-09-17,21,5603,6142,2420,13733,15790,3127,73,32940,0,0,0,0,939,1716,2655
2018-09-17,22,5226,5683,2236,12986,14894,2911,66,31074,0,0,0,0,952,1691,2643
2018-09-17,23,4805,5234,2030,11954,13581,2619,60,28429,0,0,0,0,955,1640,2595
2018-09-17,24,4431,4904,1872,11061,12365,2358,55,26055,0,0,0,0,942,1643,2585
2018-09-18,1,4184,4664,1786,10487,10857,2211,51,23817,0,0,0,0,946,1765,2711
2018-09-18,2,3956,4535,1728,10020,10265,2110,48,22656,0,0,0,0,918,1731,2649
2018-09-18,3,3810,4462,1697,9754,9862,2043,47,21919,0,0,0,0,894,1686,2580
2018-09-18,4,3713,4478,1694,9667,9672,2008,47,21605,0,0,0,0,872,1645,2517
2018-09-18,5,3698,4644,1757,9837,9802,2042,48,21941,0,0,0,0,837,1583,2420
2018-09-18,6,3787,4987,1967,10375,10391,2173,51,23202,0,0,0,0,774,1475,2249
2018-09-18,7,3900,5256,2288,11440,11261,2394,54,25360,3,57,2,62,698,1366,2064
2018-09-18,8,4002,5403,2441,12064,11827,2492,56,26650,292,1631,280,2203,613,1239,1852
2018-09-18,9,4225,5578,2395,12055,12130,2537,58,26992,1053,4812,998,6863,521,1036,1557
2018-09-18,10,4490,5760,2368,11828,12536,2567,62,27207,1276,6080,1398,8754,399,841,1240
2018-09-18,11,4756,5932,2351,11585,12981,2586,67,27433,1312,6543,1555,9410,290,684,974
2018-09-18,12,5039,6110,2359,11415,13489,2592,73,27782,1297,6732,1579,9608,235,730,965
2018-09-18,13,5334,6327,2378,11396,14012,2632,79,28331,1282,6730,1571,9583,212,861,1073
2018-09-18,14,5620,6543,2401,11702,14797,2715,83,29509,1273,6697,1566,9536,207,1052,1259
2018-09-18,15,5888,6736,2413,12062,15600,2822,87,30783,1280,6604,1567,9451,235,1350,1585
2018-09-18,16,6098,6875,2427,12546,16338,2929,90,32114,1286,6398,1516,9200,293,1699,1992
2018-09-18,17,6145,6862,2461,12989,16776,3039,92,33107,1221,5585,1312,8118,400,1979,2379
2018-09-18,18,6064,6780,2470,13488,16612,3084,91,33485,881,3298,829,5008,543,2157,2700
2018-09-18,19,5925,6617,2468,13759,16124,3060,85,33241,196,616,173,985,655,2287,2942
2018-09-18,20,5816,6457,2506,14069,16002,3176,81,33539,1,1,3,5,722,2408,3130
2018-09-18,21,5540,6110,2435,13814,15510,3070,74,32678,0,0,0,0,761,2477,3238
2018-09-18,22,5144,5645,2252,12954,14395,2841,67,30468,0,0,0,0,783,2515,3298
2018-09-18,23,4725,5203,2046,11857,13009,2551,60,27689,0,0,0,0,795,2519,3314
2018-09-18,24,4341,4869,1887,10956,11788,2309,54,25319,0,0,0,0,786,2532,3318
2018-09-19,1,4025,4591,1777,10264,10396,2141,48,23061,0,0,0,0,773,2494,3267
2018-09-19,2,3830,4462,1717,9889,9890,2043,46,22080,0,0,0,0,780,2517,3297
2018-09-19,3,3693,4396,1682,9648,9503,1984,46,21392,0,0,0,0,738,2533,3271
2018-09-19,4,3606,4405,1680,9545,9341,1953,45,21096,0,0,0,0,697,2487,3184
2018-09-19,5,3590,4567,1743,9742,9505,1985,47,21492,0,0,0,0,646,2380,3026
2018-09-19,6,3701,4905,1952,10303,10123,2120,51,22808,0,0,0,0,571,2291,2862
2018-09-19,7,3819,5174,2280,11354,10961,2344,54,24924,4,44,2,50,461,2188,2649
2018-09-19,8,3895,5301,2415,11829,11346,2437,56,25879,288,1619,281,2188,381,2021,2402
2018-09-19,9,4096,5452,2387,11732,11753,2473,57,26227,1052,4785,1005,6842,288,1762,2050
2018-09-19,10,4335,5609,2359,11510,12260,2489,61,26532,1298,6062,1408,8768,201,1458,1659
2018-09-19,11,4580,5752,2349,11281,12793,2495,65,26847,1317,6517,1567,9401,144,1165,1309
2018-09-19,12,4832,5876,2346,11189,13228,2497,70,27196,1303,6745,1580,9628,112,1172,1284
2018-09-19,13,5100,6032,2358,11325,13711,2537,75,27860,1287,6818,1572,9677,96,1290,1386
2018-09-19,14,5365,6213,2378,11694,14403,2614,79,29004,1277,6779,1566,9622,86,1463,1549
2018-09-19,15,5627,6370,2392,12223,15140,2717,83,30375,1283,6693,1567,9543,101,1771,1872
2018-09-19,16,5839,6486,2405,12865,15778,2834,86,31775,1291,6258,1525,9074,148,2061,2209
2018-09-19,17,5897,6467,2438,13442,16126,2947,88,32814,1220,5467,1318,8005,233,2336,2569
2018-09-19,18,5840,6352,2444,13995,16131,3004,87,33428,872,3271,831,4974,325,2467,2792
2018-09-19,19,5725,6202,2438,14277,15800,2989,82,33359,187,572,172,931,366,2485,2851
2018-09-19,20,5645,6090,2481,14489,15807,3114,77,33698,1,0,2,3,466,2472,2938
2018-09-19,21,5377,5814,2426,14120,15291,3015,70,32707,0,0,0,0,471,2309,2780
2018-09-19,22,5013,5400,2244,13173,14214,2803,64,30464,0,0,0,0,477,2079,2556
2018-09-19,23,4595,5016,2039,12108,12924,2528,57,27826,0,0,0,0,501,1743,2244
2018-09-19,24,4230,4730,1884,11137,11702,2284,52,25386,0,0,0,0,526,1273,1799
2018-09-20,1,3926,4499,1783,10568,10756,2162,48,23746,0,0,0,0,421,1353,1774
2018-09-20,2,3733,4384,1723,10112,10173,2063,46,22605,0,0,0,0,431,882,1313
2018-09-20,3,3584,4325,1690,9827,9764,2004,45,21852,0,0,0,0,437,663,1100
2018-09-20,4,3513,4346,1690,9713,9585,1973,45,21529,0,0,0,0,418,486,904
2018-09-20,5,3512,4512,1754,9875,9732,2005,47,21871,0,0,0,0,399,393,792
2018-09-20,6,3628,4862,1965,10427,10341,2141,51,23171,0,0,0,0,348,261,609
2018-09-20,7,3753,5133,2294,11463,11214,2367,55,25309,2,44,2,48,296,229,525
2018-09-20,8,3840,5252,2437,12007,11634,2461,56,26369,274,1609,270,2153,276,235,511
2018-09-20,9,4051,5361,2405,12020,11997,2498,57,26784,1036,4638,1006,6680,251,237,488
2018-09-20,10,4291,5492,2379,11838,12407,2514,60,27033,1298,5966,1417,8681,260,281,541
2018-09-20,11,4535,5613,2362,11766,12953,2520,65,27517,1315,6539,1572,9426,247,323,570
2018-09-20,12,4804,5700,2352,11783,13541,2522,70,28128,1297,6790,1579,9666,201,312,513
2018-09-20,13,5075,5829,2361,11976,14151,2562,75,28976,1277,6832,1570,9679,157,281,438
2018-09-20,14,5349,5970,2379,12419,14927,2640,80,30278,1271,6817,1565,9653,130,246,376
2018-09-20,15,5623,6087,2385,12975,15815,2744,83,31830,1279,6720,1566,9565,108,207,315
2018-09-20,16,5834,6173,2399,13689,16565,2862,86,33415,1287,6397,1527,9211,110,196,306
2018-09-20,17,5931,6226,2429,14324,17016,2976,88,34616,1213,5583,1319,8115,110,198,308
2018-09-20,18,5877,6076,2437,14777,16995,3034,87,35102,848,3257,811,4916,153,223,376
2018-09-20,19,5772,5981,2432,14983,16391,3019,82,34685,171,549,157,877,199,310,509
2018-09-20,20,5679,5912,2489,15217,16064,3145,78,34713,1,0,0,1,265,452,717
2018-09-20,21,5405,5616,2417,14746,15544,3045,71,33616,0,0,0,0,284,505,789
2018-09-20,22,5042,5298,2232,13762,14450,2831,64,31317,0,0,0,0,290,475,765
2018-09-20,23,4632,4960,2032,12533,13040,2553,58,28394,0,0,0,0,324,436,760
2018-09-20,24,4259,4689,1866,11511,11869,2307,52,25950,0,0,0,0,316,366,682
2018-09-21,1,3937,4433,1809,10840,11236,2117,50,24455,0,0,0,0,403,310,713
2018-09-21,2,3740,4340,1747,10326,10610,2027,48,23222,0,0,0,0,359,246,605
2018-09-21,3,3600,4301,1711,9988,10185,1967,47,22398,0,0,0,0,309,222,531
2018-09-21,4,3518,4337,1703,9849,9976,1938,46,22021,0,0,0,0,236,191,427
2018-09-21,5,3520,4505,1756,9980,10118,1963,47,22319,0,0,0,0,203,171,374
2018-09-21,6,3638,4847,1944,10498,10684,2060,50,23503,0,0,0,0,165,139,304
2018-09-21,7,3749,5105,2241,11489,11435,2282,54,25471,3,42,2,47,114,114,228
2018-09-21,8,3862,5210,2385,12040,11925,2376,54,26607,284,1690,260,2234,84,111,195
2018-09-21,9,4105,5284,2370,12042,12401,2435,57,27149,1040,4958,1013,7011,62,95,157
2018-09-21,10,4383,5376,2357,12061,12910,2431,61,27677,1294,6224,1415,8933,57,100,157
2018-09-21,11,4667,5465,2368,12087,13485,2437,66,28290,1312,6689,1574,9575,51,126,177
2018-09-21,12,4978,5531,2363,12239,14071,2486,72,29082,1297,6889,1581,9767,57,151,208
2018-09-21,13,5278,5659,2380,12499,14640,2539,78,29969,1278,6879,1571,9728,73,172,245
2018-09-21,14,5602,5817,2413,13092,15445,2610,83,31442,1268,6846,1565,9679,108,190,298
2018-09-21,15,5927,5961,2438,13705,16155,2695,87,32853,1279,6733,1568,9580,161,218,379
2018-09-21,16,6198,6062,2480,14383,16707,2793,90,34182,1286,6384,1526,9196,256,287,543
2018-09-21,17,6317,6091,2525,14934,16917,2898,91,35048,1213,5555,1310,8078,383,372,755
2018-09-21,18,6259,5998,2523,15214,16704,2977,90,35194,841,3187,804,4832,481,450,931
2018-09-21,19,6108,5879,2483,15182,16078,2958,85,34512,164,521,150,835,609,535,1144
2018-09-21,20,5928,5772,2495,15248,15673,2963,79,34173,1,0,0,1,730,684,1414
2018-09-21,21,5590,5492,2419,14676,15274,2940,73,33172,0,0,0,0,750,683,1433
2018-09-21,22,5217,5157,2221,13767,14462,2797,66,31302,0,0,0,0,753,645,1398
2018-09-21,23,4840,4834,2027,12705,13298,2574,60,28847,0,0,0,0,775,582,1357
2018-09-21,24,4468,4578,1861,11713,12241,2335,55,26556,0,0,0,0,791,498,1289
2018-09-22,1,4190,4468,1755,11120,11372,2094,51,24849,0,0,0,0,832,398,1230
2018-09-22,2,3946,4358,1676,10585,10737,1988,48,23570,0,0,0,0,808,364,1172
2018-09-22,3,3787,4285,1618,10214,10268,1917,47,22656,0,0,0,0,745,333,1078
2018-09-22,4,3672,4267,1590,10017,9996,1878,46,22148,0,0,0,0,673,285,958
2018-09-22,5,3620,4315,1595,9987,9960,1873,46,22077,0,0,0,0,541,233,774
2018-09-22,6,3649,4462,1665,10161,10180,1920,47,22519,0,0,0,0,450,182,632
2018-09-22,7,3643,4573,1794,10540,10346,2010,49,23154,2,39,3,44,385,157,542
2018-09-22,8,3727,4707,1904,10714,10461,2051,49,23484,273,1688,257,2218,307,136,443
2018-09-22,9,3998,4885,1998,10928,10849,2123,53,24165,1032,4976,1010,7018,233,98,331
2018-09-22,10,4312,5029,2076,10913,11225,2142,57,24552,1293,6272,1406,8971,176,96,272
2018-09-22,11,4643,5154,2132,10954,11777,2142,63,25150,1312,6725,1571,9608,137,127,264
2018-09-22,12,4976,5277,2135,11127,12499,2167,70,26075,1298,6904,1579,9781,136,187,323
2018-09-22,13,5297,5434,2128,11406,13294,2217,76,27205,1280,6884,1569,9733,148,289,437
2018-09-22,14,5617,5646,2130,11851,14006,2271,83,28422,1273,6849,1565,9687,164,402,566
2018-09-22,15,5915,5841,2131,12356,14755,2370,87,29777,1280,6760,1566,9606,243,490,733
2018-09-22,16,6128,6017,2144,13032,15442,2512,89,31285,1288,6446,1522,9256,306,579,885
2018-09-22,17,6198,6172,2172,13650,15802,2650,91,32403,1214,5590,1305,8109,436,726,1162
2018-09-22,18,6125,6101,2178,14171,15833,2751,88,33054,839,3122,799,4760,475,787,1262
2018-09-22,19,5951,6003,2166,14332,15490,2809,84,32924,157,495,146,798,520,864,1384
2018-09-22,20,5782,5888,2226,14537,15312,2893,79,33031,0,0,0,0,576,1079,1655
2018-09-22,21,5490,5555,2180,14042,14647,2807,72,31777,0,0,0,0,621,1139,1760
2018-09-22,22,5150,5205,2036,13231,13810,2653,66,29971,0,0,0,0,676,1153,1829
2018-09-22,23,4822,4880,1901,12290,12877,2456,60,27892,0,0,0,0,716,1191,1907
2018-09-22,24,4507,4590,1771,11421,11866,2257,55,25809,0,0,0,0,710,1127,1837
2018-09-23,1,4231,4417,1649,10566,11241,2131,52,24202,0,0,0,0,736,923,1659
2018-09-23,2,4008,4294,1582,10063,10615,2015,49,22955,0,0,0,0,712,858,1570
2018-09-23,3,3844,4212,1544,9701,10157,1939,48,22058,0,0,0,0,697,815,1512
2018-09-23,4,3734,4184,1539,9509,9868,1901,47,21537,0,0,0,0,692,768,1460
2018-09-23,5,3658,4203,1558,9441,9736,1890,47,21327,0,0,0,0,682,692,1374
2018-09-23,6,3662,4305,1619,9539,9789,1920,48,21508,0,0,0,0,618,611,1229
2018-09-23,7,3620,4395,1746,9794,9896,1979,49,21930,2,33,2,37,556,563,1119
2018-09-23,8,3667,4523,1855,9814,9891,2009,51,21975,246,1563,249,2058,515,508,1023
2018-09-23,9,3937,4680,1969,9878,10174,2069,55,22388,957,4755,999,6711,457,406,863
2018-09-23,10,4271,4829,2025,9861,10616,2086,60,22835,1224,6022,1397,8643,339,332,671
2018-09-23,11,4600,4933,2028,9847,11259,2094,66,23478,1267,6493,1562,9322,233,334,567
2018-09-23,12,4957,5152,2035,9978,11960,2111,73,24334,1254,6688,1575,9517,185,463,648
2018-09-23,13,5284,5326,2041,10195,12751,2157,79,25393,1247,6641,1563,9451,164,639,803
2018-09-23,14,5569,5531,2036,10597,13807,2230,85,26929,1240,6582,1559,9381,161,868,1029
2018-09-23,15,5809,5716,2020,11122,14443,2335,89,28201,1246,6457,1559,9262,200,1121,1321
2018-09-23,16,6020,5881,2037,11808,15240,2471,91,29820,1268,6132,1513,8913,242,1371,1613
2018-09-23,17,6046,5919,2084,12415,15670,2611,92,30999,1189,5260,1289,7738,300,1638,1938
2018-09-23,18,5976,5827,2139,13021,15752,2708,90,31781,812,2864,768,4444,336,1720,2056
2018-09-23,19,5839,5756,2165,13324,15543,2782,86,31946,147,430,135,712,392,1781,2173
2018-09-23,20,5711,5663,2255,13638,14870,2875,80,31673,0,0,0,0,496,1850,2346
2018-09-23,21,5439,5391,2234,13262,14247,2777,73,30569,0,0,0,0,549,1896,2445
2018-09-23,22,5091,5069,2064,12433,13408,2595,66,28712,0,0,0,0,574,1959,2533
2018-09-23,23,4755,4749,1890,11457,12410,2366,59,26502,0,0,0,0,588,2012,2600
2018-09-23,24,4401,4491,1751,10618,11568,2161,53,24611,0,0,0,0,568,2077,2645
2018-09-24,1,4137,4309,1653,10148,10508,2073,50,22990,0,0,0,0,513,1987,2500
2018-09-24,2,3941,4218,1609,9773,10058,1993,47,22083,0,0,0,0,444,1924,2368
2018-09-24,3,3801,4173,1599,9519,9741,1941,46,21460,0,0,0,0,393,1853,2246
2018-09-24,4,3722,4207,1622,9423,9600,1918,46,21201,0,0,0,0,341,1768,2109
2018-09-24,5,3733,4384,1712,9630,9820,1965,47,21676,0,0,0,0,316,1680,1996
2018-09-24,6,3829,4746,1941,10203,10479,2088,50,23032,0,0,0,0,268,1519,1787
2018-09-24,7,3966,5045,2303,11247,11408,2306,53,25225,2,34,2,38,219,1336,1555
2018-09-24,8,4068,5167,2463,11840,11818,2396,55,26320,239,1621,235,2095,193,1092,1285
2018-09-24,9,4302,5283,2422,11946,12247,2416,60,26880,982,4911,976,6869,163,839,1002
2018-09-24,10,4571,5401,2381,11774,12589,2420,65,27060,1258,6241,1384,8883,168,574,742
2018-09-24,11,4822,5491,2346,11726,13006,2399,70,27414,1291,6689,1548,9528,152,374,526
2018-09-24,12,5092,5547,2325,11794,13426,2389,75,27897,1277,6866,1560,9703,113,341,454
2018-09-24,13,5387,5636,2327,12004,13899,2419,79,28613,1268,6872,1549,9689,94,390,484
2018-09-24,14,5647,5733,2340,12550,14622,2474,83,29940,1261,6851,1548,9660,75,506,581
2018-09-24,15,5873,5821,2338,13184,15188,2551,87,31220,1271,6759,1552,9582,68,760,828
2018-09-24,16,6019,5905,2348,13958,15621,2646,89,32525,1279,6414,1509,9202,69,1060,1129
2018-09-24,17,6038,5954,2372,14640,15865,2741,89,33544,1200,5544,1281,8025,79,1449,1528
2018-09-24,18,5945,5834,2400,15051,15640,2804,87,33791,793,2978,743,4514,113,1749,1862
2018-09-24,19,5836,5805,2410,15238,15328,2838,83,33697,139,447,124,710,193,1940,2133
2018-09-24,20,5748,5729,2477,15467,15286,2942,79,33985,0,0,0,0,311,2084,2395
2018-09-24,21,5477,5466,2405,14820,14663,2827,73,32593,0,0,0,0,377,2025,2402
2018-09-24,22,5107,5131,2214,13722,13640,2630,67,30268,0,0,0,0,413,1909,2322
2018-09-24,23,4730,4794,2015,12436,12468,2367,60,27543,0,0,0,0,472,1734,2206
2018-09-24,24,4380,4550,1863,11371,11377,2148,55,25162,0,0,0,0,499,1536,2035
2018-09-25,1,4100,4370,1793,10654,10686,2028,52,23631,0,0,0,0,630,1424,2054
2018-09-25,2,3887,4286,1738,10182,10160,1945,49,22549,0,0,0,0,615,1151,1766
2018-09-25,3,3747,4259,1710,9865,9813,1890,48,21829,0,0,0,0,535,840,1375
2018-09-25,4,3663,4314,1713,9734,9662,1869,48,21523,0,0,0,0,437,590,1027
2018-09-25,5,3646,4507,1784,9900,9849,1904,49,21913,0,0,0,0,384,386,770
2018-09-25,6,3748,4892,1997,10452,10453,2029,52,23197,0,0,0,0,368,270,638
2018-09-25,7,3892,5174,2340,11521,11338,2290,55,25413,2,29,2,33,316,210,526
2018-09-25,8,3983,5217,2492,12047,11797,2381,57,26493,238,1565,233,2036,292,186,478
2018-09-25,9,4184,5249,2437,12095,12083,2417,60,26867,1004,4828,992,6824,240,171,411
2018-09-25,10,4433,5311,2395,12193,12412,2347,64,27230,1265,6231,1397,8893,215,219,434
2018-09-25,11,4678,5372,2368,12174,12823,2348,69,27627,1301,6694,1557,9552,176,243,419
2018-09-25,12,4930,5418,2364,12272,13285,2336,73,28180,1288,6871,1562,9721,143,255,398
2018-09-25,13,5220,5494,2378,12498,13836,2356,79,28982,1265,6882,1552,9699,112,235,347
2018-09-25,14,5509,5565,2403,13102,14570,2427,83,30394,1257,6846,1551,9654,90,221,311
2018-09-25,15,5773,5652,2415,13754,15345,2524,86,31920,1267,6754,1555,9576,83,194,277
2018-09-25,16,5969,5734,2430,14505,15934,2629,89,33368,1274,6391,1513,9178,82,183,265
2018-09-25,17,6021,5795,2464,15188,16378,2746,90,34614,1192,5488,1281,7961,112,184,296
2018-09-25,18,5947,5757,2489,15696,16212,2820,89,35027,785,2915,735,4435,215,276,491
2018-09-25,19,5857,5741,2492,15856,15713,2845,85,34708,136,422,117,675,337,458,795
2018-09-25,20,5749,5676,2556,16058,15638,2949,80,34933,0,0,0,0,487,657,1144
2018-09-25,21,5472,5435,2451,15363,15097,2854,73,33598,0,0,0,0,511,713,1224
2018-09-25,22,5088,5093,2233,14196,14079,2652,67,31204,0,0,0,0,538,638,1176
2018-09-25,23,4701,4760,2030,12830,12812,2402,60,28314,0,0,0,0,555,594,1149
2018-09-25,24,4333,4533,1862,11773,11740,2181,55,25958,0,0,0,0,562,523,1085
2018-09-26,1,4084,4376,1819,10654,10803,2046,51,23766,0,0,0,0,657,348,1005
2018-09-26,2,3877,4301,1761,10154,10179,1959,49,22552,0,0,0,0,578,256,834
2018-09-26,3,3739,4275,1727,9813,9804,1905,48,21781,0,0,0,0,472,206,678
2018-09-26,4,3656,4330,1723,9683,9626,1876,48,21444,0,0,0,0,358,190,548
2018-09-26,5,3639,4520,1786,9842,9829,1904,49,21834,0,0,0,0,299,191,490
2018-09-26,6,3750,4898,1994,10390,10463,2029,52,23143,0,0,0,0,251,201,452
2018-09-26,7,3877,5171,2324,11425,11415,2262,56,25366,1,26,2,29,213,199,412
2018-09-26,8,3953,5214,2478,12180,12211,2362,58,27022,226,1549,230,2005,206,206,412
2018-09-26,9,4142,5230,2439,12150,12614,2371,60,27406,977,4827,973,6777,163,197,360
2018-09-26,10,4370,5281,2408,12032,13068,2385,64,27761,1249,6221,1378,8848,136,256,392
2018-09-26,11,4608,5335,2413,12083,13687,2408,69,28459,1280,6674,1536,9490,98,297,395
2018-09-26,12,4858,5386,2410,12242,14355,2426,74,29310,1261,6850,1552,9663,73,317,390
2018-09-26,13,5116,5466,2433,12587,15063,2468,80,30410,1238,6848,1534,9620,56,323,379
2018-09-26,14,5385,5580,2468,13230,15935,2561,85,32023,1233,6818,1533,9584,50,305,355
2018-09-26,15,5648,5695,2517,13945,16810,2670,89,33726,1241,6733,1538,9512,44,260,304
2018-09-26,16,5859,5800,2567,14707,17436,2800,91,35245,1231,6359,1484,9074,41,227,268
2018-09-26,17,5932,5845,2615,15335,17833,2914,92,36384,1155,5448,1256,7859,51,201,252
2018-09-26,18,5890,5784,2655,15815,17745,2989,90,36848,736,2862,721,4319,77,185,262
2018-09-26,19,5835,5771,2641,15951,17302,3005,85,36553,96,333,107,536,133,161,294
2018-09-26,20,5739,5712,2646,16129,16743,3088,80,36250,0,0,0,0,224,269,493
2018-09-26,21,5450,5394,2543,15425,16064,2980,74,34754,0,0,0,0,277,358,635
2018-09-26,22,5062,5059,2312,14247,14908,2769,67,32202,0,0,0,0,330,290,620
2018-09-26,23,4640,4726,2079,12857,13470,2495,60,29092,0,0,0,0,389,293,682
2018-09-26,24,4278,4486,1906,11665,12141,2260,55,26331,0,0,0,0,385,308,693
2018-09-27,1,3990,4363,1845,10956,11266,2128,52,24614,0,0,0,0,500,322,822
2018-09-27,2,3774,4284,1771,10413,10575,2043,50,23293,0,0,0,0,476,307,783
2018-09-27,3,3625,4252,1729,10031,10138,1976,49,22406,0,0,0,0,422,240,662
2018-09-27,4,3550,4294,1717,9877,9924,1937,48,21995,0,0,0,0,352,188,540
2018-09-27,5,3540,4480,1769,10021,10076,1968,49,22324,0,0,0,0,289,159,448
2018-09-27,6,3648,4849,1965,10561,10677,2097,53,23597,0,0,0,0,262,116,378
2018-09-27,7,3778,5121,2286,11613,11608,2334,56,25820,1,25,1,27,229,90,319
2018-09-27,8,3880,5181,2435,12343,12484,2440,58,27536,194,1523,212,1929,214,83,297
2018-09-27,9,4094,5219,2411,12340,12980,2472,61,28063,873,4719,926,6518,157,75,232
2018-09-27,10,4347,5288,2435,12344,13580,2501,65,28702,1145,6101,1331,8577,112,79,191
2018-09-27,11,4623,5364,2453,12460,14369,2540,70,29650,1181,6593,1478,9252,87,100,187
2018-09-27,12,4919,5436,2461,12687,15178,2577,75,30731,1161,6776,1513,9450,67,123,190
2018-09-27,13,5209,5573,2510,13084,15998,2636,82,32011,1142,6753,1497,9392,53,137,190
2018-09-27,14,5523,5721,2578,13791,16924,2736,87,33750,1140,6720,1495,9355,52,149,201
2018-09-27,15,5807,5845,2640,14527,17804,2865,90,35498,1148,6628,1495,9271,66,155,221
2018-09-27,16,6050,5935,2688,15292,18389,2977,93,36961,1136,6223,1423,8782,105,180,285
2018-09-27,17,6140,5958,2740,15903,18676,3089,94,37972,1042,5224,1202,7468,174,252,426
2018-09-27,18,6100,5894,2775,16286,18464,3154,93,38206,632,2650,658,3940,274,348,622
2018-09-27,19,6030,5873,2751,16355,17926,3159,87,37737,63,274,88,425,410,472,882
2018-09-27,20,5914,5760,2726,16459,17614,3210,82,37576,0,0,0,0,634,766,1400
2018-09-27,21,5606,5433,2577,15670,16853,3073,75,35882,0,0,0,0,748,798,1546
2018-09-27,22,5190,5052,2352,14480,15624,2856,68,33238,0,0,0,0,826,770,1596
2018-09-27,23,4759,4719,2123,13047,14095,2575,61,29988,0,0,0,0,887,705,1592
2018-09-27,24,4353,4486,1942,11835,12652,2331,55,27083,0,0,0,0,919,662,1581
2018-09-28,1,4048,4379,1838,10821,11454,2200,53,24739,0,0,0,0,1047,655,1702
2018-09-28,2,3844,4288,1756,10258,10698,2101,51,23320,0,0,0,0,1055,627,1682
2018-09-28,3,3691,4240,1708,9891,10273,2027,50,22453,0,0,0,0,1039,590,1629
2018-09-28,4,3603,4267,1693,9758,10029,1993,49,22039,0,0,0,0,1021,538,1559
2018-09-28,5,3595,4422,1733,9902,10182,2021,50,22364,0,0,0,0,992,488,1480
2018-09-28,6,3695,4761,1912,10439,10788,2146,53,23636,0,0,0,0,955,417,1372
2018-09-28,7,3879,5038,2190,11502,11790,2387,56,25942,1,23,1,25,909,385,1294
2018-09-28,8,3972,5119,2318,12215,12672,2499,59,27654,187,1332,195,1714,864,343,1207
2018-09-28,9,4189,5204,2343,12162,13077,2531,61,28043,833,4338,879,6050,806,294,1100
2018-09-28,10,4458,5292,2403,12129,13583,2539,64,28528,1113,5773,1273,8159,726,332,1058
2018-09-28,11,4746,5371,2428,12100,14246,2548,70,29176,1141,6317,1424,8882,639,363,1002
2018-09-28,12,5052,5446,2434,12127,14881,2568,76,29865,1130,6503,1472,9105,591,455,1046
2018-09-28,13,5358,5565,2456,12229,15482,2617,83,30622,1118,6472,1457,9047,544,591,1135
2018-09-28,14,5694,5703,2508,12645,16217,2714,88,31875,1112,6419,1453,8984,575,771,1346
2018-09-28,15,6003,5815,2548,13077,16882,2820,92,33083,1134,6258,1456,8848,653,903,1556
2018-09-28,16,6274,5879,2603,13578,17213,2922,94,34019,1125,5854,1395,8374,751,1031,1782
2018-09-28,17,6348,5883,2636,13922,17342,3011,96,34581,1045,4885,1176,7106,871,1170,2041
2018-09-28,18,6277,5821,2600,14165,17019,3037,94,34525,628,2367,640,3635,947,1156,2103
2018-09-28,19,6149,5756,2539,14156,16421,3033,89,33909,63,218,82,363,985,1108,2093
2018-09-28,20,5981,5651,2532,14380,16130,3067,83,33869,0,0,0,0,1052,1088,2140
2018-09-28,21,5623,5379,2440,13890,15424,2932,76,32532,0,0,0,0,1074,1060,2134
2018-09-28,22,5251,5045,2248,13056,14479,2757,69,30571,0,0,0,0,1089,1007,2096
2018-09-28,23,4896,4719,2073,12089,13320,2546,62,28228,0,0,0,0,1088,932,2020
2018-09-28,24,4531,4481,1902,11162,12227,2339,57,25995,0,0,0,0,1055,913,1968
2018-09-29,1,4134,4437,1725,10669,11021,2102,51,24043,0,0,0,0,972,956,1928
2018-09-29,2,3906,4332,1646,10123,10361,2000,48,22732,0,0,0,0,912,958,1870
2018-09-29,3,3751,4262,1593,9757,9939,1929,47,21873,0,0,0,0,847,928,1775
2018-09-29,4,3635,4248,1567,9557,9685,1888,46,21377,0,0,0,0,756,915,1671
2018-09-29,5,3576,4293,1576,9545,9689,1887,47,21369,0,0,0,0,647,914,1561
2018-09-29,6,3600,4437,1656,9749,9947,1941,48,21877,0,0,0,0,558,845,1403
2018-09-29,7,3626,4564,1794,10195,10188,2028,49,22649,1,20,1,22,469,773,1242
2018-09-29,8,3655,4685,1935,10455,10178,2064,49,22927,197,1344,181,1722,376,678,1054
2018-09-29,9,3895,4862,2027,10599,10546,2134,52,23534,911,4414,879,6204,329,630,959
2018-09-29,10,4190,4997,2092,10535,10873,2135,56,23802,1217,5945,1302,8464,280,616,896
2018-09-29,11,4491,5105,2136,10439,11174,2108,61,23985,1241,6438,1463,9142,251,633,884
2018-09-29,12,4763,5221,2120,10419,11459,2094,66,24242,1222,6608,1496,9326,273,743,1016
2018-09-29,13,5028,5369,2102,10439,11942,2108,72,24764,1216,6565,1500,9281,268,887,1155
2018-09-29,14,5267,5549,2098,10644,12521,2146,76,25592,1215,6528,1501,9244,274,1049,1323
2018-09-29,15,5490,5732,2095,11011,13165,2242,79,26702,1239,6420,1505,9164,317,1148,1465
2018-09-29,16,5639,5888,2112,11444,13601,2381,82,27713,1222,6014,1441,8677,395,1216,1611
2018-09-29,17,5634,5979,2115,11734,13873,2497,82,28390,1153,5011,1221,7385,499,1303,1802
2018-09-29,18,5539,5937,2142,12231,13873,2587,79,28974,686,2365,658,3709,509,1209,1718
2018-09-29,19,5423,5890,2156,12535,13707,2674,75,29194,75,227,78,380,532,1087,1619
2018-09-29,20,5297,5776,2185,12880,13584,2750,70,29486,0,0,0,0,537,1005,1542
2018-09-29,21,5048,5467,2141,12561,13083,2666,65,28576,0,0,0,0,481,966,1447
2018-09-29,22,4746,5156,1999,12005,12469,2526,61,27261,0,0,0,0,458,923,1381
2018-09-29,23,4511,4836,1866,11342,11659,2346,56,25602,0,0,0,0,466,874,1340
2018-09-29,24,4241,4553,1733,10640,10958,2166,51,24014,0,0,0,0,447,813,1260
2018-09-30,1,3994,4350,1618,9834,10343,2144,47,22551,0,0,0,0,450,1018,1468
2018-09-30,2,3788,4232,1553,9519,9892,2006,45,21645,0,0,0,0,342,984,1326
2018-09-30,3,3645,4154,1518,9216,9480,1925,44,20848,0,0,0,0,205,915,1120
2018-09-30,4,3530,4131,1504,9104,9205,1878,42,20414,0,0,0,0,143,866,1009
2018-09-30,5,3481,4149,1519,9176,9109,1869,42,20380,0,0,0,0,122,814,936
2018-09-30,6,3492,4244,1583,9368,9196,1901,43,20692,0,0,0,0,106,711,817
2018-09-30,7,3463,4348,1701,9643,9274,1946,45,21092,1,18,1,20,102,602,704
2018-09-30,8,3486,4457,1834,9707,9171,1967,47,21073,134,1176,154,1464,98,475,573
2018-09-30,9,3702,4597,1949,9835,9444,2013,49,21522,587,4108,663,5358,78,349,427
2018-09-30,10,3977,4734,2006,9834,9720,2000,54,21789,906,5579,1079,7564,76,334,410
2018-09-30,11,4238,4829,2012,9616,10112,2006,58,21972,968,6096,1224,8288,60,334,394
2018-09-30,12,4481,4991,2018,9541,10588,2033,64,22407,1003,6255,1347,8605,58,393,451
2018-09-30,13,4716,5091,2020,9546,11217,2091,69,23103,1014,6167,1395,8576,55,505,560
2018-09-30,14,4954,5241,2016,9808,11973,2187,74,24223,1017,6066,1408,8491,69,638,707
2018-09-30,15,5139,5383,2002,10168,12724,2290,78,25441,1041,5843,1388,8272,77,704,781
2018-09-30,16,5304,5489,2018,10659,13380,2500,81,26800,1015,5271,1322,7608,84,733,817
2018-09-30,17,5293,5507,2063,11127,13945,2711,83,28047,909,4259,1118,6286,120,762,882
2018-09-30,18,5229,5454,2128,11618,14133,2846,82,28861,485,1881,579,2945,219,705,924
2018-09-30,19,5190,5461,2170,11983,14104,2936,79,29284,40,147,63,250,341,674,1015
2018-09-30,20,5122,5443,2230,12449,14015,2997,74,29716,0,0,0,0,481,652,1133
2018-09-30,21,4898,5199,2198,12211,13500,2906,68,28866,0,0,0,0,506,592,1098
2018-09-30,22,4627,4888,2032,11541,12668,2718,61,27169,0,0,0,0,507,505,1012
2018-09-30,23,4339,4585,1861,10718,11698,2471,55,25122,0,0,0,0,541,457,998
2018-09-30,24,4060,4392,1713,9960,10858,2255,50,23305,0,0,0,0,557,423,980
2018-10-01,1,3995,4365,1615,9758,10457,2190,45,22633,0,0,0,0,447,437,884
2018-10-01,2,3815,4294,1569,9503,10091,2097,43,21917,0,0,0,0,492,397,889
2018-10-01,3,3695,4249,1553,9269,9804,2036,42,21334,0,0,0,0,435,340,775
2018-10-01,4,3627,4288,1574,9230,9699,2007,42,21161,0,0,0,0,360,298,658
2018-10-01,5,3632,4471,1658,9465,9931,2051,43,21674,0,0,0,0,292,271,563
2018-10-01,6,3754,4837,1874,10107,10692,2184,47,23214,0,0,0,0,234,216,450
2018-10-01,7,3941,5157,2225,11223,11770,2415,51,25643,1,11,1,13,171,186,357
2018-10-01,8,4049,5266,2430,11900,12368,2547,54,27050,149,792,156,1097,135,161,296
2018-10-01,9,4244,5380,2402,11885,12765,2597,57,27485,727,2663,802,4192,110,153,263
2018-10-01,10,4486,5486,2375,11750,13274,2637,60,27903,1060,3620,1242,5922,106,187,293
2018-10-01,11,4685,5572,2341,11752,13870,2700,64,28568,1087,4121,1424,6632,77,247,324
2018-10-01,12,4876,5650,2329,11718,14474,2769,67,29211,1068,4244,1437,6749,61,303,364
2018-10-01,13,5063,5763,2337,11827,15129,2879,71,30087,1063,4000,1424,6487,57,353,410
2018-10-01,14,5247,5884,2342,12159,15829,2984,74,31227,1044,3893,1413,6350,73,380,453
2018-10-01,15,5430,5996,2328,12497,16282,3071,77,32109,1047,3659,1410,6116,82,401,483
2018-10-01,16,5566,6081,2334,12999,16546,3161,79,32966,1050,3377,1308,5735,95,405,500
2018-10-01,17,5564,6180,2337,13440,16742,3223,78,33664,936,2587,1063,4586,121,436,557
2018-10-01,18,5517,6047,2371,13697,16582,3315,77,33851,502,926,522,1950,148,472,620
2018-10-01,19,5529,6105,2413,13975,16440,3351,74,34021,34,51,49,134,196,463,659
2018-10-01,20,5401,5988,2497,14493,16428,3367,71,34539,0,0,0,0,245,447,692
2018-10-01,21,5188,5681,2411,13950,15742,3249,66,33188,0,0,0,0,255,382,637
2018-10-01,22,4876,5284,2226,13050,14705,3017,60,31012,0,0,0,0,238,328,566
2018-10-01,23,4509,4915,2018,11960,13440,2707,54,28342,0,0,0,0,260,313,573
2018-10-01,24,4187,4641,1846,10989,12271,2441,49,25933,0,0,0,0,258,279,537
2018-10-02,1,4206,4468,1709,10472,11344,2345,50,24390,0,0,0,0,228,272,500
2018-10-02,2,4032,4377,1642,10076,10844,2239,48,23385,0,0,0,0,184,260,444
2018-10-02,3,3892,4326,1606,9816,10543,2154,46,22739,0,0,0,0,155,236,391
2018-10-02,4,3824,4362,1601,9689,10328,2121,46,22364,0,0,0,0,121,257,378
2018-10-02,5,3837,4532,1655,9859,10553,2156,47,22793,0,0,0,0,105,243,348
2018-10-02,6,3945,4888,1854,10437,11256,2314,51,24236,0,0,0,0,93,215,308
2018-10-02,7,4126,5182,2186,11669,12334,2605,54,26841,0,10,1,11,91,232,323
2018-10-02,8,4177,5258,2381,12472,12748,2719,56,28175,97,695,127,919,103,281,384
2018-10-02,9,4359,5359,2343,12612,12938,2749,59,28541,422,2226,569,3217,129,380,509
2018-10-02,10,4574,5456,2331,12548,13129,2753,62,28675,660,3558,1007,5225,118,527,645
2018-10-02,11,4750,5550,2315,12490,13406,2747,66,28891,730,4116,1177,6023,115,730,845
2018-10-02,12,4920,5655,2323,12463,13681,2741,70,29138,741,4382,1252,6375,75,901,976
2018-10-02,13,5091,5788,2344,12454,13887,2746,73,29342,723,4661,1263,6647,60,1091,1151
2018-10-02,14,5275,5909,2361,12670,14254,2779,75,29958,691,4687,1249,6627,63,1260,1323
2018-10-02,15,5452,6010,2362,12839,14390,2821,77,30306,679,4602,1219,6500,77,1366,1443
2018-10-02,16,5587,6093,2365,13074,14518,2859,78,30709,649,4560,1153,6362,149,1451,1600
2018-10-02,17,5614,6155,2370,13318,14490,2908,77,30974,558,3781,915,5254,197,1526,1723
2018-10-02,18,5568,6002,2369,13454,14175,2929,74,30811,235,1560,437,2232,220,1485,1705
2018-10-02,19,5553,6057,2408,13628,14053,3019,71,30952,20,102,34,156,311,1381,1692
2018-10-02,20,5457,5946,2484,14174,14203,3112,69,31738,0,0,0,0,489,1279,1768
2018-10-02,21,5252,5658,2391,13737,13727,2981,65,30690,0,0,0,0,488,1169,1657
2018-10-02,22,4968,5279,2212,12908,13041,2762,60,28951,0,0,0,0,466,1070,1536
2018-10-02,23,4639,4915,2020,11901,12001,2484,55,26622,0,0,0,0,450,954,1404
2018-10-02,24,4323,4635,1859,11012,11119,2270,50,24632,0,0,0,0,439,880,1319
2018-10-03,1,3899,4440,1735,10565,10743,2213,48,23747,0,0,0,0,647,971,1618
2018-10-03,2,3724,4343,1672,10155,10238,2125,46,22742,0,0,0,0,630,962,1592
2018-10-03,3,3606,4292,1640,9898,10012,2054,44,22186,0,0,0,0,598,928,1526
2018-10-03,4,3541,4323,1648,9594,9573,2027,44,21415,0,0,0,0,554,885,1439
2018-10-03,5,3561,4490,1717,9779,9714,2058,45,21774,0,0,0,0,500,829,1329
2018-10-03,6,3693,4835,1935,10371,10402,2193,47,23191,0,0,0,0,409,774,1183
2018-10-03,7,3881,5130,2289,11537,11540,2438,50,25743,0,15,0,15,351,696,1047
2018-10-03,8,3888,5205,2487,12256,12125,2529,52,27140,59,1006,99,1164,254,606,860
2018-10-03,9,4040,5304,2448,12525,12808,2538,55,28105,287,3429,371,4087,239,556,795
2018-10-03,10,4205,5395,2408,12658,13121,2507,59,28525,464,4863,760,6087,218,511,729
2018-10-03,11,4336,5471,2362,12707,13300,2479,62,28727,524,5480,883,6887,197,457,654
2018-10-03,12,4474,5548,2323,12624,13333,2443,64,28643,520,5690,1029,7239,196,502,698
2018-10-03,13,4630,5644,2322,12531,13410,2438,65,28623,569,5496,1008,7073,203,580,783
2018-10-03,14,4777,5731,2316,12694,13646,2505,66,29090,537,5392,968,6897,227,672,899
2018-10-03,15,4927,5814,2296,12769,13811,2592,67,29419,528,5209,899,6636,271,829,1100
2018-10-03,16,5021,5893,2297,12947,13803,2665,68,29663,530,4761,865,6156,347,1006,1353
2018-10-03,17,5017,5849,2313,13166,13758,2714,66,29882,431,3830,654,4915,464,1202,1666
2018-10-03,18,4934,5758,2317,13339,13360,2732,64,29673,159,1501,278,1938,543,1203,1746
2018-10-03,19,4936,5843,2377,13515,13259,2816,63,29831,13,93,19,125,550,1175,1725
2018-10-03,20,4861,5742,2477,14051,13550,2940,62,30780,0,0,0,0,589,1160,1749
2018-10-03,21,4689,5464,2399,13674,13178,2833,60,29923,0,0,0,0,622,1148,1770
2018-10-03,22,4448,5120,2243,12915,12440,2653,56,28242,0,0,0,0,651,1162,1813
2018-10-03,23,4177,4809,2044,11904,11400,2401,51,25934,0,0,0,0,639,1201,1840
2018-10-03,24,3913,4567,1877,11003,10527,2204,47,23959,0,0,0,0,632,1297,1929
2018-10-04,1,3689,4397,1767,10584,10399,2167,46,23373,0,0,0,0,603,1262,1865
2018-10-04,2,3527,4305,1712,10166,9996,2081,44,22465,0,0,0,0,609,1325,1934
2018-10-04,3,3403,4260,1681,9852,9669,2017,43,21758,0,0,0,0,586,1312,1898
2018-10-04,4,3356,4298,1681,9724,9560,1987,42,21491,0,0,0,0,563,1357,1920
2018-10-04,5,3374,4467,1748,9889,9750,2022,44,21882,0,0,0,0,544,1420,1964
2018-10-04,6,3514,4821,1964,10473,10462,2164,47,23323,0,0,0,0,518,1465,1983
2018-10-04,7,3694,5113,2312,11582,11472,2430,51,25712,0,14,1,15,474,1367,1841
2018-10-04,8,3717,5178,2495,12222,11720,2523,53,26695,89,1099,124,1312,457,1347,1804
2018-10-04,9,3834,5261,2453,11967,11470,2550,55,26221,426,3895,639,4960,481,1238,1719
2018-10-04,10,3973,5335,2423,11869,11598,2539,59,26243,657,5564,1040,7261,484,1119,1603
2018-10-04,11,4082,5402,2380,11790,11737,2509,61,26275,817,6131,1207,8155,444,962,1406
2018-10-04,12,4184,5453,2338,11614,11782,2475,63,26112,905,6308,1285,8498,401,1043,1444
2018-10-04,13,4304,5507,2337,11514,11890,2467,66,26114,929,6204,1335,8468,379,1199,1578
2018-10-04,14,4446,5549,2332,11678,12151,2497,68,26571,931,6144,1340,8415,387,1511,1898
2018-10-04,15,4597,5603,2304,11859,12451,2549,69,27105,931,6069,1289,8289,444,1878,2322
2018-10-04,16,4692,5654,2287,12121,12755,2614,70,27737,909,5757,1194,7860,543,2097,2640
2018-10-04,17,4668,5645,2293,12475,12980,2687,71,28390,781,4733,994,6508,632,2308,2940
2018-10-04,18,4601,5604,2307,12640,12867,2734,68,28486,370,1984,427,2781,632,2445,3077
2018-10-04,19,4625,5734,2371,12881,12878,2837,67,28840,50,166,31,247,628,2486,3114
2018-10-04,20,4602,5671,2467,13414,13216,2941,66,29815,0,0,0,0,638,2623,3261
2018-10-04,21,4473,5445,2424,13109,12870,2841,63,29060,0,0,0,0,653,2670,3323
2018-10-04,22,4256,5130,2270,12428,12183,2650,59,27497,0,0,0,0,634,2693,3327
2018-10-04,23,3969,4813,2076,11506,11322,2393,54,25453,0,0,0,0,614,2695,3309
2018-10-04,24,3707,4571,1916,10674,10604,2193,50,23697,0,0,0,0,613,2720,3333
2018-10-05,1,3564,4370,1797,10040,10199,2083,46,22544,0,0,0,0,579,2665,3244
2018-10-05,2,3416,4292,1739,9679,9762,2000,44,21662,0,0,0,0,568,2692,3260
2018-10-05,3,3304,4253,1713,9419,9511,1933,43,21083,0,0,0,0,526,2691,3217
2018-10-05,4,3255,4298,1721,9337,9351,1911,43,20819,0,0,0,0,460,2634,3094
2018-10-05,5,3270,4466,1793,9508,9522,1944,45,21195,0,0,0,0,399,2520,2919
2018-10-05,6,3412,4807,2002,10062,10140,2070,48,22496,0,0,0,0,337,2361,2698
2018-10-05,7,3575,5102,2338,11146,11117,2309,51,24799,0,14,0,14,263,2148,2411
2018-10-05,8,3596,5168,2530,11770,11369,2391,53,25759,142,1187,129,1458,188,1823,2011
2018-10-05,9,3729,5224,2493,11609,11514,2416,54,25769,770,4155,683,5608,151,1386,1537
2018-10-05,10,3880,5276,2455,11391,11665,2389,55,25676,1060,5851,1116,8027,137,959,1096
2018-10-05,11,4004,5323,2403,11110,11834,2326,57,25503,1122,6344,1297,8763,108,611,719
2018-10-05,12,4107,5352,2341,10798,11860,2276,59,25170,1108,6495,1380,8983,86,423,509
2018-10-05,13,4220,5383,2309,10693,12073,2274,62,25278,1097,6454,1421,8972,82,332,414
2018-10-05,14,4353,5400,2283,10931,12503,2325,64,25999,1086,6459,1426,8971,90,340,430
2018-10-05,15,4516,5398,2240,11103,12839,2398,65,26581,1100,6377,1420,8897,125,485,610
2018-10-05,16,4651,5400,2218,11540,13250,2457,67,27490,1074,5928,1354,8356,192,817,1009
2018-10-05,17,4703,5396,2220,12085,13551,2537,69,28418,950,4771,1124,6845,292,1241,1533
2018-10-05,18,4667,5351,2238,12507,13470,2569,68,28791,482,1972,532,2986,351,1506,1857
2018-10-05,19,4691,5494,2298,12634,13314,2645,67,28836,37,151,40,228,390,1758,2148
2018-10-05,20,4623,5447,2384,13045,13321,2726,66,29334,0,0,0,0,484,1961,2445
2018-10-05,21,4473,5270,2311,12645,12844,2637,63,28364,0,0,0,0,511,1980,2491
2018-10-05,22,4268,5039,2162,12010,12237,2502,59,26983,0,0,0,0,528,1963,2491
2018-10-05,23,4024,4782,2006,11298,11421,2319,53,25267,0,0,0,0,522,1913,2435
2018-10-05,24,3775,4549,1865,10528,10567,2133,49,23453,0,0,0,0,496,1901,2397
2018-10-06,1,3532,4360,1786,9871,10012,2057,43,22161,0,0,0,0,520,2173,2693
2018-10-06,2,3375,4288,1723,9456,9522,1960,41,21157,0,0,0,0,449,2177,2626
2018-10-06,3,3265,4248,1686,9173,9220,1896,41,20507,0,0,0,0,430,2241,2671
2018-10-06,4,3197,4257,1672,9037,9009,1861,41,20126,0,0,0,0,413,2251,2664
2018-10-06,5,3194,4322,1694,9071,9000,1866,41,20156,0,0,0,0,397,2265,2662
2018-10-06,6,3262,4474,1770,9277,9334,1918,43,20749,0,0,0,0,421,2296,2717
2018-10-06,7,3295,4612,1907,9737,9634,2096,45,21690,0,10,0,10,402,2332,2734
2018-10-06,8,3260,4705,2050,9982,9652,2146,47,22003,142,1011,157,1310,388,2354,2742
2018-10-06,9,3446,4798,2147,10173,9877,2127,48,22401,803,3836,799,5438,324,2423,2747
2018-10-06,10,3608,4851,2195,10051,10032,2126,49,22436,1150,5523,1235,7908,220,2444,2664
2018-10-06,11,3726,4891,2183,9899,10135,2074,51,22337,1196,6065,1421,8682,233,2448,2681
2018-10-06,12,3825,4930,2147,9714,10257,2022,54,22223,1157,6253,1478,8888,221,2678,2899
2018-10-06,13,3911,4943,2119,9635,10423,2006,56,22298,1159,6164,1511,8834,210,2860,3070
2018-10-06,14,4022,4957,2091,9706,10718,2030,58,22689,1166,6074,1502,8742,207,3005,3212
2018-10-06,15,4177,4978,2066,9959,11118,2096,60,23411,1200,5944,1491,8635,218,3175,3393
2018-10-06,16,4277,5013,2066,10367,11533,2205,62,24345,1206,5564,1423,8193,228,3307,3535
2018-10-06,17,4331,5097,2086,10748,11740,2314,64,25044,1031,4465,1165,6661,282,3367,3649
2018-10-06,18,4292,5116,2111,11240,11713,2397,63,25590,503,1785,543,2831,282,3296,3578
2018-10-06,19,4316,5307,2170,11645,11781,2527,61,26191,56,140,42,238,274,3208,3482
2018-10-06,20,4283,5310,2262,12192,12010,2658,59,27096,0,0,0,0,353,3119,3472
2018-10-06,21,4172,5140,2200,11844,11699,2576,56,26352,0,0,0,0,404,3131,3535
2018-10-06,22,3985,4915,2082,11389,11223,2442,53,25284,0,0,0,0,468,3138,3606
2018-10-06,23,3748,4667,1944,10697,10555,2276,49,23755,0,0,0,0,558,3095,3653
2018-10-06,24,3549,4457,1814,10042,9949,2115,45,22328,0,0,0,0,657,2982,3639
2018-10-07,1,3327,4280,1714,9831,9546,2067,43,21663,0,0,0,0,814,2474,3288
2018-10-07,2,3167,4213,1656,9423,9098,1960,42,20700,0,0,0,0,847,2150,2997
2018-10-07,3,3086,4169,1633,9164,8858,1889,41,20129,0,0,0,0,856,2010,2866
2018-10-07,4,3035,4172,1629,8999,8674,1860,41,19751,0,0,0,0,864,1849,2713
2018-10-07,5,3023,4213,1661,8980,8633,1850,42,19681,0,0,0,0,878,1700,2578
2018-10-07,6,3047,4319,1731,9097,8730,1878,43,19924,0,0,0,0,892,1555,2447
2018-10-07,7,3071,4431,1870,9366,8843,1932,45,20363,0,8,0,8,883,1407,2290
2018-10-07,8,3045,4511,2020,9454,8740,1965,47,20383,158,933,168,1259,891,1217,2108
2018-10-07,9,3197,4559,2137,9542,8935,2054,49,20759,902,3620,873,5395,899,939,1838
2018-10-07,10,3363,4591,2181,9638,9134,2077,50,21077,1258,5250,1314,7822,911,764,1675
2018-10-07,11,3489,4607,2150,9494,9181,2018,51,20921,1297,5909,1502,8708,888,715,1603
2018-10-07,12,3589,4687,2097,9425,9285,1971,52,20910,1277,6028,1532,8837,861,717,1578
2018-10-07,13,3692,4689,2078,9483,9451,1955,53,21118,1264,5838,1536,8638,815,682,1497
2018-10-07,14,3807,4735,2059,9689,9691,1986,54,21596,1268,5704,1531,8503,785,672,1457
2018-10-07,15,3960,4774,2036,10079,10104,2048,55,22462,1290,5455,1531,8276,767,695,1462
2018-10-07,16,4119,4868,2037,10603,10576,2139,57,23551,1276,5012,1460,7748,727,802,1529
2018-10-07,17,4162,4952,2070,11159,10903,2238,60,24537,1139,3895,1185,6219,691,984,1675
2018-10-07,18,4200,4988,2136,11720,11130,2356,59,25442,540,1428,538,2506,647,1056,1703
2018-10-07,19,4299,5194,2228,12255,11544,2564,59,26599,33,104,43,180,676,1163,1839
2018-10-07,20,4295,5227,2322,12760,11932,2630,59,27557,0,0,0,0,662,1273,1935
2018-10-07,21,4178,5043,2260,12455,11618,2546,57,26852,0,0,0,0,645,1192,1837
2018-10-07,22,3979,4766,2112,11821,11041,2405,53,25497,0,0,0,0,603,1073,1676
2018-10-07,23,3703,4510,1932,10939,10320,2194,49,23678,0,0,0,0,557,893,1450
2018-10-07,24,3477,4341,1781,10161,9589,2032,45,22003,0,0,0,0,560,719,1279
2018-10-08,1,3225,4269,1657,9298,9501,1910,43,20927,0,0,0,0,523,777,1300
2018-10-08,2,3113,4235,1609,8991,9120,1859,42,20189,0,0,0,0,557,645,1202
2018-10-08,3,3043,4227,1594,8823,8892,1809,42,19742,0,0,0,0,588,547,1135
2018-10-08,4,3039,4295,1599,8778,8821,1788,42,19605,0,0,0,0,616,482,1098
2018-10-08,5,3074,4482,1681,9051,9115,1819,44,20205,0,0,0,0,603,434,1037
2018-10-08,6,3212,4879,1895,9669,9818,1944,47,21653,0,0,0,0,538,393,931
2018-10-08,7,3407,5202,2247,10702,10738,2173,50,23839,0,7,0,7,448,341,789
2018-10-08,8,3425,5218,2442,11296,11025,2267,52,24816,149,1083,164,1396,392,294,686
2018-10-08,9,3497,5222,2420,11281,11200,2282,53,24992,902,4082,856,5840,408,291,699
2018-10-08,10,3588,5232,2415,11153,11407,2272,54,25063,1267,5881,1312,8460,452,299,751
2018-10-08,11,3690,5260,2389,11104,11592,2204,55,25131,1306,6443,1501,9250,480,295,775
2018-10-08,12,3771,5293,2356,11070,11751,2152,56,25205,1279,6577,1535,9391,440,297,737
2018-10-08,13,3849,5319,2365,11066,12021,2135,57,25457,1260,6509,1533,9302,387,292,679
2018-10-08,14,3959,5344,2375,11367,12417,2162,58,26182,1264,6474,1527,9265,353,302,655
2018-10-08,15,4067,5349,2357,11709,12831,2216,60,26993,1287,6365,1532,9184,310,378,688
2018-10-08,16,4176,5370,2340,12239,13279,2319,61,28074,1281,5960,1452,8693,254,495,749
2018-10-08,17,4240,5418,2329,12734,13457,2434,62,28864,1141,4737,1172,7050,207,719,926
2018-10-08,18,4240,5440,2350,13038,13408,2508,62,29193,528,1772,517,2817,133,885,1018
2018-10-08,19,4344,5613,2439,13279,13559,2653,62,29729,32,130,34,196,102,1008,1110
2018-10-08,20,4345,5577,2527,13589,13788,2788,63,30404,0,0,0,0,118,1192,1310
2018-10-08,21,4207,5348,2429,12973,13272,2668,59,29148,0,0,0,0,116,1180,1296
2018-10-08,22,3983,5016,2249,12169,12635,2476,55,27511,0,0,0,0,116,1184,1300
2018-10-08,23,3713,4699,2054,11230,11623,2245,51,25325,0,0,0,0,143,1232,1375
2018-10-08,24,3455,4507,1887,10467,10718,2052,48,23461,0,0,0,0,174,1300,1474
2018-10-09,1,3204,4409,1740,10040,9801,1935,42,21996,0,0,0,0,203,1105,1308
2018-10-09,2,3089,4350,1671,9683,9494,1854,41,21250,0,0,0,0,240,1003,1243
2018-10-09,3,3020,4330,1640,9399,9253,1807,41,20679,0,0,0,0,198,884,1082
2018-10-09,4,2993,4397,1637,9304,9180,1791,41,20495,0,0,0,0,173,770,943
2018-10-09,5,3034,4596,1701,9498,9415,1823,43,20958,0,0,0,0,166,663,829
2018-10-09,6,3166,4990,1910,10026,9956,1949,48,22156,0,0,0,0,149,534,683
2018-10-09,7,3365,5278,2246,11117,10977,2215,52,24538,0,9,0,9,132,446,578
2018-10-09,8,3380,5286,2434,11746,11253,2285,54,25514,146,1154,163,1463,116,374,490
2018-10-09,9,3437,5277,2409,11652,11371,2283,54,25536,912,4270,871,6053,96,263,359
2018-10-09,10,3508,5267,2399,11480,11540,2265,54,25516,1290,5907,1341,8538,86,184,270
2018-10-09,11,3589,5265,2369,11372,11636,2234,54,25473,1314,6426,1513,9253,83,173,256
2018-10-09,12,3672,5273,2361,11300,11754,2195,55,25480,1289,6560,1543,9392,66,188,254
2018-10-09,13,3787,5300,2372,11310,11949,2188,56,25680,1259,6474,1535,9268,67,231,298
2018-10-09,14,3949,5313,2372,11551,12242,2235,58,26262,1258,6495,1535,9288,78,316,394
2018-10-09,15,4123,5314,2350,11874,12584,2303,60,26997,1276,6404,1540,9220,105,526,631
2018-10-09,16,4277,5338,2336,12251,12870,2366,61,27725,1262,6047,1452,8761,172,800,972
2018-10-09,17,4362,5372,2340,12674,13077,2460,63,28450,1114,4774,1177,7065,309,1153,1462
2018-10-09,18,4391,5419,2373,12923,12857,2533,62,28551,505,1688,509,2702,494,1326,1820
2018-10-09,19,4466,5594,2453,13299,13047,2675,61,29260,22,118,30,170,722,1363,2085
2018-10-09,20,4419,5569,2534,13643,13241,2782,61,29903,0,0,0,0,873,1515,2388
2018-10-09,21,4253,5341,2445,13112,12735,2666,58,28747,0,0,0,0,887,1578,2465
2018-10-09,22,4027,5011,2275,12330,12039,2478,53,27078,0,0,0,0,876,1697,2573
2018-10-09,23,3723,4706,2076,11328,11100,2234,49,24889,0,0,0,0,871,1763,2634
2018-10-09,24,3454,4500,1905,10514,10278,2037,45,23052,0,0,0,0,831,1837,2668
2018-10-10,1,3299,4373,1781,9961,9811,1940,43,21937,0,0,0,0,630,2181,2811
2018-10-10,2,3184,4324,1721,9568,9472,1858,42,21123,0,0,0,0,538,2169,2707
2018-10-10,3,3111,4298,1690,9343,9236,1809,42,20611,0,0,0,0,463,2013,2476
2018-10-10,4,3083,4364,1697,9291,9167,1820,42,20500,0,0,0,0,434,1786,2220
2018-10-10,5,3119,4553,1769,9464,9345,1862,44,20898,0,0,0,0,419,1534,1953
2018-10-10,6,3241,4934,1997,10053,10003,1951,48,22238,0,0,0,0,394,1221,1615
2018-10-10,7,3441,5235,2358,11139,10964,2196,53,24532,0,9,0,9,340,941,1281
2018-10-10,8,3455,5237,2557,11751,11247,2317,55,25547,129,1041,143,1313,281,765,1046
2018-10-10,9,3512,5217,2519,11616,11363,2350,56,25562,815,4117,811,5743,250,603,853
2018-10-10,10,3621,5201,2474,11412,11528,2334,56,25507,1137,5794,1278,8209,220,453,673
2018-10-10,11,3726,5192,2429,11182,11607,2253,56,25275,1189,6396,1460,9045,175,322,497
2018-10-10,12,3805,5193,2373,11020,11638,2196,57,25088,1175,6526,1496,9197,114,311,425
2018-10-10,13,3902,5213,2343,10928,11755,2178,58,25096,1165,6388,1497,9050,82,340,422
2018-10-10,14,4028,5221,2331,11114,12026,2226,60,25603,1158,6362,1497,9017,72,391,463
2018-10-10,15,4166,5226,2309,11383,12292,2302,61,26214,1171,6235,1498,8904,75,481,556
2018-10-10,16,4291,5258,2293,11723,12572,2360,62,26895,1189,5746,1404,8339,98,623,721
2018-10-10,17,4400,5280,2296,12112,12755,2455,63,27566,1049,4519,1131,6699,154,814,968
2018-10-10,18,4372,5333,2336,12497,12717,2599,62,28056,462,1561,489,2512,257,919,1176
2018-10-10,19,4482,5515,2419,12949,12958,2728,62,28878,49,103,30,182,408,999,1407
2018-10-10,20,4481,5492,2491,13372,13185,2797,61,29596,0,0,0,0,571,1173,1744
2018-10-10,21,4332,5276,2434,12954,12746,2701,58,28639,0,0,0,0,603,1170,1773
2018-10-10,22,4095,4953,2279,12177,11983,2550,54,26945,0,0,0,0,628,1180,1808
2018-10-10,23,3807,4660,2087,11181,10969,2288,50,24668,0,0,0,0,649,1057,1706
2018-10-10,24,3533,4467,1923,10367,10160,2078,46,22833,0,0,0,0,650,945,1595
2018-10-11,1,3285,4436,1797,9851,9702,1926,44,21705,0,0,0,0,734,957,1691
2018-10-11,2,3165,4386,1747,9477,9322,1856,43,20880,0,0,0,0,733,908,1641
2018-10-11,3,3091,4370,1724,9219,9087,1808,43,20337,0,0,0,0,719,919,1638
2018-10-11,4,3065,4435,1738,9191,9064,1785,43,20261,0,0,0,0,684,925,1609
2018-10-11,5,3105,4630,1819,9298,9239,1815,45,20576,0,0,0,0,647,932,1579
2018-10-11,6,3243,5015,2054,9884,9895,1953,48,21960,0,0,0,0,566,885,1451
2018-10-11,7,3450,5305,2421,11019,10948,2207,53,24408,0,6,0,6,461,809,1270
2018-10-11,8,3461,5304,2619,11685,11217,2291,54,25427,112,850,103,1065,404,720,1124
2018-10-11,9,3552,5282,2556,11545,11301,2287,56,25366,742,3486,592,4820,348,533,881
2018-10-11,10,3650,5259,2499,11317,11440,2266,57,25256,1075,5221,984,7280,289,392,681
2018-10-11,11,3748,5237,2438,11075,11524,2223,57,25055,1135,5815,1194,8144,226,281,507
2018-10-11,12,3830,5224,2357,10848,11558,2174,57,24814,1135,5937,1288,8360,189,266,455
2018-10-11,13,3916,5241,2315,10737,11650,2157,58,24778,1135,5737,1298,8170,173,281,454
2018-10-11,14,4036,5252,2297,10892,11855,2191,58,25173,1137,5626,1309,8072,170,296,466
2018-10-11,15,4184,5255,2264,11060,12074,2234,59,25605,1151,5411,1279,7841,175,315,490
2018-10-11,16,4262,5274,2240,11430,12318,2303,59,26290,1133,4945,1217,7295,187,331,518
2018-10-11,17,4311,5304,2241,11728,12431,2396,61,26794,986,3783,941,5710,207,380,587
2018-10-11,18,4308,5356,2276,12108,12380,2472,59,27197,426,1227,377,2030,232,386,618
2018-10-11,19,4418,5525,2362,12601,12665,2631,59,28136,20,71,19,110,291,404,695
2018-10-11,20,4429,5502,2421,13054,12918,2735,60,28947,0,0,0,0,347,481,828
2018-10-11,21,4292,5291,2377,12678,12526,2623,58,28066,0,0,0,0,421,482,903
2018-10-11,22,4083,4985,2236,11997,11854,2445,54,26531,0,0,0,0,522,312,834
2018-10-11,23,3798,4700,2050,11130,10980,2206,50,24545,0,0,0,0,577,210,787
2018-10-11,24,3539,4502,1897,10388,10224,2017,46,22858,0,0,0,0,577,182,759
2018-10-12,1,3284,4434,1821,9943,9700,1927,41,21795,0,0,0,0,496,264,760
2018-10-12,2,3155,4384,1769,9549,9298,1853,40,20924,0,0,0,0,484,289,773
2018-10-12,3,3076,4367,1747,9293,9065,1802,40,20383,0,0,0,0,419,316,735
2018-10-12,4,3055,4423,1753,9215,8949,1781,41,20169,0,0,0,0,355,371,726
2018-10-12,5,3087,4604,1827,9398,9182,1812,42,20618,0,0,0,0,278,394,672
2018-10-12,6,3221,4953,2040,9956,9813,1933,46,21931,0,0,0,0,250,416,666
2018-10-12,7,3407,5248,2377,10937,10817,2170,50,24156,0,5,0,5,226,439,665
2018-10-12,8,3403,5269,2570,11639,11091,2235,51,25198,125,720,150,995,221,462,683
2018-10-12,9,3500,5251,2521,11540,11172,2250,51,25197,896,3070,824,4790,214,479,693
2018-10-12,10,3613,5227,2464,11321,11239,2235,50,25028,1303,4678,1322,7303,214,630,844
2018-10-12,11,3726,5198,2396,11105,11466,2196,50,25001,1337,5306,1481,8124,213,723,936
2018-10-12,12,3812,5171,2329,10973,11731,2181,50,25119,1317,5554,1521,8392,177,737,914
2018-10-12,13,3897,5168,2301,10928,12058,2201,52,25423,1295,5477,1525,8297,142,721,863
2018-10-12,14,4015,5163,2291,11191,12524,2270,53,26220,1291,5326,1526,8143,116,683,799
2018-10-12,15,4162,5150,2279,11397,12909,2340,54,26882,1307,5168,1535,8010,103,619,722
2018-10-12,16,4294,5150,2280,11822,13248,2426,55,27735,1309,4813,1447,7569,101,544,645
2018-10-12,17,4361,5150,2289,12266,13554,2535,57,28594,1158,3678,1168,6004,126,502,628
2018-10-12,18,4317,5182,2302,12657,13432,2604,56,28930,506,1195,471,2172,141,410,551
2018-10-12,19,4381,5318,2331,13010,13478,2724,55,29447,21,94,23,138,167,312,479
2018-10-12,20,4339,5280,2327,13233,13531,2775,54,29773,0,0,0,0,207,283,490
2018-10-12,21,4197,5119,2229,12767,13033,2676,52,28709,0,0,0,0,267,277,544
2018-10-12,22,4019,4898,2104,12092,12434,2525,49,27282,0,0,0,0,313,294,607
2018-10-12,23,3798,4663,1967,11223,11594,2334,46,25378,0,0,0,0,369,315,684
2018-10-12,24,3570,4461,1835,10428,10747,2140,43,23539,0,0,0,0,382,341,723
2018-10-13,1,3364,4348,1772,9774,10217,2033,43,22249,0,0,0,0,516,487,1003
2018-10-13,2,3211,4288,1714,9341,9726,1943,41,21234,0,0,0,0,465,513,978
2018-10-13,3,3119,4259,1680,9102,9473,1884,41,20682,0,0,0,0,412,510,922
2018-10-13,4,3064,4269,1674,8930,9291,1851,41,20296,0,0,0,0,338,522,860
2018-10-13,5,3070,4337,1705,8952,9305,1852,41,20333,0,0,0,0,274,554,828
2018-10-13,6,3137,4482,1795,9149,9564,1905,43,20843,0,0,0,0,252,555,807
2018-10-13,7,3189,4640,1947,9560,9876,2029,45,21693,0,3,0,3,230,580,810
2018-10-13,8,3168,4718,2109,9806,9973,2149,47,22156,130,616,125,871,221,540,761
2018-10-13,9,3299,4790,2212,9933,10326,2286,48,22777,908,2672,752,4332,210,484,694
2018-10-13,10,3454,4816,2229,9879,10497,2368,49,22975,1308,4276,1226,6810,198,443,641
2018-10-13,11,3576,4823,2193,9683,10686,2357,49,22952,1343,4983,1415,7741,175,414,589
2018-10-13,12,3668,4824,2132,9529,10654,2284,50,22694,1321,5264,1465,8050,152,464,616
2018-10-13,13,3753,4809,2097,9536,10710,2218,50,22692,1298,5166,1464,7928,141,506,647
2018-10-13,14,3901,4809,2063,9716,10653,2168,52,22766,1295,5103,1465,7863,143,600,743
2018-10-13,15,4052,4827,2033,10019,10711,2143,54,23104,1310,4934,1468,7712,174,894,1068
2018-10-13,16,4195,4883,2037,10555,10796,2127,52,23709,1314,4597,1390,7301,204,1297,1501
2018-10-13,17,4287,4954,2046,11068,10951,2190,53,24441,1160,3502,1109,5771,268,1726,1994
2018-10-13,18,4270,5058,2083,11598,10879,2319,53,25027,503,1099,449,2051,336,1888,2224
2018-10-13,19,4353,5229,2166,12175,11117,2461,53,25987,18,104,21,143,439,2008,2447
2018-10-13,20,4272,5200,2208,12425,11378,2531,54,26569,0,0,0,0,552,2108,2660
2018-10-13,21,4136,5039,2149,11968,11105,2494,53,25800,0,0,0,0,614,2144,2758
2018-10-13,22,3979,4832,2051,11419,10791,2383,51,24825,0,0,0,0,645,2113,2758
2018-10-13,23,3738,4607,1931,10688,10277,2207,48,23401,0,0,0,0,650,2097,2747
2018-10-13,24,3504,4420,1814,9987,9759,2036,45,22008,0,0,0,0,605,2037,2642
2018-10-14,1,3290,4340,1746,9587,9455,1937,43,21205,0,0,0,0,674,1833,2507
2018-10-14,2,3130,4284,1697,9222,9056,1853,42,20355,0,0,0,0,604,1678,2282
2018-10-14,3,3038,4251,1680,8955,8768,1798,42,19745,0,0,0,0,518,1437,1955
2018-10-14,4,2989,4262,1684,8788,8598,1764,41,19374,0,0,0,0,484,1163,1647
2018-10-14,5,2977,4307,1721,8774,8565,1767,42,19330,0,0,0,0,492,967,1459
2018-10-14,6,2992,4417,1800,8881,8694,1828,43,19631,0,0,0,0,522,741,1263
2018-10-14,7,3038,4554,1937,9141,8924,1906,46,20201,0,5,0,5,566,586,1152
2018-10-14,8,2999,4636,2105,9251,8834,1916,47,20235,130,855,133,1118,634,507,1141
2018-10-14,9,3106,4670,2216,9315,8902,1955,50,20401,907,3716,846,5469,712,387,1099
2018-10-14,10,3244,4679,2244,9271,9060,2006,50,20565,1308,5484,1328,8120,775,369,1144
2018-10-14,11,3356,4683,2204,9176,9148,1994,50,20546,1341,6045,1502,8888,767,439,1206
2018-10-14,12,3442,4751,2131,9118,9269,1944,49,20558,1319,6225,1534,9078,690,529,1219
2018-10-14,13,3508,4734,2085,9152,9431,1896,49,20706,1297,6151,1532,8980,644,586,1230
2018-10-14,14,3600,4764,2052,9322,9644,1892,50,21086,1295,6115,1535,8945,629,588,1217
2018-10-14,15,3698,4790,2026,9563,9979,1950,50,21721,1310,5992,1542,8844,598,597,1195
2018-10-14,16,3801,4879,2023,10047,10381,2093,52,22753,1314,5665,1451,8430,553,615,1168
2018-10-14,17,3817,4947,2055,10560,10796,2256,55,23846,1160,4493,1159,6812,531,617,1148
2018-10-14,18,3847,5059,2138,11282,11067,2449,54,25032,504,1492,471,2467,552,683,1235
2018-10-14,19,3991,5249,2254,11953,11599,2654,56,26444,16,147,20,183,540,658,1198
2018-10-14,20,3987,5236,2328,12451,11943,2713,57,27347,0,0,0,0,558,693,1251
2018-10-14,21,3854,5070,2282,12193,11637,2617,54,26684,0,0,0,0,551,605,1156
2018-10-14,22,3660,4813,2150,11497,11110,2487,50,25327,0,0,0,0,516,564,1080
2018-10-14,23,3611,4580,1980,10666,10422,2290,47,23609,0,0,0,0,497,575,1072
2018-10-14,24,3424,4439,1833,9859,9708,2098,44,21893,0,0,0,0,487,559,1046
2018-10-15,1,3221,4363,1740,9694,8938,1908,42,20767,0,0,0,0,500,616,1116
2018-10-15,2,3127,4352,1705,9353,8695,1838,41,20113,0,0,0,0,455,654,1109
2018-10-15,3,3083,4365,1702,9105,8576,1788,42,19696,0,0,0,0,436,654,1090
2018-10-15,4,3082,4459,1732,9004,8576,1768,42,19575,0,0,0,0,453,659,1112
2018-10-15,5,3142,4679,1837,9193,8875,1804,45,20103,0,0,0,0,453,596,1049
2018-10-15,6,3304,5088,2089,9710,9605,1944,51,21496,0,0,0,0,429,637,1066
2018-10-15,7,3537,5412,2473,10798,10632,2142,59,23816,0,4,0,4,414,674,1088
2018-10-15,8,3558,5399,2686,11517,10889,2228,59,24878,113,926,135,1174,376,671,1047
2018-10-15,9,3577,5340,2624,11564,11038,2241,58,25088,826,3954,851,5631,319,778,1097
2018-10-15,10,3594,5280,2557,11455,11172,2223,56,25095,1204,5826,1358,8388,288,954,1242
2018-10-15,11,3597,5216,2487,11380,11286,2205,55,25110,1241,6390,1515,9146,218,1080,1298
2018-10-15,12,3586,5165,2396,11282,11373,2195,55,25089,1219,6513,1550,9282,161,1174,1335
2018-10-15,13,3589,5144,2356,11303,11538,2212,55,25293,1189,6445,1541,9175,117,1186,1303
2018-10-15,14,3628,5120,2335,11537,11810,2271,54,25857,1186,6446,1548,9180,84,1164,1248
2018-10-15,15,3670,5100,2300,11844,12090,2352,55,26525,1203,6365,1557,9125,69,1146,1215
2018-10-15,16,3726,5115,2289,12236,12344,2454,56,27274,1201,5943,1467,8611,66,1068,1134
2018-10-15,17,3761,5168,2313,12546,12486,2563,56,27835,1063,4603,1178,6844,80,997,1077
2018-10-15,18,3784,5278,2358,12927,12492,2666,57,28323,447,1519,474,2440,114,904,1018
2018-10-15,19,3987,5443,2437,13158,12858,2755,58,29013,14,172,18,204,192,737,929
2018-10-15,20,4028,5421,2477,13489,13054,2808,59,29594,0,0,0,0,291,724,1015
2018-10-15,21,3927,5215,2412,13031,12506,2736,56,28512,0,0,0,0,428,682,1110
2018-10-15,22,3769,4895,2272,12328,11791,2568,52,26922,0,0,0,0,569,650,1219
2018-10-15,23,3642,4619,2095,11408,10896,2319,48,24856,0,0,0,0,636,573,1209
2018-10-15,24,3435,4452,1936,10563,10038,2100,45,22931,0,0,0,0,619,549,1168
2018-10-16,1,3287,4516,1826,9613,9528,1879,44,21248,0,0,0,0,514,559,1073
2018-10-16,2,3184,4471,1779,9253,9127,1806,45,20414,0,0,0,0,490,547,1037
2018-10-16,3,3135,4462,1762,9004,8872,1758,46,19864,0,0,0,0,429,541,970
2018-10-16,4,3119,4532,1775,8954,8794,1742,47,19721,0,0,0,0,388,534,922
2018-10-16,5,3174,4730,1860,9165,9024,1774,51,20197,0,0,0,0,354,509,863
2018-10-16,6,3334,5126,2097,9729,9611,1906,57,21486,0,0,0,0,323,510,833
2018-10-16,7,3548,5443,2465,10816,10651,2164,64,23879,0,3,0,3,288,506,794
2018-10-16,8,3516,5426,2657,11675,11103,2223,63,25250,108,846,131,1085,264,476,740
2018-10-16,9,3517,5378,2579,11346,11157,2197,59,24943,816,3760,848,5424,208,447,655
2018-10-16,10,3523,5336,2508,11002,11328,2185,56,24754,1196,5467,1356,8019,183,530,713
2018-10-16,11,3540,5300,2426,10708,11456,2180,54,24582,1232,5976,1517,8725,175,654,829
2018-10-16,12,3557,5277,2355,10479,11633,2180,53,24529,1209,6125,1544,8878,146,707,853
2018-10-16,13,3604,5282,2336,10432,11839,2211,52,24716,1179,5980,1533,8692,119,735,854
2018-10-16,14,3707,5284,2319,10714,12124,2279,52,25353,1177,5936,1540,8653,100,719,819
2018-10-16,15,3836,5280,2301,11029,12422,2374,53,26060,1189,5781,1551,8521,91,656,747
2018-10-16,16,3950,5306,2304,11550,12666,2467,53,26918,1190,5394,1465,8049,93,582,675
2018-10-16,17,4000,5335,2310,12030,12785,2556,54,27606,1036,4074,1157,6267,125,528,653
2018-10-16,18,4014,5433,2352,12507,12693,2637,55,28074,419,1304,452,2175,186,381,567
2018-10-16,19,4187,5577,2426,13140,13047,2797,56,29224,11,154,18,183,293,292,585
2018-10-16,20,4183,5535,2447,13361,13257,2857,57,29715,0,0,0,0,470,287,757
2018-10-16,21,4046,5329,2355,12803,12755,2712,54,28505,0,0,0,0,518,309,827
2018-10-16,22,3843,5013,2220,12042,12077,2509,51,26861,0,0,0,0,553,306,859
2018-10-16,23,3680,4724,2043,11062,11057,2250,47,24598,0,0,0,0,575,272,847
2018-10-16,24,3461,4527,1893,10251,10209,2033,44,22720,0,0,0,0,573,255,828
2018-10-17,1,3237,4429,1813,9621,9526,1868,46,21245,0,0,0,0,345,222,567
2018-10-17,2,3147,4380,1763,9231,9122,1797,46,20380,0,0,0,0,306,240,546
2018-10-17,3,3101,4359,1742,8993,8864,1755,46,19842,0,0,0,0,243,252,495
2018-10-17,4,3086,4429,1753,8919,8768,1738,47,19655,0,0,0,0,217,250,467
2018-10-17,5,3139,4622,1838,9124,8980,1768,49,20105,0,0,0,0,191,268,459
2018-10-17,6,3289,4997,2071,9727,9624,1903,54,21492,0,0,0,0,157,284,441
2018-10-17,7,3513,5315,2434,10836,10708,2157,60,23945,0,5,0,5,122,251,373
2018-10-17,8,3492,5324,2633,11549,10852,2223,63,24870,99,828,118,1045,100,246,346
2018-10-17,9,3484,5290,2566,11250,10885,2195,61,24574,813,3761,810,5384,82,231,313
2018-10-17,10,3489,5271,2491,10915,10984,2174,60,24316,1195,5530,1287,8012,74,306,380
2018-10-17,11,3507,5255,2425,10651,11063,2145,59,24101,1230,6153,1478,8861,63,324,387
2018-10-17,12,3499,5246,2350,10469,11210,2120,59,24042,1207,6294,1504,9005,40,347,387
2018-10-17,13,3528,5260,2331,10444,11407,2126,60,24220,1188,6222,1497,8907,24,351,375
2018-10-17,14,3593,5271,2319,10713,11640,2180,60,24776,1185,6184,1499,8868,20,336,356
2018-10-17,15,3680,5285,2315,11090,11939,2240,60,25511,1191,6069,1512,8772,19,288,307
2018-10-17,16,3772,5314,2313,11545,12252,2318,60,26357,1191,5751,1415,8357,17,271,288
2018-10-17,17,3837,5335,2339,11982,12513,2412,60,27151,1036,4282,1120,6438,14,231,245
2018-10-17,18,3840,5418,2375,12482,12625,2494,60,27845,399,1281,426,2106,14,196,210
2018-10-17,19,4004,5541,2440,13119,13032,2689,62,29086,10,115,14,139,36,148,184
2018-10-17,20,4027,5476,2436,13305,13221,2774,62,29547,0,0,0,0,84,158,242
2018-10-17,21,3908,5275,2341,12766,12722,2644,59,28375,0,0,0,0,122,164,286
2018-10-17,22,3730,4969,2214,12015,12001,2450,56,26706,0,0,0,0,166,151,317
2018-10-17,23,3574,4684,2034,11038,11011,2203,52,24488,0,0,0,0,196,151,347
2018-10-17,24,3379,4491,1883,10186,10122,2007,48,22547,0,0,0,0,175,157,332
2018-10-18,1,3174,4381,1809,9608,9467,1919,42,21220,0,0,0,0,187,201,388
2018-10-18,2,3079,4331,1759,9219,9075,1835,42,20355,0,0,0,0,180,223,403
2018-10-18,3,3028,4314,1738,9020,8869,1789,42,19904,0,0,0,0,169,231,400
2018-10-18,4,3015,4379,1749,8928,8760,1777,43,19691,0,0,0,0,148,228,376
2018-10-18,5,3072,4578,1831,9128,8956,1824,45,20137,0,0,0,0,111,220,331
2018-10-18,6,3216,4939,2067,9730,9584,1957,49,21504,0,0,0,0,79,211,290
2018-10-18,7,3444,5254,2427,10828,10591,2163,55,23820,0,4,0,4,52,189,241
2018-10-18,8,3436,5266,2622,11568,10913,2239,58,24961,108,917,121,1146,41,190,231
2018-10-18,9,3450,5247,2550,11338,10956,2178,55,24711,841,4093,819,5753,39,193,232
2018-10-18,10,3467,5238,2486,11033,11023,2116,54,24410,1239,6052,1332,8623,40,223,263
2018-10-18,11,3506,5228,2414,10764,11146,2106,53,24253,1281,6618,1496,9395,43,255,298
2018-10-18,12,3539,5223,2348,10598,11293,2104,52,24232,1255,6670,1522,9447,34,277,311
2018-10-18,13,3610,5242,2326,10604,11499,2136,52,24476,1228,6624,1508,9360,24,283,307
2018-10-18,14,3733,5261,2317,10848,11764,2210,53,25091,1232,6641,1512,9385,24,273,297
2018-10-18,15,3867,5274,2308,11193,12094,2290,52,25838,1254,6595,1530,9379,19,247,266
2018-10-18,16,3963,5301,2301,11637,12405,2420,53,26699,1255,6152,1425,8832,16,237,253
2018-10-18,17,4025,5308,2318,12104,12677,2566,52,27583,1100,4553,1117,6770,16,214,230
2018-10-18,18,4022,5389,2352,12557,12767,2710,52,28270,418,1379,415,2212,17,202,219
2018-10-18,19,4179,5506,2428,13178,13144,2838,54,29397,8,166,13,187,34,174,208
2018-10-18,20,4146,5429,2401,13367,13313,2867,55,29785,0,0,0,0,61,219,280
2018-10-18,21,3995,5234,2304,12795,12827,2790,52,28647,0,0,0,0,81,253,334
2018-10-18,22,3790,4938,2174,12042,12107,2613,49,26994,0,0,0,0,90,236,326
2018-10-18,23,3604,4662,2006,11080,11139,2364,45,24812,0,0,0,0,136,228,364
2018-10-18,24,3392,4471,1859,10233,10264,2107,42,22829,0,0,0,0,143,231,374
2018-10-19,1,3214,4364,1784,9739,9834,1950,44,21750,0,0,0,0,146,245,391
2018-10-19,2,3112,4312,1728,9323,9380,1869,43,20798,0,0,0,0,142,269,411
2018-10-19,3,3051,4294,1703,9071,9110,1810,43,20218,0,0,0,0,130,285,415
2018-10-19,4,3032,4357,1709,8992,8953,1789,44,19960,0,0,0,0,105,319,424
2018-10-19,5,3068,4537,1783,9188,9160,1813,46,20391,0,0,0,0,71,368,439
2018-10-19,6,3189,4883,1992,9763,9762,1930,50,21689,0,0,0,0,56,352,408
2018-10-19,7,3392,5199,2321,10813,10765,2165,54,23980,0,4,0,4,56,356,412
2018-10-19,8,3396,5233,2526,11503,11070,2233,56,25045,85,889,113,1087,59,388,447
2018-10-19,9,3429,5218,2478,11310,11249,2271,55,25067,732,4085,793,5610,62,393,455
2018-10-19,10,3481,5204,2430,11155,11473,2285,54,25146,1129,6097,1308,8534,73,523,596
2018-10-19,11,3557,5181,2366,10944,11769,2277,53,25222,1170,6628,1476,9274,68,639,707
2018-10-19,12,3636,5159,2315,10789,12079,2282,53,25379,1145,6680,1503,9328,61,721,782
2018-10-19,13,3719,5167,2285,10793,12430,2323,53,25777,1118,6629,1494,9241,53,787,840
2018-10-19,14,3844,5175,2277,11120,12913,2410,54,26674,1125,6649,1498,9272,51,797,848
2018-10-19,15,3983,5173,2267,11483,13346,2513,54,27574,1149,6601,1515,9265,52,757,809
2018-10-19,16,4096,5170,2271,11962,13736,2591,55,28524,1147,6145,1406,8698,55,735,790
2018-10-19,17,4158,5157,2281,12466,13898,2691,56,29291,974,4460,1089,6523,59,681,740
2018-10-19,18,4127,5225,2302,12816,13742,2764,56,29560,350,1269,377,1996,68,574,642
2018-10-19,19,4249,5325,2354,13242,13855,2887,57,30224,6,105,10,121,94,413,507
2018-10-19,20,4179,5221,2288,13261,13790,2891,57,30183,0,0,0,0,118,316,434
2018-10-19,21,4025,5070,2179,12670,13214,2749,54,28871,0,0,0,0,141,329,470
2018-10-19,22,3850,4853,2064,11975,12544,2579,52,27331,0,0,0,0,170,334,504
2018-10-19,23,3659,4625,1936,11190,11656,2362,48,25438,0,0,0,0,190,323,513
2018-10-19,24,3456,4433,1813,10396,10736,2153,44,23512,0,0,0,0,184,350,534
2018-10-20,1,3258,4304,1736,9850,10170,2025,42,22271,0,0,0,0,199,340,539
2018-10-20,2,3132,4246,1678,9406,9626,1920,41,21176,0,0,0,0,187,356,543
2018-10-20,3,3053,4225,1647,9093,9252,1851,41,20422,0,0,0,0,162,371,533
2018-10-20,4,3014,4240,1643,8926,9019,1812,42,19982,0,0,0,0,118,373,491
2018-10-20,5,3015,4314,1673,8941,9021,1812,43,20000,0,0,0,0,86,376,462
2018-10-20,6,3053,4468,1768,9151,9259,1849,45,20487,0,0,0,0,72,363,435
2018-10-20,7,3134,4636,1928,9591,9588,1935,49,21346,0,4,0,4,69,359,428
2018-10-20,8,3106,4720,2108,9895,9656,1966,49,21750,79,741,101,921,70,365,435
2018-10-20,9,3204,4762,2192,9984,9962,2029,51,22210,709,3520,767,4996,66,376,442
2018-10-20,10,3321,4781,2199,9916,10308,2058,50,22514,1118,5306,1271,7695,71,469,540
2018-10-20,11,3429,4779,2153,9714,10626,2056,49,22625,1164,5834,1465,8463,57,546,603
2018-10-20,12,3545,4765,2104,9548,10995,2055,49,22826,1140,5905,1486,8531,41,544,585
2018-10-20,13,3640,4752,2054,9525,11454,2088,50,23295,1111,5723,1480,8314,31,520,551
2018-10-20,14,3781,4759,2016,9680,11880,2146,51,23936,1116,5656,1483,8255,25,484,509
2018-10-20,15,3934,4797,2005,9963,12284,2233,53,24711,1138,5463,1495,8096,22,460,482
2018-10-20,16,4093,4896,2017,10479,12694,2361,54,25767,1132,5005,1380,7517,22,429,451
2018-10-20,17,4145,4947,2043,11030,13001,2484,57,26752,948,3603,1049,5600,36,359,395
2018-10-20,18,4145,5031,2096,11667,12959,2584,57,27448,325,918,357,1600,39,289,328
2018-10-20,19,4262,5162,2180,12315,13188,2760,57,28503,5,22,6,33,72,233,305
2018-10-20,20,4185,5088,2129,12424,13086,2788,56,28537,0,0,0,0,117,220,337
2018-10-20,21,4027,4930,2028,11915,12548,2656,53,27355,0,0,0,0,153,224,377
2018-10-20,22,3864,4726,1925,11372,11962,2510,51,26077,0,0,0,0,193,210,403
2018-10-20,23,3625,4512,1828,10658,11189,2322,47,24399,0,0,0,0,239,191,430
2018-10-20,24,3417,4329,1723,9946,10452,2138,44,22763,0,0,0,0,261,170,431
2018-10-21,1,3299,4241,1672,9540,9795,1977,42,21536,0,0,0,0,255,165,420
2018-10-21,2,3167,4178,1622,9097,9294,1884,41,20498,0,0,0,0,250,153,403
2018-10-21,3,3091,4143,1594,8825,8964,1816,41,19829,0,0,0,0,225,146,371
2018-10-21,4,3034,4152,1595,8691,8731,1775,41,19421,0,0,0,0,187,141,328
2018-10-21,5,3013,4194,1625,8653,8669,1769,42,19316,0,0,0,0,153,128,281
2018-10-21,6,3086,4296,1699,8761,8771,1797,44,19555,0,0,0,0,127,126,253
2018-10-21,7,3139,4449,1834,9050,9000,1852,47,20131,0,2,0,2,115,119,234
2018-10-21,8,3085,4524,1994,9312,8924,1865,49,20333,70,616,91,777,107,110,217
2018-10-21,9,3209,4555,2099,9439,9152,1892,50,20718,688,2904,691,4283,93,99,192
2018-10-21,10,3347,4582,2118,9306,9471,1895,49,20905,1089,4638,1164,6891,80,126,206
2018-10-21,11,3464,4574,2074,8997,9793,1873,48,20895,1137,5320,1373,7830,62,152,214
2018-10-21,12,3575,4657,2049,8831,10134,1845,49,21041,1114,5474,1402,7990,48,173,221
2018-10-21,13,3656,4681,2029,8862,10492,1840,50,21427,1068,5394,1376,7838,42,169,211
2018-10-21,14,3785,4744,1987,9054,10728,1895,51,21911,1072,5368,1370,7810,46,177,223
2018-10-21,15,3930,4829,1970,9412,11241,1989,52,22876,1092,5222,1362,7676,60,221,281
2018-10-21,16,4062,4976,1984,9909,11685,2098,54,23929,1080,4827,1244,7151,86,260,346
2018-10-21,17,4164,5030,2034,10520,12017,2259,57,25033,896,3489,924,5309,120,320,440
2018-10-21,18,4162,5126,2124,11289,12261,2413,57,26203,287,862,305,1454,149,399,548
2018-10-21,19,4289,5220,2242,11883,12622,2644,58,27390,4,26,5,35,237,434,671
2018-10-21,20,4248,5127,2226,12095,12745,2697,57,27777,0,0,0,0,348,558,906
2018-10-21,21,4111,4949,2136,11716,12272,2566,53,26789,0,0,0,0,408,561,969
2018-10-21,22,3922,4684,2013,11083,11659,2383,50,25356,0,0,0,0,471,561,1032
2018-10-21,23,3657,4433,1858,10390,10875,2167,46,23659,0,0,0,0,548,552,1100
2018-10-21,24,3399,4271,1721,9653,10073,1980,43,21929,0,0,0,0,606,582,1188
2018-10-22,1,3255,4192,1660,9143,9364,1881,41,20612,0,0,0,0,555,556,1111
2018-10-22,2,3130,4151,1623,8866,9076,1818,40,19984,0,0,0,0,560,559,1119
2018-10-22,3,3064,4145,1611,8683,8852,1780,40,19538,0,0,0,0,545,589,1134
2018-10-22,4,3034,4221,1636,8689,8796,1759,41,19468,0,0,0,0,508,580,1088
2018-10-22,5,3083,4425,1734,8941,9051,1795,43,20012,0,0,0,0,477,533,1010
2018-10-22,6,3266,4816,1970,9570,9761,1938,47,21499,0,0,0,0,443,461,904
2018-10-22,7,3493,5164,2337,10691,10792,2182,53,23901,0,2,0,2,407,399,806
2018-10-22,8,3491,5216,2564,11634,10989,2246,55,25107,68,612,88,768,380,339,719
2018-10-22,9,3579,5222,2525,11528,11112,2256,55,25134,693,3054,708,4455,348,266,614
2018-10-22,10,3680,5238,2467,11146,11282,2239,54,24905,1112,4902,1211,7225,291,210,501
2018-10-22,11,3777,5240,2408,10817,11525,2212,54,24792,1155,5505,1412,8072,234,156,390
2018-10-22,12,3865,5250,2354,10627,11798,2208,55,24872,1132,5688,1438,8258,186,144,330
2018-10-22,13,3958,5286,2336,10540,12148,2218,57,25146,1105,5613,1432,8150,161,145,306
2018-10-22,14,4078,5298,2324,10718,12662,2270,58,25891,1105,5587,1431,8123,158,139,297
2018-10-22,15,4206,5305,2313,10999,13123,2316,58,26679,1129,5384,1445,7958,206,163,369
2018-10-22,16,4303,5330,2313,11393,13463,2376,59,27474,1122,4934,1330,7386,265,260,525
2018-10-22,17,4375,5408,2326,11792,13597,2458,60,28090,929,3535,1008,5472,338,468,806
2018-10-22,18,4363,5466,2371,12286,13597,2572,59,28697,295,871,322,1488,379,629,1008
2018-10-22,19,4498,5549,2456,12995,13736,2762,59,29736,3,27,2,32,440,811,1251
2018-10-22,20,4446,5430,2433,13149,13900,2796,58,30087,0,0,0,0,504,1010,1514
2018-10-22,21,4281,5209,2325,12614,13384,2648,55,28884,0,0,0,0,564,982,1546
2018-10-22,22,4058,4890,2195,11854,12611,2459,52,27159,0,0,0,0,633,886,1519
2018-10-22,23,3738,4598,2024,10909,11539,2215,47,24892,0,0,0,0,685,809,1494
2018-10-22,24,3468,4402,1868,10128,10615,2016,43,22986,0,0,0,0,728,783,1511
2018-10-23,1,3267,4305,1784,9533,9789,1921,42,21468,0,0,0,0,825,693,1518
2018-10-23,2,3152,4248,1733,9153,9259,1846,41,20482,0,0,0,0,847,611,1458
2018-10-23,3,3083,4229,1711,8898,8891,1801,41,19813,0,0,0,0,813,615,1428
2018-10-23,4,3058,4294,1724,8824,8718,1778,41,19544,0,0,0,0,772,603,1375
2018-10-23,5,3098,4492,1805,8964,8833,1810,43,19833,0,0,0,0,705,568,1273
2018-10-23,6,3233,4870,2038,9576,9465,1940,48,21211,0,0,0,0,616,479,1095
2018-10-23,7,3454,5206,2400,10931,10933,2197,52,24296,0,1,0,1,518,361,879
2018-10-23,8,3478,5229,2617,11679,11253,2262,54,25431,59,650,86,795,462,309,771
2018-10-23,9,3546,5219,2558,11378,11341,2235,55,25193,622,3294,695,4611,518,277,795
2018-10-23,10,3648,5219,2488,11040,11501,2206,54,24986,1013,5162,1195,7370,487,254,741
2018-10-23,11,3757,5221,2416,10732,11708,2181,53,24859,1068,5792,1399,8259,432,206,638
2018-10-23,12,3849,5234,2360,10422,11956,2169,54,24785,1039,5979,1416,8434,353,175,528
2018-10-23,13,3964,5275,2340,10240,12249,2179,55,24909,990,6083,1381,8454,277,165,442
2018-10-23,14,4093,5294,2320,10405,12632,2249,57,25528,972,6072,1369,8413,260,185,445
2018-10-23,15,4246,5312,2300,10643,13041,2343,58,26269,983,5966,1378,8327,295,262,557
2018-10-23,16,4346,5349,2299,10983,13434,2431,59,27090,957,5648,1266,7871,314,474,788
2018-10-23,17,4388,5427,2291,11402,13697,2532,60,27874,772,4025,942,5739,364,755,1119
2018-10-23,18,4404,5492,2338,11903,13750,2632,59,28528,217,950,281,1448,399,983,1382
2018-10-23,19,4523,5565,2440,12664,14071,2813,60,29792,3,20,3,26,436,1191,1627
2018-10-23,20,4488,5446,2439,12907,13962,2836,58,29948,0,0,0,0,478,1338,1816
2018-10-23,21,4323,5227,2329,12435,13357,2681,55,28713,0,0,0,0,525,1302,1827
2018-10-23,22,4084,4916,2192,11782,12589,2492,52,27098,0,0,0,0,552,1199,1751
2018-10-23,23,3783,4630,2018,10873,11524,2243,47,24870,0,0,0,0,571,1047,1618
2018-10-23,24,3518,4434,1859,10111,10559,2047,44,22943,0,0,0,0,541,961,1502
2018-10-24,1,3298,4343,1800,9475,9823,1922,42,21446,0,0,0,0,472,562,1034
2018-10-24,2,3184,4287,1746,9121,9386,1845,42,20577,0,0,0,0,412,465,877
2018-10-24,3,3116,4270,1722,8909,9093,1813,41,20039,0,0,0,0,388,409,797
2018-10-24,4,3085,4329,1734,8863,8970,1795,42,19853,0,0,0,0,359,403,762
2018-10-24,5,3122,4527,1813,9100,9145,1817,44,20289,0,0,0,0,314,437,751
2018-10-24,6,3249,4902,2046,9719,9747,1952,48,21647,0,0,0,0,269,378,647
2018-10-24,7,3479,5240,2406,10838,10765,2204,53,24041,0,2,0,2,238,306,544
2018-10-24,8,3489,5263,2619,11450,10890,2314,55,24891,51,579,77,707,201,247,448
2018-10-24,9,3533,5246,2571,11362,11026,2317,55,24943,552,2970,627,4149,180,183,363
2018-10-24,10,3640,5243,2508,11084,11186,2260,54,24767,945,4861,1158,6964,139,127,266
2018-10-24,11,3758,5240,2457,10792,11426,2229,54,24684,1009,5555,1374,7938,114,106,220
2018-10-24,12,3853,5244,2397,10461,11704,2224,55,24627,990,5773,1397,8160,86,109,195
2018-10-24,13,3949,5282,2359,10214,12017,2232,56,24702,969,5776,1393,8138,82,117,199
2018-10-24,14,4086,5306,2339,10326,12469,2303,58,25339,963,5757,1390,8110,91,127,218
2018-10-24,15,4228,5332,2315,10557,12937,2392,59,26127,973,5702,1405,8080,111,150,261
2018-10-24,16,4348,5447,2293,10953,13345,2461,60,27001,995,5320,1295,7610,135,201,336
2018-10-24,17,4426,5419,2298,11413,13566,2551,62,27774,808,3836,966,5610,192,371,563
2018-10-24,18,4428,5510,2358,11948,13578,2637,60,28406,226,865,277,1368,265,610,875
2018-10-24,19,4551,5571,2476,12640,13884,2826,61,29594,2,11,4,17,357,821,1178
2018-10-24,20,4498,5451,2476,12863,13757,2861,59,29723,0,0,0,0,433,958,1391
2018-10-24,21,4340,5242,2388,12404,13128,2707,56,28476,0,0,0,0,445,931,1376
2018-10-24,22,4102,4939,2250,11735,12352,2511,52,26831,0,0,0,0,452,902,1354
2018-10-24,23,3796,4658,2066,10905,11425,2269,48,24828,0,0,0,0,470,808,1278
2018-10-24,24,3519,4463,1906,10145,10480,2057,44,22908,0,0,0,0,472,741,1213
2018-10-25,1,3292,4341,1807,9810,9872,1939,42,21822,0,0,0,0,456,1485,1941
2018-10-25,2,3177,4282,1757,9403,9414,1864,41,20882,0,0,0,0,412,1444,1856
2018-10-25,3,3104,4261,1734,9165,9097,1813,41,20276,0,0,0,0,356,1369,1725
2018-10-25,4,3076,4321,1746,9111,8955,1795,42,20061,0,0,0,0,306,1224,1530
2018-10-25,5,3116,4512,1826,9299,9122,1817,44,20441,0,0,0,0,259,1011,1270
2018-10-25,6,3243,4880,2064,9877,9730,1952,48,21766,0,0,0,0,235,713,948
2018-10-25,7,3475,5214,2423,10941,10742,2204,53,24100,0,2,0,2,213,452,665
2018-10-25,8,3497,5248,2640,11832,11096,2314,55,25478,43,626,73,742,204,269,473
2018-10-25,9,3570,5233,2577,11741,11232,2317,55,25525,539,3280,597,4416,202,136,338
2018-10-25,10,3680,5234,2518,11413,11396,2260,54,25304,954,5264,1119,7337,192,117,309
2018-10-25,11,3787,5232,2461,10998,11668,2229,54,25128,1023,5905,1347,8275,178,156,334
2018-10-25,12,3889,5235,2388,10749,11958,2224,55,25166,1011,6062,1386,8459,149,174,323
2018-10-25,13,4002,5276,2348,10619,12304,2232,57,25391,999,6008,1381,8388,146,170,316
2018-10-25,14,4149,5300,2325,10823,12737,2303,59,26091,994,6013,1380,8387,155,160,315
2018-10-25,15,4292,5320,2290,11075,13189,2392,61,26878,1007,5907,1382,8296,173,133,306
2018-10-25,16,4412,5349,2270,11452,13597,2468,62,27745,987,5462,1268,7717,211,106,317
2018-10-25,17,4497,5355,2279,11951,13837,2564,63,28603,787,3806,921,5514,269,100,369
2018-10-25,18,4495,5468,2333,12526,13843,2644,62,29238,212,771,225,1208,335,121,456
2018-10-25,19,4589,5553,2435,13018,14118,2826,62,30183,1,12,1,14,456,255,711
2018-10-25,20,4521,5431,2423,13192,13917,2861,60,30189,0,0,0,0,560,475,1035
2018-10-25,21,4341,5234,2323,12756,13310,2707,56,28988,0,0,0,0,569,449,1018
2018-10-25,22,4106,4941,2196,12099,12539,2511,52,27361,0,0,0,0,581,393,974
2018-10-25,23,3814,4668,2025,11184,11492,2269,48,25152,0,0,0,0,604,295,899
2018-10-25,24,3556,4478,1866,10346,10528,2057,44,23135,0,0,0,0,607,228,835
2018-10-26,1,3314,4376,1769,9805,9990,1991,43,22017,0,0,0,0,557,161,718
2018-10-26,2,3191,4324,1709,9438,9594,1896,42,21159,0,0,0,0,524,138,662
2018-10-26,3,3110,4309,1681,9205,9348,1838,41,20621,0,0,0,0,491,128,619
2018-10-26,4,3082,4366,1682,9097,9265,1816,42,20409,0,0,0,0,445,137,582
2018-10-26,5,3113,4552,1741,9345,9429,1861,44,20868,0,0,0,0,392,129,521
2018-10-26,6,3228,4899,1945,9849,10012,1993,48,22091,0,0,0,0,344,111,455
2018-10-26,7,3439,5222,2262,10975,10979,2240,53,24436,0,1,0,1,301,106,407
2018-10-26,8,3456,5261,2473,11696,11047,2295,54,25251,41,626,68,735,259,101,360
2018-10-26,9,3527,5241,2450,11557,11228,2264,54,25268,534,3377,596,4507,202,99,301
2018-10-26,10,3642,5221,2422,11272,11455,2223,52,25162,937,5364,1119,7420,150,99,249
2018-10-26,11,3760,5193,2386,11029,11834,2197,52,25274,996,5959,1348,8303,108,114,222
2018-10-26,12,3850,5163,2347,10868,12183,2190,53,25453,971,6076,1375,8422,73,124,197
2018-10-26,13,3967,5174,2322,10772,12630,2223,55,25863,961,6018,1363,8342,58,129,187
2018-10-26,14,4093,5182,2304,11023,13291,2312,57,26871,968,6012,1364,8344,50,122,172
2018-10-26,15,4247,5183,2279,11295,13824,2414,58,27779,980,5907,1375,8262,48,111,159
2018-10-26,16,4396,5223,2260,11672,14381,2493,60,28795,962,5430,1254,7646,51,94,145
2018-10-26,17,4457,5231,2266,12141,14670,2621,61,29683,762,3704,902,5368,67,88,155
2018-10-26,18,4462,5276,2293,12627,14634,2751,61,30262,193,739,212,1144,85,63,148
2018-10-26,19,4550,5345,2374,12923,14691,2865,61,30730,1,9,1,11,112,68,180
2018-10-26,20,4456,5212,2333,12944,14292,2850,58,30335,0,0,0,0,169,113,282
2018-10-26,21,4258,5050,2221,12462,13594,2757,54,29058,0,0,0,0,191,159,350
2018-10-26,22,4042,4832,2109,11909,12861,2583,51,27594,0,0,0,0,208,177,385
2018-10-26,23,3799,4607,1980,11170,11922,2359,47,25688,0,0,0,0,235,177,412
2018-10-26,24,3546,4412,1842,10398,11010,2149,44,23790,0,0,0,0,234,171,405
2018-10-27,1,3304,4319,1712,9933,10627,2002,43,22795,0,0,0,0,386,154,540
2018-10-27,2,3163,4253,1645,9525,10152,1907,41,21815,0,0,0,0,392,161,553
2018-10-27,3,3079,4218,1611,9243,9690,1838,41,21001,0,0,0,0,389,143,532
2018-10-27,4,3033,4235,1603,9104,9455,1795,41,20585,0,0,0,0,375,138,513
2018-10-27,5,3038,4313,1626,9104,9445,1796,42,20576,0,0,0,0,357,134,491
2018-10-27,6,3063,4451,1716,9270,9698,1833,45,21036,0,0,0,0,328,129,457
2018-10-27,7,3166,4635,1867,9712,9938,1923,48,21811,0,1,0,1,306,119,425
2018-10-27,8,3159,4734,2049,10203,9948,2007,50,22398,37,583,66,686,310,113,423
2018-10-27,9,3269,4795,2162,10304,10218,2064,51,22825,506,3242,570,4318,301,95,396
2018-10-27,10,3432,4822,2208,10207,10500,2092,50,23037,910,5251,1101,7262,250,78,328
2018-10-27,11,3566,4826,2194,9956,10861,2044,50,23099,971,5845,1336,8152,184,79,263
2018-10-27,12,3697,4835,2143,9684,11207,2048,52,23180,941,5978,1364,8283,143,83,226
2018-10-27,13,3831,4848,2103,9621,11578,2077,55,23519,922,5947,1355,8224,136,109,245
2018-10-27,14,3982,4898,2067,9709,12021,2123,58,24099,917,5965,1354,8236,148,140,288
2018-10-27,15,4140,4971,2040,9993,12545,2210,61,24997,933,5842,1360,8135,209,185,394
2018-10-27,16,4293,5093,2038,10411,13103,2334,65,26101,908,5400,1239,7547,283,237,520
2018-10-27,17,4359,5115,2057,10837,13380,2453,66,26924,705,3645,881,5231,384,325,709
2018-10-27,18,4380,5231,2102,11396,13501,2557,66,27708,168,701,199,1068,493,451,944
2018-10-27,19,4450,5272,2213,12103,13739,2741,65,28837,1,7,1,9,602,593,1195
2018-10-27,20,4349,5130,2186,12216,13363,2734,61,28563,0,0,0,0,709,765,1474
2018-10-27,21,4161,4967,2078,11853,12707,2592,56,27396,0,0,0,0,777,694,1471
2018-10-27,22,3947,4762,1979,11402,12098,2446,53,26186,0,0,0,0,827,629,1456
2018-10-27,23,3735,4548,1856,10769,11304,2266,48,24577,0,0,0,0,845,566,1411
2018-10-27,24,3497,4358,1736,10127,10495,2091,45,22948,0,0,0,0,843,537,1380
2018-10-28,1,3306,4221,1619,9439,9817,1995,43,21483,0,0,0,0,795,626,1421
2018-10-28,2,3166,4156,1560,9043,9381,1895,42,20549,0,0,0,0,733,640,1373
2018-10-28,3,3069,4119,1531,8781,9106,1829,41,19945,0,0,0,0,748,675,1423
2018-10-28,4,3007,4130,1523,8652,8901,1790,42,19573,0,0,0,0,733,704,1437
2018-10-28,5,2990,4173,1537,8648,8841,1782,43,19503,0,0,0,0,707,714,1421
2018-10-28,6,3035,4269,1602,8764,8901,1821,45,19720,0,0,0,0,663,737,1400
2018-10-28,7,3099,4439,1723,9040,9087,1895,48,20260,0,1,0,1,614,745,1359
2018-10-28,8,3094,4530,1887,9439,9064,1924,50,20667,27,544,59,630,582,772,1354
2018-10-28,9,3228,4560,2016,9599,9261,1942,52,21042,446,3053,542,4041,572,657,1229
2018-10-28,10,3404,4595,2089,9586,9469,1946,51,21241,858,4984,1076,6918,522,586,1108
2018-10-28,11,3553,4592,2113,9449,9637,1929,52,21256,930,5546,1304,7780,492,506,998
2018-10-28,12,3685,4670,2094,9342,9895,1930,54,21398,916,5739,1330,7985,435,524,959
2018-10-28,13,3811,4688,2078,9300,10154,1926,57,21619,905,5717,1330,7952,398,613,1011
2018-10-28,14,3965,4771,2061,9311,10449,1979,59,21987,904,5688,1329,7921,371,748,1119
2018-10-28,15,4143,4870,2041,9481,10974,2079,61,22783,916,5485,1327,7728,386,1064,1450
2018-10-28,16,4317,5037,2037,9753,11550,2206,64,23760,884,4909,1199,6992,405,1420,1825
2018-10-28,17,4455,5106,2065,10134,12009,2356,66,24752,663,3098,835,4596,447,1708,2155
2018-10-28,18,4454,5229,2157,10838,12350,2521,67,25963,151,531,183,865,503,1829,2332
2018-10-28,19,4523,5271,2303,11664,12910,2747,67,27576,1,3,2,6,534,1876,2410
2018-10-28,20,4451,5095,2316,11809,12716,2748,63,27524,0,0,0,0,560,1900,2460
2018-10-28,21,4273,4918,2217,11453,12272,2598,58,26569,0,0,0,0,528,1929,2457
2018-10-28,22,4058,4663,2081,10909,11613,2406,54,25169,0,0,0,0,509,1922,2431
2018-10-28,23,3799,4423,1917,10190,10888,2195,48,23509,0,0,0,0,467,1901,2368
2018-10-28,24,3546,4251,1763,9502,10174,2007,44,21916,0,0,0,0,389,1905,2294
2018-10-29,1,3379,4184,1666,9195,9372,1951,41,20748,0,0,0,0,493,1953,2446
2018-10-29,2,3243,4143,1629,8900,9059,1886,40,20074,0,0,0,0,398,2056,2454
2018-10-29,3,3168,4134,1618,8737,8916,1834,40,19716,0,0,0,0,323,2064,2387
2018-10-29,4,3118,4211,1646,8735,8881,1799,41,19645,0,0,0,0,258,2058,2316
2018-10-29,5,3150,4416,1742,8969,9132,1834,44,20168,0,0,0,0,223,2046,2269
2018-10-29,6,3303,4801,1991,9561,9794,1981,48,21573,0,0,0,0,212,2006,2218
2018-10-29,7,3547,5179,2360,10666,10818,2203,54,23929,0,1,0,1,201,1924,2125
2018-10-29,8,3578,5238,2596,11575,11460,2329,57,25612,32,470,49,551,195,1830,2025
2018-10-29,9,3665,5246,2579,11564,11553,2368,57,25731,495,2780,494,3769,226,1790,2016
2018-10-29,10,3779,5264,2527,11332,11510,2282,57,25369,927,4723,1031,6681,245,1697,1942
2018-10-29,11,3912,5265,2493,11063,11460,2208,57,24976,992,5365,1266,7623,378,1590,1968
2018-10-29,12,4019,5262,2427,10749,11624,2198,59,24806,954,5563,1316,7833,406,1631,2037
2018-10-29,13,4116,5285,2387,10483,11837,2215,61,24779,923,5541,1330,7794,416,1795,2211
2018-10-29,14,4220,5290,2349,10492,12114,2270,63,25127,898,5573,1343,7814,419,1978,2397
2018-10-29,15,4328,5294,2299,10685,12524,2357,64,25818,917,5470,1336,7723,398,2233,2631
2018-10-29,16,4424,5316,2254,11012,12859,2446,65,26570,889,4999,1214,7102,370,2390,2760
2018-10-29,17,4453,5338,2260,11423,13114,2535,67,27326,677,3260,854,4791,349,2510,2859
2018-10-29,18,4470,5486,2350,11960,13231,2675,65,28118,153,585,181,919,272,2564,2836
2018-10-29,19,4585,5577,2515,12644,13601,2868,65,29366,2,8,1,11,222,2626,2848
2018-10-29,20,4532,5473,2547,12760,13353,2836,61,29198,0,0,0,0,212,2592,2804
2018-10-29,21,4358,5249,2447,12339,12809,2686,57,28078,0,0,0,0,258,2618,2876
2018-10-29,22,4120,4929,2288,11721,12052,2490,53,26504,0,0,0,0,281,2594,2875
2018-10-29,23,3823,4648,2111,10920,11199,2245,48,24600,0,0,0,0,367,2570,2937
2018-10-29,24,3570,4466,1953,10147,10396,2043,45,22819,0,0,0,0,429,2560,2989
2018-10-30,1,3256,4375,1839,9491,9715,1921,43,21356,0,0,0,0,460,2414,2874
2018-10-30,2,3148,4324,1796,9091,9298,1854,43,20473,0,0,0,0,529,2330,2859
2018-10-30,3,3092,4316,1782,8875,9045,1788,42,19937,0,0,0,0,570,2244,2814
2018-10-30,4,3070,4386,1805,8818,8977,1770,43,19795,0,0,0,0,602,2134,2736
2018-10-30,5,3116,4597,1898,9018,9173,1811,45,20234,0,0,0,0,647,2001,2648
2018-10-30,6,3254,4985,2152,9591,9806,1957,49,21592,0,0,0,0,658,1771,2429
2018-10-30,7,3491,5340,2530,10817,10878,2214,54,24150,0,1,0,1,648,1428,2076
2018-10-30,8,3505,5362,2766,11800,11377,2351,57,25774,34,524,55,613,613,1080,1693
2018-10-30,9,3513,5313,2698,11605,11343,2415,58,25610,560,3227,635,4422,624,736,1360
2018-10-30,10,3562,5292,2616,11107,11383,2300,58,25038,1023,5513,1198,7734,683,477,1160
2018-10-30,11,3621,5271,2540,10789,11474,2196,58,24707,1073,6091,1395,8559,768,380,1148
2018-10-30,12,3647,5252,2447,10543,11580,2164,58,24534,1042,6167,1418,8627,777,367,1144
2018-10-30,13,3688,5265,2388,10358,11733,2157,58,24493,1013,6196,1420,8629,754,358,1112
2018-10-30,14,3746,5256,2329,10465,12064,2207,58,24966,1021,6206,1431,8658,726,344,1070
2018-10-30,15,3844,5259,2272,10705,12363,2265,58,25579,1046,6109,1441,8596,672,338,1010
2018-10-30,16,3883,5289,2236,11016,12723,2340,59,26325,1023,5626,1319,7968,619,333,952
2018-10-30,17,3904,5292,2248,11368,12866,2437,59,26916,769,3696,927,5392,575,340,915
2018-10-30,18,3963,5477,2326,11909,12902,2539,60,27593,172,734,218,1124,464,322,786
2018-10-30,19,4090,5575,2479,12637,13371,2735,62,28988,2,8,5,15,405,388,793
2018-10-30,20,4040,5476,2503,12757,13244,2738,60,28984,0,0,0,0,415,435,850
2018-10-30,21,3923,5264,2410,12345,12717,2611,57,27914,0,0,0,0,439,391,830
2018-10-30,22,3737,4960,2255,11768,12051,2426,54,26483,0,0,0,0,461,364,825
2018-10-30,23,3612,4692,2064,10948,11156,2192,50,24531,0,0,0,0,458,391,849
2018-10-30,24,3415,4528,1904,10169,10300,2001,46,22701,0,0,0,0,434,378,812
2018-10-31,1,3259,4467,1835,9636,9680,1886,44,21438,0,0,0,0,437,480,917
2018-10-31,2,3163,4433,1783,9271,9308,1819,44,20632,0,0,0,0,404,500,904
2018-10-31,3,3116,4429,1761,9027,9068,1771,45,20100,0,0,0,0,327,466,793
2018-10-31,4,3104,4508,1771,8958,9015,1759,47,19968,0,0,0,0,253,455,708
2018-10-31,5,3166,4720,1848,9135,9220,1795,51,20391,0,0,0,0,226,439,665
2018-10-31,6,3336,5108,2081,9694,9826,1931,57,21698,0,0,0,0,180,401,581
2018-10-31,7,3568,5461,2427,10770,10830,2188,63,24040,0,1,0,1,143,396,539
2018-10-31,8,3581,5447,2627,11638,11230,2274,67,25396,29,499,48,576,125,362,487
2018-10-31,9,3559,5364,2588,11352,11095,2207,62,24904,542,3210,608,4360,133,408,541
2018-10-31,10,3545,5307,2532,10990,11101,2142,59,24480,1012,5215,1160,7387,144,447,591
2018-10-31,11,3541,5249,2484,10751,11168,2096,57,24260,1075,5785,1362,8222,186,492,678
2018-10-31,12,3529,5198,2416,10606,11248,2067,56,24164,1036,5895,1391,8322,222,478,700
2018-10-31,13,3547,5190,2371,10505,11413,2088,55,24248,961,5836,1371,8168,226,434,660
2018-10-31,14,3602,5173,2335,10718,11753,2163,55,24877,960,5840,1373,8173,214,362,576
2018-10-31,15,3699,5170,2308,10981,12103,2253,55,25581,976,5737,1369,8082,136,273,409
2018-10-31,16,3788,5192,2283,11343,12427,2350,56,26363,886,5224,1232,7342,70,216,286
2018-10-31,17,3846,5218,2291,11794,12522,2439,56,26997,653,3349,850,4852,42,166,208
2018-10-31,18,3921,5412,2362,12330,12608,2549,57,27733,127,598,179,904,31,123,154
2018-10-31,19,4080,5517,2482,12929,13161,2760,59,29097,0,3,0,3,35,110,145
2018-10-31,20,4002,5431,2469,13065,13074,2762,57,29147,0,0,0,0,51,137,188
2018-10-31,21,3907,5232,2369,12589,12585,2624,54,28040,0,0,0,0,58,145,203
2018-10-31,22,3764,4927,2226,11928,11867,2438,51,26472,0,0,0,0,52,146,198
2018-10-31,23,3670,4660,2035,11082,11067,2201,48,24586,0,0,0,0,81,159,240
2018-10-31,24,3472,4480,1867,10272,10257,2010,45,22774,0,0,0,0,105,153,258
2018-11-01,1,3268,4376,1725,9718,9637,1904,44,21492,0,0,0,0,247,142,389
2018-11-01,2,3152,4319,1662,9372,9213,1828,44,20647,0,0,0,0,304,160,464
2018-11-01,3,3088,4303,1636,9133,8942,1775,45,20085,0,0,0,0,281,216,497
2018-11-01,4,3067,4376,1643,9078,8852,1749,47,19918,0,0,0,0,271,256,527
2018-11-01,5,3105,4579,1716,9252,9069,1782,51,20346,0,0,0,0,271,247,518
2018-11-01,6,3256,4980,1954,9796,9698,1923,58,21664,0,0,0,0,234,246,480
2018-11-01,7,3499,5379,2318,10921,10754,2168,64,24095,0,1,0,1,198,257,455
2018-11-01,8,3512,5381,2540,11899,11132,2239,65,25526,18,419,39,476,195,243,438
2018-11-01,9,3501,5314,2500,11812,11078,2200,62,25344,395,2723,497,3615,228,252,480
2018-11-01,10,3519,5255,2455,11401,11158,2142,58,24951,778,4585,1016,6379,257,304,561
2018-11-01,11,3535,5197,2397,11106,11332,2112,55,24797,860,5251,1248,7359,288,373,661
2018-11-01,12,3558,5152,2339,10808,11518,2118,53,24688,852,5456,1312,7620,253,381,634
2018-11-01,13,3634,5138,2309,10579,11795,2139,53,24754,838,5393,1298,7529,202,386,588
2018-11-01,14,3732,5126,2278,10752,12206,2195,52,25393,836,5304,1298,7438,162,387,549
2018-11-01,15,3829,5109,2252,11054,12457,2274,52,26024,856,5108,1286,7250,103,323,426
2018-11-01,16,3914,5128,2246,11467,12663,2362,51,26731,835,4605,1143,6583,64,260,324
2018-11-01,17,3990,5185,2278,11918,12804,2475,52,27436,601,2896,756,4253,35,217,252
2018-11-01,18,4051,5304,2337,12429,13004,2608,53,28282,113,445,141,699,32,163,195
2018-11-01,19,4190,5377,2441,13133,13540,2778,56,29696,1,2,0,3,30,174,204
2018-11-01,20,4174,5356,2391,13020,13358,2765,56,29387,0,0,0,0,65,251,316
2018-11-01,21,4023,5144,2303,12429,12833,2642,54,28146,0,0,0,0,79,286,365
2018-11-01,22,3811,4850,2189,11690,12205,2458,51,26592,0,0,0,0,78,271,349
2018-11-01,23,3610,4590,2018,10639,11312,2231,47,24415,0,0,0,0,94,269,363
2018-11-01,24,3399,4416,1864,9889,10473,2028,44,22621,0,0,0,0,106,283,389
2018-11-02,1,3198,4356,1716,9646,9881,1863,43,21620,0,0,0,0,95,276,371
2018-11-02,2,3083,4292,1645,9258,9413,1795,42,20696,0,0,0,0,87,348,435
2018-11-02,3,3030,4271,1615,8996,9121,1741,42,20088,0,0,0,0,73,318,391
2018-11-02,4,3006,4331,1617,8931,8973,1721,43,19855,0,0,0,0,65,302,367
2018-11-02,5,3049,4522,1684,9118,9153,1759,44,20262,0,0,0,0,67,288,355
2018-11-02,6,3191,4890,1898,9706,9760,1895,50,21597,0,0,0,0,52,274,326
2018-11-02,7,3436,5287,2227,10818,10802,2146,56,24009,0,0,0,0,45,242,287
2018-11-02,8,3465,5320,2461,11698,11275,2238,58,25457,27,479,46,552,44,226,270
2018-11-02,9,3474,5280,2462,11552,11323,2213,57,25333,537,3236,570,4343,44,214,258
2018-11-02,10,3510,5235,2431,11282,11493,2184,54,25201,996,5403,1146,7545,46,203,249
2018-11-02,11,3552,5178,2380,10986,11675,2161,53,25063,1062,5994,1359,8415,47,208,255
2018-11-02,12,3609,5126,2327,10776,11946,2160,52,25124,1018,6091,1383,8492,46,196,242
2018-11-02,13,3691,5100,2285,10689,12270,2190,53,25390,964,5862,1350,8176,42,190,232
2018-11-02,14,3782,5089,2251,10898,12846,2245,53,26230,963,5857,1347,8167,40,201,241
2018-11-02,15,3882,5061,2204,11189,13263,2321,54,27015,982,5731,1342,8055,39,267,306
2018-11-02,16,3984,5055,2183,11484,13564,2393,55,27683,974,5087,1187,7248,42,402,444
2018-11-02,17,4062,5107,2208,11882,13822,2493,55,28439,704,3127,793,4624,44,606,650
2018-11-02,18,4123,5176,2276,12356,13767,2627,56,28993,139,464,148,751,53,900,953
2018-11-02,19,4242,5215,2376,12658,13901,2815,57,29618,1,0,1,2,70,1327,1397
2018-11-02,20,4162,5159,2334,12479,13610,2758,56,29088,0,0,0,0,121,1710,1831
2018-11-02,21,4006,4997,2240,11908,13080,2620,54,27847,0,0,0,0,140,1664,1804
2018-11-02,22,3824,4789,2140,11248,12429,2457,51,26371,0,0,0,0,156,1614,1770
2018-11-02,23,3610,4576,2005,10468,11649,2262,47,24613,0,0,0,0,235,1469,1704
2018-11-02,24,3404,4397,1863,9782,10796,2057,43,22866,0,0,0,0,318,1433,1751
2018-11-03,1,3254,4377,1736,9841,10099,2012,40,22178,0,0,0,0,381,1367,1748
2018-11-03,2,3133,4310,1672,9443,9677,1916,40,21262,0,0,0,0,414,1064,1478
2018-11-03,3,3070,4275,1643,9149,9355,1848,40,20578,0,0,0,0,422,818,1240
2018-11-03,4,3029,4296,1637,8979,9146,1810,40,20161,0,0,0,0,457,615,1072
2018-11-03,5,3028,4377,1672,8988,9128,1809,42,20153,0,0,0,0,526,474,1000
2018-11-03,6,3073,4554,1777,9200,9336,1850,45,20617,0,0,0,0,510,337,847
2018-11-03,7,3170,4815,1944,9670,9712,1934,49,21551,0,0,0,0,495,259,754
2018-11-03,8,3199,4918,2156,10037,9628,1972,52,21876,22,438,40,500,476,223,699
2018-11-03,9,3248,4962,2282,10161,9838,2025,53,22265,464,2948,554,3966,461,196,657
2018-11-03,10,3356,4996,2302,10034,10082,2018,51,22374,857,5083,1126,7066,427,195,622
2018-11-03,11,3460,5008,2265,9831,10324,2003,49,22396,925,5686,1335,7946,435,262,697
2018-11-03,12,3526,5016,2194,9676,10563,2004,48,22482,893,5777,1364,8034,429,286,715
2018-11-03,13,3581,4997,2107,9593,10914,2028,48,22772,848,5668,1330,7846,412,261,673
2018-11-03,14,3649,4978,2039,9668,11360,2082,49,23347,845,5644,1322,7811,395,257,652
2018-11-03,15,3732,4981,1995,9910,11805,2177,49,24129,858,5510,1320,7688,316,219,535
2018-11-03,16,3820,5019,1989,10347,12417,2301,51,25302,830,4854,1159,6843,253,195,448
2018-11-03,17,3875,5139,2031,10814,12835,2441,51,26327,586,2942,781,4309,227,161,388
2018-11-03,18,3949,5260,2115,11477,12859,2563,51,27136,104,434,141,679,164,130,294
2018-11-03,19,4100,5326,2231,11951,13174,2720,52,28084,1,0,1,2,144,147,291
2018-11-03,20,4031,5278,2207,11914,12883,2703,52,27738,0,0,0,0,161,209,370
2018-11-03,21,3919,5122,2128,11474,12389,2598,51,26698,0,0,0,0,178,218,396
2018-11-03,22,3742,4921,2046,10958,11798,2461,48,25451,0,0,0,0,193,186,379
2018-11-03,23,3583,4701,1930,10246,11117,2270,45,23864,0,0,0,0,240,165,405
2018-11-03,24,3404,4534,1802,9594,10416,2087,43,22326,0,0,0,0,266,155,421
2018-11-04,1,3235,4405,1633,9530,9729,1906,42,21394,0,0,0,0,287,144,431
2018-11-04,2,3120,4358,1578,9107,9228,1806,42,20371,0,0,0,0,278,162,440
2018-11-04,3,3011,4346,1562,8689,8752,1721,43,19394,0,0,0,0,269,143,412
2018-11-04,4,3020,4416,1605,8685,8733,1721,46,19373,0,0,0,0,239,126,365
2018-11-04,5,3068,4524,1696,8825,8881,1761,50,19705,0,0,0,0,223,109,332
2018-11-04,6,3056,4588,1827,9137,8799,1784,53,19961,15,361,33,409,214,102,316
2018-11-04,7,3095,4688,1949,9423,8831,1846,53,20341,390,2434,488,3312,217,94,311
2018-11-04,8,3223,4710,2051,9569,9101,1917,53,20828,814,4297,1055,6166,208,97,305
2018-11-04,9,3333,4717,2072,9488,9412,1935,50,21073,894,4972,1281,7147,196,101,297
2018-11-04,10,3448,4697,2001,9313,9699,1914,49,21163,877,5204,1324,7405,150,163,313
2018-11-04,11,3526,4752,1983,9073,10026,1890,48,21225,863,5158,1315,7336,133,330,463
2018-11-04,12,3626,4751,1972,8969,10474,1886,50,21567,876,5137,1312,7325,120,621,741
2018-11-04,13,3734,4801,1960,9081,10914,1931,51,22164,891,5015,1318,7224,118,1019,1137
2018-11-04,14,3861,4877,1951,9296,11290,2057,52,22882,867,4473,1156,6496,139,1388,1527
2018-11-04,15,3942,5050,1975,9766,11710,2199,55,23916,624,2712,784,4120,163,1761,1924
2018-11-04,16,4136,5349,2094,10500,12157,2394,57,25294,108,367,137,612,207,1986,2193
2018-11-04,17,4374,5496,2283,11676,12977,2734,60,27635,2,0,0,2,282,2068,2350
2018-11-04,18,4299,5423,2305,12005,12888,2734,56,27870,0,0,0,0,349,2088,2437
2018-11-04,19,4155,5279,2259,11807,12381,2609,54,27038,0,0,0,0,347,2132,2479
2018-11-04,20,3980,5088,2158,11306,11809,2459,52,25813,0,0,0,0,342,2146,2488
2018-11-04,21,3774,4830,2021,10596,11130,2293,49,24255,0,0,0,0,389,2148,2537
2018-11-04,22,3487,4614,1861,9769,10304,2088,44,22393,0,0,0,0,375,2178,2553
2018-11-04,23,3300,4468,1725,9144,9675,1927,42,20975,0,0,0,0,342,2238,2580
2018-11-04,24,3120,4358,1578,9107,9228,1806,42,20371,0,0,0,0,278,162,440
2018-11-05,1,3102,4401,1669,9113,9271,1840,41,20454,0,0,0,0,319,2453,2772
2018-11-05,2,3008,4381,1636,8801,8965,1769,41,19765,0,0,0,0,322,2400,2722
2018-11-05,3,2962,4390,1629,8644,8763,1723,42,19362,0,0,0,0,307,2309,2616
2018-11-05,4,2952,4485,1663,8640,8730,1711,44,19313,0,0,0,0,307,2176,2483
2018-11-05,5,3017,4721,1782,8893,9021,1772,48,19922,0,0,0,0,277,2006,2283
2018-11-05,6,3180,5113,2041,9534,9742,1928,54,21447,0,0,0,0,250,1791,2041
2018-11-05,7,3317,5376,2425,10628,10506,2109,60,23495,19,401,36,456,237,1593,1830
2018-11-05,8,3370,5435,2613,11400,10900,2207,60,24758,455,2826,538,3819,239,1224,1463
2018-11-05,9,3436,5416,2545,11414,11130,2236,58,25025,942,5034,1138,7114,249,903,1152
2018-11-05,10,3505,5407,2482,11251,11331,2263,53,25085,1012,5648,1338,7998,284,627,911
2018-11-05,11,3584,5381,2412,11083,11570,2251,52,25143,973,5792,1379,8144,272,605,877
2018-11-05,12,3643,5365,2358,10949,11720,2238,52,25144,937,5823,1369,8129,252,621,873
2018-11-05,13,3705,5379,2320,10852,11976,2268,52,25334,953,5819,1373,8145,239,678,917
2018-11-05,14,3779,5389,2286,10967,12329,2311,53,25848,975,5709,1371,8055,198,905,1103
2018-11-05,15,3859,5420,2260,11314,12563,2356,55,26475,951,5177,1229,7357,171,1152,1323
2018-11-05,16,3942,5524,2261,11760,12786,2416,55,27203,673,3060,790,4523,159,1409,1568
2018-11-05,17,4104,5798,2371,12396,13099,2561,57,28299,131,438,158,727,134,1546,1680
2018-11-05,18,4303,5929,2554,13316,13873,2852,60,30287,3,0,0,3,135,1716,1851
2018-11-05,19,4233,5826,2582,13360,13616,2841,58,30062,0,0,0,0,165,1855,2020
2018-11-05,20,4098,5648,2538,12950,13080,2737,56,29009,0,0,0,0,188,1874,2062
2018-11-05,21,3939,5399,2427,12327,12499,2569,53,27636,0,0,0,0,211,1865,2076
2018-11-05,22,3732,5077,2264,11534,11763,2364,49,25897,0,0,0,0,279,1821,2100
2018-11-05,23,3499,4808,2078,10647,10865,2129,45,23873,0,0,0,0,307,1745,2052
2018-11-05,24,3296,4642,1930,9878,10088,1952,43,22148,0,0,0,0,322,1660,1982
2018-11-06,1,3175,4585,1859,9590,9455,1874,44,21158,0,0,0,0,409,1539,1948
2018-11-06,2,3083,4542,1816,9227,9070,1798,44,20329,0,0,0,0,389,1407,1796
2018-11-06,3,3033,4540,1801,9023,8861,1747,45,19868,0,0,0,0,390,1251,1641
2018-11-06,4,3026,4622,1827,8974,8814,1736,46,19761,0,0,0,0,421,1078,1499
2018-11-06,5,3093,4848,1934,9201,9077,1786,50,20310,0,0,0,0,388,790,1178
2018-11-06,6,3259,5241,2199,9819,9730,1943,55,21739,0,0,0,0,355,558,913
2018-11-06,7,3398,5489,2573,10900,10423,2144,62,23724,20,430,33,483,337,375,712
2018-11-06,8,3434,5522,2754,11649,11143,2280,60,25326,493,3105,532,4130,339,248,587
2018-11-06,9,3470,5480,2658,11448,11315,2299,58,25312,1003,5297,1122,7422,360,178,538
2018-11-06,10,3514,5453,2569,11099,11397,2311,55,25054,1072,5890,1324,8286,409,151,560
2018-11-06,11,3565,5423,2465,10825,11439,2287,53,24795,1025,5987,1361,8373,359,151,510
2018-11-06,12,3618,5402,2402,10648,11590,2202,53,24685,993,5905,1342,8240,298,154,452
2018-11-06,13,3679,5414,2353,10541,11713,2201,53,24702,1001,5946,1344,8291,245,148,393
2018-11-06,14,3758,5426,2315,10698,11993,2248,53,25184,1025,5862,1344,8231,171,146,317
2018-11-06,15,3827,5462,2276,11061,12164,2297,54,25766,1010,5247,1242,7499,113,158,271
2018-11-06,16,3908,5580,2276,11547,12391,2375,54,26558,717,3075,795,4587,90,192,282
2018-11-06,17,4042,5850,2396,12255,12672,2512,57,27684,133,436,147,716,60,180,240
2018-11-06,18,4255,5973,2583,13215,13459,2796,62,29719,5,0,0,5,56,234,290
2018-11-06,19,4223,5883,2622,13316,13252,2783,61,29599,0,0,0,0,75,320,395
2018-11-06,20,4089,5711,2587,13066,12751,2687,58,28750,0,0,0,0,79,330,409
2018-11-06,21,3928,5468,2476,12504,12218,2540,55,27505,0,0,0,0,81,324,405
2018-11-06,22,3730,5156,2315,11764,11577,2352,51,25933,0,0,0,0,110,319,429
2018-11-06,23,3547,4887,2132,10818,10724,2130,47,23909,0,0,0,0,111,299,410
2018-11-06,24,3353,4717,1992,10056,9974,1960,45,22225,0,0,0,0,127,273,400
2018-11-07,1,3210,4568,1942,9342,9153,1885,44,20611,0,0,0,0,147,447,594
2018-11-07,2,3124,4538,1908,8974,8791,1813,44,19810,0,0,0,0,146,448,594
2018-11-07,3,3077,4543,1895,8760,8485,1761,45,19240,0,0,0,0,150,461,611
2018-11-07,4,3070,4632,1927,8731,8446,1749,47,19161,0,0,0,0,158,466,624
2018-11-07,5,3140,4870,2040,8960,8654,1799,52,19654,0,0,0,0,148,443,591
2018-11-07,6,3311,5254,2313,9624,9354,1955,59,21179,0,0,0,0,139,415,554
2018-11-07,7,3451,5505,2712,10785,10171,2149,67,23360,20,403,31,454,143,396,539
2018-11-07,8,3483,5514,2870,11387,10638,2238,63,24518,491,3080,553,4124,138,370,508
2018-11-07,9,3506,5439,2763,11072,10797,2244,60,24363,988,5286,1163,7437,140,352,492
2018-11-07,10,3523,5379,2655,10885,10897,2223,56,24252,1062,5880,1360,8302,162,325,487
2018-11-07,11,3547,5312,2549,10767,10986,2201,53,24197,1015,5983,1402,8400,145,459,604
2018-11-07,12,3571,5260,2463,10702,11107,2181,52,24228,983,5900,1379,8262,122,657,779
2018-11-07,13,3614,5247,2405,10721,11286,2199,52,24444,991,5925,1385,8301,107,901,1008
2018-11-07,14,3688,5248,2357,11028,11533,2242,52,25043,1013,5818,1381,8212,83,1203,1286
2018-11-07,15,3761,5273,2333,11337,11741,2294,53,25611,995,5201,1235,7431,71,1495,1566
2018-11-07,16,3845,5398,2321,11803,11910,2367,53,26320,700,3017,779,4496,74,1731,1805
2018-11-07,17,3992,5686,2449,12298,12202,2511,56,27253,132,402,137,671,73,1929,2002
2018-11-07,18,4221,5818,2646,13266,12976,2794,61,29284,4,0,0,4,88,2001,2089
2018-11-07,19,4185,5734,2687,13339,12802,2787,60,29175,0,0,0,0,126,2043,2169
2018-11-07,20,4074,5588,2645,13015,12350,2697,57,28305,0,0,0,0,151,2023,2174
2018-11-07,21,3938,5362,2546,12451,11823,2556,54,27070,0,0,0,0,171,1982,2153
2018-11-07,22,3747,5054,2389,11681,11196,2372,50,25485,0,0,0,0,217,1890,2107
2018-11-07,23,3564,4794,2203,10767,10392,2153,46,23545,0,0,0,0,269,1789,2058
2018-11-07,24,3381,4642,2067,9976,9642,1977,44,21827,0,0,0,0,333,1657,1990
2018-11-08,1,3253,4619,2012,9369,9282,1891,46,20778,0,0,0,0,848,1540,2388
2018-11-08,2,3170,4595,1982,9050,8943,1820,47,20049,0,0,0,0,891,1135,2026
2018-11-08,3,3119,4602,1976,8845,8725,1765,48,19572,0,0,0,0,918,782,1700
2018-11-08,4,3113,4693,2014,8828,8688,1750,49,19504,0,0,0,0,951,524,1475
2018-11-08,5,3182,4921,2138,9096,8962,1801,53,20102,0,0,0,0,948,360,1308
2018-11-08,6,3350,5311,2420,9717,9646,1950,60,21562,0,0,0,0,927,297,1224
2018-11-08,7,3490,5556,2829,10724,10196,2141,67,23315,16,375,29,420,907,323,1230
2018-11-08,8,3526,5558,2980,11097,10490,2218,65,24056,480,3006,539,4025,946,432,1378
2018-11-08,9,3562,5482,2853,10777,10644,2215,63,23885,989,5331,1153,7473,940,635,1575
2018-11-08,10,3592,5423,2728,10558,10726,2194,60,23724,1065,5938,1352,8355,940,871,1811
2018-11-08,11,3612,5356,2597,10407,10868,2181,58,23701,1018,6013,1391,8422,892,977,1869
2018-11-08,12,3632,5294,2489,10348,11083,2176,57,23849,986,5966,1375,8327,820,1057,1877
2018-11-08,13,3653,5280,2414,10369,11311,2205,56,24127,994,6012,1384,8390,749,1081,1830
2018-11-08,14,3701,5278,2357,10638,11683,2286,56,24849,1015,5920,1386,8321,703,1055,1758
2018-11-08,15,3757,5305,2307,11018,12006,2380,56,25645,996,5301,1236,7533,665,1002,1667
2018-11-08,16,3812,5409,2298,11525,12284,2470,56,26522,696,3044,785,4525,606,937,1543
2018-11-08,17,3964,5707,2423,11959,12455,2614,60,27274,128,388,138,654,576,950,1526
2018-11-08,18,4188,5833,2618,12768,12962,2891,64,28872,0,0,0,0,549,850,1399
2018-11-08,19,4191,5750,2665,12855,12794,2863,63,28762,0,0,0,0,543,802,1345
2018-11-08,20,4117,5607,2645,12592,12397,2742,61,27979,0,0,0,0,532,765,1297
2018-11-08,21,4013,5381,2555,12085,11999,2590,61,26921,0,0,0,0,517,743,1260
2018-11-08,22,3831,5090,2401,11398,11319,2408,58,25370,0,0,0,0,479,713,1192
2018-11-08,23,3641,4843,2224,10551,10486,2187,55,23466,0,0,0,0,445,683,1128
2018-11-08,24,3460,4696,2085,9843,9710,2003,54,21797,0,0,0,0,412,654,1066
2018-11-09,1,3333,4694,2056,9498,9354,1889,52,20980,0,0,0,0,469,702,1171
2018-11-09,2,3258,4671,2021,9177,8970,1824,54,20213,0,0,0,0,426,692,1118
2018-11-09,3,3218,4677,2017,8955,8711,1788,56,19697,0,0,0,0,387,661,1048
2018-11-09,4,3224,4766,2059,8875,8504,1773,59,19397,0,0,0,0,333,631,964
2018-11-09,5,3301,4991,2183,9138,8728,1823,64,19941,0,0,0,0,288,615,903
2018-11-09,6,3484,5342,2445,9784,9421,1946,73,21411,0,0,0,0,259,585,844
2018-11-09,7,3636,5580,2815,10829,10340,2134,81,23570,14,376,31,421,220,564,784
2018-11-09,8,3665,5594,2981,11369,10716,2247,76,24594,461,3021,546,4028,191,579,770
2018-11-09,9,3681,5520,2872,11073,10876,2194,69,24398,981,5392,1169,7542,167,620,787
2018-11-09,10,3667,5443,2752,10837,10994,2107,62,24190,1038,5987,1370,8395,153,702,855
2018-11-09,11,3644,5352,2620,10628,10891,2084,58,23850,998,6046,1402,8446,112,752,864
2018-11-09,12,3625,5268,2508,10502,10933,2078,55,23755,957,5988,1379,8324,73,748,821
2018-11-09,13,3615,5231,2420,10455,11077,2124,54,23897,964,6036,1386,8386,43,718,761
2018-11-09,14,3626,5219,2355,10748,11361,2237,53,24585,989,5916,1389,8294,21,618,639
2018-11-09,15,3654,5226,2298,11120,11637,2361,53,25358,968,5309,1243,7520,16,524,540
2018-11-09,16,3697,5324,2287,11569,11793,2468,54,26070,652,3052,786,4490,12,438,450
2018-11-09,17,3863,5600,2402,11984,11968,2609,58,26808,93,374,130,597,10,352,362
2018-11-09,18,4112,5717,2579,12852,12656,2822,63,28582,0,0,0,0,12,315,327
2018-11-09,19,4111,5624,2590,12900,12415,2755,62,28321,0,0,0,0,20,272,292
2018-11-09,20,4048,5463,2528,12551,11990,2659,63,27452,0,0,0,0,30,234,264
2018-11-09,21,3971,5270,2433,12098,11543,2560,63,26452,0,0,0,0,42,205,247
2018-11-09,22,3845,5046,2311,11519,10989,2399,60,25156,0,0,0,0,49,184,233
2018-11-09,23,3674,4836,2180,10830,10331,2233,58,23640,0,0,0,0,56,155,211
2018-11-09,24,3513,4680,2062,10140,9635,2080,58,22098,0,0,0,0,74,138,212
2018-11-10,1,3409,4644,2036,9476,9341,1914,59,20981,0,0,0,0,77,93,170
2018-11-10,2,3325,4599,1986,9124,8890,1818,60,20083,0,0,0,0,84,93,177
2018-11-10,3,3275,4586,1970,8928,8603,1755,62,19539,0,0,0,0,91,93,184
2018-11-10,4,3265,4620,1983,8880,8466,1760,64,19362,0,0,0,0,108,101,209
2018-11-10,5,3293,4708,2045,8959,8532,1776,69,19528,0,0,0,0,111,89,200
2018-11-10,6,3393,4861,2174,9186,8825,1818,74,20095,0,0,0,0,121,80,201
2018-11-10,7,3398,4958,2351,9465,9192,1910,82,20840,13,355,28,396,132,79,211
2018-11-10,8,3397,5076,2511,9537,9207,1944,78,20955,469,2981,500,3950,124,69,193
2018-11-10,9,3444,5124,2577,9509,9248,1978,71,20992,1009,5333,1088,7430,112,66,178
2018-11-10,10,3473,5122,2563,9376,9303,1971,63,20899,1072,5933,1293,8298,107,66,173
2018-11-10,11,3475,5082,2482,9230,9368,1941,57,20782,1033,5989,1329,8351,96,82,178
2018-11-10,12,3461,5029,2405,9068,9401,1925,54,20633,1017,5924,1317,8258,87,117,204
2018-11-10,13,3439,4984,2317,8988,9494,1945,52,20664,1022,5966,1313,8301,78,175,253
2018-11-10,14,3454,4977,2253,9130,9644,1995,51,21006,1044,5841,1308,8193,64,230,294
2018-11-10,15,3494,5008,2200,9485,9789,2057,51,21567,1026,5226,1199,7451,57,320,377
2018-11-10,16,3553,5165,2233,10070,10084,2181,53,22574,703,2916,743,4362,56,439,495
2018-11-10,17,3771,5506,2360,10712,10626,2332,57,23913,97,335,120,552,61,566,627
2018-11-10,18,4030,5645,2542,11647,11622,2604,62,26123,0,0,0,0,70,755,825
2018-11-10,19,4019,5570,2544,11803,11591,2614,61,26257,0,0,0,0,85,966,1051
2018-11-10,20,3942,5426,2495,11547,11367,2546,60,25710,0,0,0,0,97,917,1014
2018-11-10,21,3878,5267,2413,11257,11071,2456,60,25034,0,0,0,0,112,866,978
2018-11-10,22,3759,5064,2313,10801,10675,2338,59,24061,0,0,0,0,138,775,913
2018-11-10,23,3626,4857,2188,10277,10156,2169,59,22851,0,0,0,0,165,663,828
2018-11-10,24,3481,4700,2083,9731,9445,1999,57,21424,0,0,0,0,219,568,787
2018-11-11,1,3357,4646,2041,9290,9173,1820,57,20532,0,0,0,0,470,704,1174
2018-11-11,2,3273,4600,2001,8961,8778,1736,57,19725,0,0,0,0,500,538,1038
2018-11-11,3,3217,4580,2000,8693,8609,1682,59,19236,0,0,0,0,564,418,982
2018-11-11,4,3206,4607,2025,8632,8513,1669,61,19068,0,0,0,0,634,393,1027
2018-11-11,5,3227,4679,2093,8711,8576,1672,65,19216,0,0,0,0,620,342,962
2018-11-11,6,3291,4798,2211,8952,8738,1729,70,19681,0,0,0,0,591,378,969
2018-11-11,7,3291,4885,2363,9304,8788,1781,78,20143,11,324,23,358,571,418,989
2018-11-11,8,3287,4997,2512,9136,8289,1793,74,19482,420,2870,498,3788,572,557,1129
2018-11-11,9,3351,4994,2596,9305,8542,1793,69,19897,987,5303,1116,7406,541,786,1327
2018-11-11,10,3407,4991,2579,9309,8465,1766,66,19794,1068,5906,1324,8298,488,952,1440
2018-11-11,11,3437,4958,2473,9266,8434,1753,61,19702,1029,5964,1362,8355,419,987,1406
2018-11-11,12,3451,4988,2381,9097,8463,1791,58,19598,1004,5925,1350,8279,316,1007,1323
2018-11-11,13,3454,4965,2307,9016,8677,1789,56,19726,1022,5981,1352,8355,247,978,1225
2018-11-11,14,3482,5006,2236,9109,8987,1880,55,20220,1050,5872,1352,8274,196,880,1076
2018-11-11,15,3532,5077,2175,9266,9300,1949,54,20757,1042,5245,1213,7500,156,770,926
2018-11-11,16,3608,5253,2210,9747,9672,2045,56,21707,711,2854,744,4309,126,647,773
2018-11-11,17,3821,5602,2353,10601,10266,2253,61,23371,97,344,115,556,91,551,642
2018-11-11,18,4085,5733,2590,11894,11373,2572,67,26095,0,0,0,0,78,494,572
2018-11-11,19,4086,5664,2634,12157,11449,2589,66,26452,0,0,0,0,67,451,518
2018-11-11,20,4025,5528,2614,11957,11204,2522,67,25939,0,0,0,0,64,434,498
2018-11-11,21,3941,5348,2530,11560,10802,2408,67,25026,0,0,0,0,67,417,484
2018-11-11,22,3789,5101,2387,11007,10396,2255,64,23912,0,0,0,0,75,375,450
2018-11-11,23,3622,4881,2224,10275,9781,2070,62,22379,0,0,0,0,80,379,459
2018-11-11,24,3467,4736,2096,9630,9221,1905,61,21008,0,0,0,0,79,374,453
2018-11-12,1,3367,4639,2046,9517,9024,1838,62,20634,0,0,0,0,147,400,547
2018-11-12,2,3306,4616,2024,9196,8744,1768,62,19964,0,0,0,0,160,417,577
2018-11-12,3,3269,4615,2034,9037,8617,1723,64,19635,0,0,0,0,167,414,581
2018-11-12,4,3270,4709,2082,9015,8573,1700,68,19548,0,0,0,0,164,427,591
2018-11-12,5,3339,4960,2215,9276,8902,1773,74,20217,0,0,0,0,175,428,603
2018-11-12,6,3491,5364,2462,9915,9585,1901,81,21674,0,0,0,0,176,465,641
2018-11-12,7,3568,5628,2776,11020,10192,2020,88,23513,8,314,18,340,178,489,667
2018-11-12,8,3626,5665,2991,11609,10475,2095,85,24455,398,2843,484,3725,169,541,710
2018-11-12,9,3696,5636,2980,11328,10683,2136,79,24418,974,5296,1105,7375,144,607,751
2018-11-12,10,3716,5607,2921,11016,10784,2149,74,24214,1058,5899,1311,8268,130,696,826
2018-11-12,11,3712,5552,2842,10847,10809,2123,69,24038,1022,5961,1350,8333,106,756,862
2018-11-12,12,3690,5505,2719,10770,10841,2082,66,23949,998,5907,1341,8246,68,794,862
2018-11-12,13,3679,5522,2628,10779,10923,2085,64,24040,1016,5969,1349,8334,45,822,867
2018-11-12,14,3701,5539,2548,11019,11018,2163,62,24451,1043,5853,1341,8237,34,765,799
2018-11-12,15,3743,5564,2483,11321,11119,2231,62,24923,1032,5217,1212,7461,31,732,763
2018-11-12,16,3783,5675,2459,11766,11215,2314,62,25547,697,2783,733,4213,35,651,686
2018-11-12,17,3955,6024,2606,12318,11613,2462,67,26650,94,330,114,538,31,605,636
2018-11-12,18,4247,6143,2830,13088,12573,2784,74,28708,0,0,0,0,30,561,591
2018-11-12,19,4275,6025,2887,13340,12621,2797,74,29021,0,0,0,0,30,516,546
2018-11-12,20,4235,5868,2851,13055,12383,2710,74,28412,0,0,0,0,33,518,551
2018-11-12,21,4134,5624,2753,12530,11925,2560,74,27280,0,0,0,0,34,528,562
2018-11-12,22,3974,5295,2577,11793,11291,2358,72,25704,0,0,0,0,39,523,562
2018-11-12,23,3785,5018,2383,10835,10489,2133,69,23718,0,0,0,0,38,500,538
2018-11-12,24,3606,4852,2219,10097,9871,1948,68,22177,0,0,0,0,39,469,508
2018-11-13,1,3425,4769,2118,9529,9478,1905,66,21171,0,0,0,0,31,471,502
2018-11-13,2,3357,4746,2083,9186,9152,1859,67,20457,0,0,0,0,40,490,530
2018-11-13,3,3328,4755,2083,9015,8937,1814,70,20029,0,0,0,0,49,489,538
2018-11-13,4,3339,4848,2123,9015,8882,1812,73,19976,0,0,0,0,48,482,530
2018-11-13,5,3421,5078,2254,9308,9174,1832,78,20586,0,0,0,0,50,484,534
2018-11-13,6,3604,5475,2536,10005,9924,1975,87,22186,0,0,0,0,58,475,533
2018-11-13,7,3756,5737,2923,11128,10763,2193,98,24376,4,278,11,293,63,459,522
2018-11-13,8,3768,5732,3103,11779,11119,2261,93,25444,256,2567,354,3177,73,465,538
2018-11-13,9,3744,5638,2977,11546,11148,2252,84,25219,702,4887,903,6492,66,374,440
2018-11-13,10,3715,5558,2843,11279,11175,2220,75,24940,784,5543,1094,7421,55,414,469
2018-11-13,11,3687,5471,2694,10979,11210,2171,68,24620,771,5641,1159,7571,56,433,489
2018-11-13,12,3659,5399,2598,10792,11250,2119,63,24415,771,5499,1167,7437,46,427,473
2018-11-13,13,3644,5380,2526,10714,11312,2120,60,24397,786,5495,1163,7444,36,401,437
2018-11-13,14,3655,5375,2467,10873,11534,2181,58,24839,794,5348,1122,7264,29,353,382
2018-11-13,15,3679,5393,2405,11039,11624,2225,56,25137,704,4386,968,6058,29,323,352
2018-11-13,16,3731,5539,2409,11208,11719,2381,57,25555,434,2259,569,3262,27,291,318
2018-11-13,17,3932,5861,2551,11669,11988,2533,61,26442,45,231,82,358,25,257,282
2018-11-13,18,4201,5983,2756,12810,12882,2754,68,28703,0,0,0,0,28,240,268
2018-11-13,19,4224,5905,2800,13071,12866,2749,69,28945,0,0,0,0,31,235,266
2018-11-13,20,4175,5763,2762,12839,12572,2693,71,28365,0,0,0,0,31,231,262
2018-11-13,21,4087,5533,2671,12365,12144,2562,71,27332,0,0,0,0,36,224,260
2018-11-13,22,3915,5218,2503,11683,11525,2423,68,25891,0,0,0,0,43,217,260
2018-11-13,23,3719,4956,2317,10770,10777,2220,65,24025,0,0,0,0,50,201,251
2018-11-13,24,3543,4788,2165,10035,10074,2053,64,22418,0,0,0,0,52,202,254
2018-11-14,1,3398,4716,2083,9424,9476,1866,65,21024,0,0,0,0,35,212,247
2018-11-14,2,3328,4678,2043,9076,9140,1796,66,20270,0,0,0,0,40,195,235
2018-11-14,3,3294,4683,2035,8879,8932,1757,68,19829,0,0,0,0,44,204,248
2018-11-14,4,3306,4770,2072,8870,8866,1754,70,19753,0,0,0,0,39,185,224
2018-11-14,5,3383,4998,2190,9152,9139,1809,75,20368,0,0,0,0,45,175,220
2018-11-14,6,3559,5380,2467,9866,9860,1973,82,21975,0,0,0,0,48,190,238
2018-11-14,7,3712,5644,2838,11070,10673,2184,92,24211,4,197,9,210,53,193,246
2018-11-14,8,3699,5649,3013,11527,10946,2246,88,25001,291,1927,352,2570,56,197,253
2018-11-14,9,3668,5563,2906,11449,11112,2228,80,25058,835,3946,930,5711,65,209,274
2018-11-14,10,3643,5493,2788,11145,11185,2191,74,24784,932,4654,1150,6736,66,251,317
2018-11-14,11,3618,5414,2659,10914,11251,2158,67,24579,909,4967,1216,7092,45,272,317
2018-11-14,12,3591,5349,2570,10800,11330,2119,63,24503,889,5010,1218,7117,30,297,327
2018-11-14,13,3582,5334,2495,10865,11479,2148,60,24745,897,5099,1225,7221,21,306,327
2018-11-14,14,3598,5335,2439,11066,11728,2229,58,25273,925,4959,1199,7083,13,268,281
2018-11-14,15,3629,5362,2403,11315,11892,2313,57,25767,911,4363,1097,6371,15,242,257
2018-11-14,16,3684,5502,2405,11609,12010,2403,57,26270,598,2289,673,3560,18,215,233
2018-11-14,17,3876,5824,2521,12067,12197,2543,61,27059,71,241,94,406,23,186,209
2018-11-14,18,4131,5928,2722,12974,13040,2774,67,29047,0,0,0,0,30,161,191
2018-11-14,19,4155,5842,2747,13006,12901,2776,66,28939,0,0,0,0,68,155,223
2018-11-14,20,4106,5699,2695,12774,12565,2685,65,28279,0,0,0,0,94,148,242
2018-11-14,21,4022,5479,2611,12326,12071,2570,67,27224,0,0,0,0,120,126,246
2018-11-14,22,3854,5172,2452,11703,11443,2407,65,25809,0,0,0,0,151,120,271
2018-11-14,23,3667,4904,2273,10850,10660,2196,62,23960,0,0,0,0,137,121,258
2018-11-14,24,3492,4731,2124,10182,10032,2018,60,22485,0,0,0,0,117,113,230
2018-11-15,1,3360,4665,2027,9643,9537,1874,59,21305,0,0,0,0,88,140,228
2018-11-15,2,3283,4623,1981,9333,9210,1824,59,20619,0,0,0,0,81,145,226
2018-11-15,3,3241,4624,1972,9169,8984,1796,61,20203,0,0,0,0,76,154,230
2018-11-15,4,3246,4712,2002,9174,8911,1779,63,20120,0,0,0,0,68,153,221
2018-11-15,5,3318,4935,2112,9471,9170,1811,68,20713,0,0,0,0,68,146,214
2018-11-15,6,3497,5318,2378,10212,9893,1964,76,22338,0,0,0,0,69,143,212
2018-11-15,7,3645,5582,2755,11424,10583,2166,85,24451,3,231,8,242,76,142,218
2018-11-15,8,3658,5586,2920,11951,10856,2225,81,25304,254,2443,336,3033,70,145,215
2018-11-15,9,3655,5522,2836,11540,11087,2189,74,25076,704,4761,857,6322,63,154,217
2018-11-15,10,3644,5474,2738,11394,11183,2132,69,24964,813,5423,1042,7278,53,181,234
2018-11-15,11,3635,5411,2624,11142,11286,2109,64,24786,798,5535,1128,7461,43,179,222
2018-11-15,12,3628,5357,2546,10969,11418,2113,61,24746,763,5309,1112,7184,29,173,202
2018-11-15,13,3627,5352,2484,10957,11638,2157,59,24996,777,5247,1100,7124,22,151,173
2018-11-15,14,3653,5359,2430,11060,11871,2250,58,25424,791,5060,1045,6896,16,111,127
2018-11-15,15,3689,5385,2396,11277,12027,2366,57,25914,719,4245,893,5857,14,86,100
2018-11-15,16,3736,5516,2395,11562,12167,2466,58,26439,422,2099,505,3026,12,73,85
2018-11-15,17,3911,5825,2501,12049,12443,2604,61,27346,40,189,63,292,8,55,63
2018-11-15,18,4143,5909,2688,12958,13226,2799,66,29240,0,0,0,0,9,69,78
2018-11-15,19,4148,5815,2709,12989,13031,2781,65,29056,0,0,0,0,8,73,81
2018-11-15,20,4090,5671,2657,12684,12632,2681,64,28251,0,0,0,0,11,78,89
2018-11-15,21,3997,5451,2570,12282,12154,2583,62,27271,0,0,0,0,24,62,86
2018-11-15,22,3829,5155,2413,11632,11482,2438,60,25803,0,0,0,0,35,59,94
2018-11-15,23,3653,4892,2236,10846,10672,2231,58,23999,0,0,0,0,47,59,106
2018-11-15,24,3476,4719,2089,10146,10056,2058,56,22509,0,0,0,0,57,66,123
2018-11-16,1,3367,4665,2013,9636,9572,1916,56,21370,0,0,0,0,46,47,93
2018-11-16,2,3280,4623,1963,9294,9184,1836,56,20560,0,0,0,0,53,45,98
2018-11-16,3,3236,4620,1947,9127,8888,1785,57,20047,0,0,0,0,59,45,104
2018-11-16,4,3234,4701,1974,9108,8798,1777,60,19932,0,0,0,0,66,47,113
2018-11-16,5,3303,4910,2075,9359,8926,1822,63,20360,0,0,0,0,74,41,115
2018-11-16,6,3473,5263,2319,10100,9583,1960,70,21904,0,0,0,0,83,40,123
2018-11-16,7,3618,5517,2665,11062,10396,2196,79,23924,4,149,8,161,96,40,136
2018-11-16,8,3644,5544,2848,11664,11022,2268,76,25222,340,1784,350,2474,99,40,139
2018-11-16,9,3659,5498,2777,11457,11120,2239,69,25078,925,3833,931,5689,95,38,133
2018-11-16,10,3659,5451,2690,11209,11193,2180,64,24838,1018,4527,1143,6688,84,39,123
2018-11-16,11,3640,5386,2579,10957,11287,2134,62,24627,982,4843,1226,7051,69,52,121
2018-11-16,12,3624,5326,2502,10767,11394,2105,59,24511,950,4871,1234,7055,52,61,113
2018-11-16,13,3608,5310,2431,10721,11569,2117,58,24652,970,4883,1246,7099,38,67,105
2018-11-16,14,3615,5310,2375,10932,11883,2168,57,25227,1009,4735,1220,6964,26,67,93
2018-11-16,15,3647,5332,2338,11113,12100,2248,57,25704,987,4160,1080,6227,20,87,107
2018-11-16,16,3703,5436,2334,11440,12291,2320,57,26295,627,2105,637,3369,18,154,172
2018-11-16,17,3871,5730,2445,11901,12496,2453,61,27097,66,184,80,330,11,206,217
2018-11-16,18,4099,5792,2627,12686,13258,2691,66,28889,0,0,0,0,11,325,336
2018-11-16,19,4089,5675,2623,12677,12985,2699,66,28614,0,0,0,0,13,496,509
2018-11-16,20,4029,5507,2551,12333,12555,2618,64,27758,0,0,0,0,16,486,502
2018-11-16,21,3948,5322,2457,11965,12130,2518,62,26863,0,0,0,0,27,437,464
2018-11-16,22,3827,5104,2329,11437,11587,2389,60,25662,0,0,0,0,35,407,442
2018-11-16,23,3672,4885,2188,10719,10966,2206,58,24139,0,0,0,0,45,391,436
2018-11-16,24,3507,4712,2066,10110,10187,2040,56,22582,0,0,0,0,63,377,440
2018-11-17,1,3418,4655,2025,9623,9350,1848,54,21068,0,0,0,0,66,369,435
2018-11-17,2,3326,4599,1973,9285,8941,1762,55,20236,0,0,0,0,81,389,470
2018-11-17,3,3270,4584,1956,9102,8687,1710,57,19749,0,0,0,0,77,391,468
2018-11-17,4,3251,4616,1968,9016,8534,1706,59,19509,0,0,0,0,71,381,452
2018-11-17,5,3269,4711,2025,9077,8609,1712,61,19653,0,0,0,0,58,354,412
2018-11-17,6,3350,4861,2147,9367,8931,1773,67,20331,0,0,0,0,55,300,355
2018-11-17,7,3368,4977,2315,9852,9091,1855,74,21064,2,168,7,177,59,251,310
2018-11-17,8,3355,5086,2470,10091,8851,1872,72,21075,253,1961,309,2523,61,165,226
2018-11-17,9,3420,5144,2563,10365,9198,1891,66,21708,761,4077,848,5686,62,99,161
2018-11-17,10,3470,5166,2569,10204,9464,1864,60,21779,886,4768,1074,6728,54,62,116
2018-11-17,11,3482,5155,2507,10053,9521,1826,57,21644,871,5024,1181,7076,40,64,104
2018-11-17,12,3476,5142,2451,9840,9469,1808,55,21359,830,5007,1190,7027,25,85,110
2018-11-17,13,3461,5130,2372,9667,9576,1836,54,21319,847,5009,1197,7053,18,125,143
2018-11-17,14,3476,5133,2309,9656,9724,1889,54,21509,862,4816,1149,6827,15,168,183
2018-11-17,15,3514,5188,2269,9774,9795,1982,54,21791,812,4186,983,5981,13,240,253
2018-11-17,16,3567,5337,2283,10020,9889,2120,55,22271,485,2068,557,3110,18,346,364
2018-11-17,17,3797,5689,2419,10665,10391,2259,59,23561,42,175,64,281,14,404,418
2018-11-17,18,4050,5774,2603,11666,11288,2509,65,25714,0,0,0,0,31,528,559
2018-11-17,19,4040,5670,2599,11790,11254,2512,64,25808,0,0,0,0,62,639,701
2018-11-17,20,3966,5533,2536,11604,11115,2439,62,25408,0,0,0,0,76,497,573
2018-11-17,21,3888,5373,2469,11346,10831,2339,61,24765,0,0,0,0,90,345,435
2018-11-17,22,3768,5164,2364,10952,10421,2237,59,23857,0,0,0,0,114,253,367
2018-11-17,23,3636,4949,2239,10407,10029,2084,56,22767,0,0,0,0,109,172,281
2018-11-17,24,3492,4777,2126,9838,9564,1920,55,21570,0,0,0,0,111,117,228
2018-11-18,1,3356,4731,2018,9316,9132,1826,53,20520,0,0,0,0,235,144,379
2018-11-18,2,3273,4687,1979,8937,8750,1744,54,19677,0,0,0,0,255,97,352
2018-11-18,3,3218,4675,1978,8722,8537,1691,55,19196,0,0,0,0,240,78,318
2018-11-18,4,3208,4704,2006,8634,8444,1674,56,19001,0,0,0,0,205,96,301
2018-11-18,5,3230,4775,2072,8666,8503,1681,59,19102,0,0,0,0,157,79,236
2018-11-18,6,3294,4891,2189,8861,8626,1732,63,19475,0,0,0,0,123,97,220
2018-11-18,7,3301,4998,2350,9222,8624,1791,70,19900,2,134,6,142,104,125,229
2018-11-18,8,3294,5108,2523,9508,8728,1809,69,20304,185,1682,255,2122,92,163,255
2018-11-18,9,3353,5098,2615,9699,8889,1811,65,20651,620,3674,727,5021,80,199,279
2018-11-18,10,3403,5081,2595,9543,8858,1766,63,20417,758,4467,941,6166,67,287,354
2018-11-18,11,3415,5030,2485,9320,8876,1716,60,20158,738,4790,1060,6588,49,311,360
2018-11-18,12,3416,5041,2394,9202,8912,1683,58,20042,708,4826,1107,6641,36,331,367
2018-11-18,13,3412,5011,2313,9100,9133,1698,56,20175,714,4812,1106,6632,33,322,355
2018-11-18,14,3427,5049,2237,9218,9435,1750,56,20646,723,4621,1051,6395,22,287,309
2018-11-18,15,3468,5123,2183,9485,9813,1828,54,21367,636,4007,902,5545,15,267,282
2018-11-18,16,3536,5318,2211,9871,10151,1955,56,22219,352,1961,504,2817,20,231,251
2018-11-18,17,3763,5698,2379,10598,10628,2159,61,23633,26,161,55,242,15,219,234
2018-11-18,18,4020,5803,2616,11807,11660,2502,67,26225,0,0,0,0,14,241,255
2018-11-18,19,4029,5728,2652,11946,11712,2555,66,26467,0,0,0,0,17,263,280
2018-11-18,20,3985,5609,2626,11756,11481,2512,64,26002,0,0,0,0,13,259,272
2018-11-18,21,3905,5433,2550,11420,11101,2393,64,25167,0,0,0,0,22,238,260
2018-11-18,22,3761,5192,2413,10902,10561,2240,62,23954,0,0,0,0,31,228,259
2018-11-18,23,3608,4966,2252,10188,9997,2047,59,22483,0,0,0,0,24,226,250
2018-11-18,24,3449,4824,2119,9486,9403,1890,58,21029,0,0,0,0,32,215,247
2018-11-19,1,3349,4733,2056,9463,9055,1798,58,20567,0,0,0,0,47,202,249
2018-11-19,2,3283,4716,2038,9176,8773,1737,59,19936,0,0,0,0,55,208,263
2018-11-19,3,3253,4735,2054,9031,8630,1693,61,19608,0,0,0,0,67,222,289
2018-11-19,4,3268,4843,2113,9072,8622,1694,65,19645,0,0,0,0,72,227,299
2018-11-19,5,3347,5083,2249,9374,8948,1759,70,20343,0,0,0,0,83,241,324
2018-11-19,6,3540,5477,2535,10090,9670,1931,79,21962,0,0,0,0,85,180,265
2018-11-19,7,3709,5769,2927,11352,10543,2146,88,24322,1,151,5,157,94,262,356
2018-11-19,8,3754,5802,3134,12103,10909,2227,89,25520,127,1852,214,2193,88,257,345
2018-11-19,9,3759,5747,3041,12023,11007,2182,79,25480,441,3775,623,4839,92,255,347
2018-11-19,10,3759,5704,2925,11633,11080,2119,73,25093,574,4453,814,5841,76,295,371
2018-11-19,11,3739,5642,2802,11434,11143,2070,67,24901,581,4581,941,6103,47,329,376
2018-11-19,12,3702,5596,2702,11261,11186,2033,63,24731,568,4444,981,5993,23,334,357
2018-11-19,13,3679,5588,2626,11193,11357,2061,61,24860,581,4172,964,5717,17,334,351
2018-11-19,14,3672,5590,2560,11279,11615,2116,59,25256,588,3841,883,5312,12,294,306
2018-11-19,15,3675,5612,2513,11397,11755,2179,58,25577,441,3183,713,4337,12,255,267
2018-11-19,16,3710,5756,2517,11666,11930,2256,59,26100,209,1406,365,1980,12,222,234
2018-11-19,17,3905,6096,2669,12129,12287,2419,64,27087,18,107,41,166,8,211,219
2018-11-19,18,4180,6192,2892,13372,13202,2732,69,29565,0,0,0,0,6,205,211
2018-11-19,19,4217,6100,2930,13598,13139,2765,68,29759,0,0,0,0,11,208,219
2018-11-19,20,4180,5952,2884,13375,12858,2700,67,29188,0,0,0,0,18,192,210
2018-11-19,21,4083,5714,2788,12974,12389,2560,68,28179,0,0,0,0,39,176,215
2018-11-19,22,3916,5390,2617,12312,11812,2373,65,26751,0,0,0,0,73,158,231
2018-11-19,23,3729,5110,2426,11323,11026,2146,62,24748,0,0,0,0,80,148,228
2018-11-19,24,3551,4931,2268,10455,10270,1964,60,22940,0,0,0,0,88,142,230
2018-11-20,1,3432,4847,2178,9871,9548,1911,60,21578,0,0,0,0,30,181,211
2018-11-20,2,3356,4814,2146,9541,9190,1829,61,20809,0,0,0,0,33,166,199
2018-11-20,3,3322,4819,2147,9352,8982,1782,63,20367,0,0,0,0,36,153,189
2018-11-20,4,3326,4916,2189,9348,8922,1770,64,20293,0,0,0,0,48,143,191
2018-11-20,5,3402,5150,2313,9613,9193,1824,70,20889,0,0,0,0,41,139,180
2018-11-20,6,3570,5536,2593,10325,9885,1956,79,22435,0,0,0,0,43,133,176
2018-11-20,7,3719,5810,2978,11532,10740,2190,84,24735,2,111,5,118,48,120,168
2018-11-20,8,3728,5810,3168,12249,11115,2280,83,25918,167,1658,290,2115,44,129,173
2018-11-20,9,3712,5727,3059,12158,11230,2258,76,25913,622,3710,815,5147,44,128,172
2018-11-20,10,3695,5666,2931,11829,11268,2227,70,25584,765,4462,1062,6289,46,149,195
2018-11-20,11,3683,5593,2791,11514,11302,2172,66,25244,763,4874,1156,6793,32,166,198
2018-11-20,12,3662,5538,2699,11228,11346,2163,62,24990,747,5056,1176,6979,34,166,200
2018-11-20,13,3645,5527,2625,11121,11487,2170,60,25027,755,5186,1179,7120,51,161,212
2018-11-20,14,3652,5525,2566,11229,11685,2227,59,25388,758,5101,1131,6990,56,142,198
2018-11-20,15,3672,5551,2509,11407,11847,2282,58,25782,692,4528,973,6193,68,133,201
2018-11-20,16,3726,5699,2518,11692,11866,2354,58,26160,368,2211,514,3093,81,136,217
2018-11-20,17,3922,6039,2672,12156,12053,2504,62,26965,22,195,52,269,104,137,241
2018-11-20,18,4177,6139,2881,13096,12891,2768,68,29012,0,0,0,0,147,180,327
2018-11-20,19,4209,6048,2911,13174,12893,2778,67,29101,0,0,0,0,179,234,413
2018-11-20,20,4166,5909,2856,12922,12662,2727,67,28566,0,0,0,0,191,224,415
2018-11-20,21,4071,5681,2763,12544,12228,2613,67,27641,0,0,0,0,211,192,403
2018-11-20,22,3901,5365,2595,11976,11728,2436,65,26394,0,0,0,0,243,185,428
2018-11-20,23,3706,5092,2398,11172,11032,2208,61,24662,0,0,0,0,199,198,397
2018-11-20,24,3528,4920,2239,10441,10244,2033,60,22967,0,0,0,0,141,221,362
2018-11-21,1,3392,4787,2161,9585,9594,1871,59,21301,0,0,0,0,77,215,292
2018-11-21,2,3314,4755,2115,9214,9244,1794,60,20504,0,0,0,0,96,215,311
2018-11-21,3,3274,4768,2105,9005,9030,1747,62,20035,0,0,0,0,130,205,335
2018-11-21,4,3275,4860,2138,8974,8963,1733,65,19926,0,0,0,0,166,185,351
2018-11-21,5,3347,5090,2239,9237,9221,1783,70,20502,0,0,0,0,147,183,330
2018-11-21,6,3530,5477,2492,9877,9915,1936,79,21997,0,0,0,0,160,170,330
2018-11-21,7,3682,5735,2844,11100,10735,2158,88,24272,2,184,7,193,173,153,326
2018-11-21,8,3684,5733,3012,11845,11146,2236,85,25503,113,2041,238,2392,207,132,339
2018-11-21,9,3667,5645,2947,12049,11312,2215,77,25843,395,3976,620,4991,250,134,384
2018-11-21,10,3650,5574,2856,12063,11378,2220,70,25921,495,4648,788,5931,286,124,410
2018-11-21,11,3640,5491,2757,11953,11429,2205,65,25841,467,4872,792,6131,275,151,426
2018-11-21,12,3623,5424,2699,11802,11446,2205,61,25703,408,4726,699,5833,289,214,503
2018-11-21,13,3615,5404,2653,11713,11570,2222,59,25753,380,4615,675,5670,313,303,616
2018-11-21,14,3628,5401,2610,11692,11745,2263,57,25947,371,4313,581,5265,274,379,653
2018-11-21,15,3656,5425,2582,11516,11761,2337,56,25861,314,3468,429,4211,267,498,765
2018-11-21,16,3717,5573,2622,11380,11778,2381,56,25786,162,1649,222,2033,275,613,888
2018-11-21,17,3922,5918,2755,11731,12118,2534,60,26632,9,122,24,155,235,577,812
2018-11-21,18,4172,6011,2945,12824,12999,2804,66,28882,0,0,0,0,217,543,760
2018-11-21,19,4193,5908,2939,12964,12984,2773,65,28975,0,0,0,0,202,552,754
2018-11-21,20,4148,5768,2851,12666,12739,2682,64,28340,0,0,0,0,187,570,757
2018-11-21,21,4047,5561,2743,12198,12268,2584,62,27301,0,0,0,0,189,617,806
2018-11-21,22,3874,5254,2580,11513,11651,2436,60,25849,0,0,0,0,217,630,847
2018-11-21,23,3687,4979,2391,10612,10813,2237,56,23908,0,0,0,0,233,679,912
2018-11-21,24,3515,4790,2222,9913,10137,2033,53,22327,0,0,0,0,249,773,1022
2018-11-22,1,3398,4674,2093,9515,9426,1930,54,21116,0,0,0,0,249,785,1034
2018-11-22,2,3291,4591,2022,9043,8993,1836,54,20117,0,0,0,0,276,768,1044
2018-11-22,3,3222,4575,1987,8749,8680,1808,54,19483,0,0,0,0,310,832,1142
2018-11-22,4,3195,4601,1992,8601,8502,1768,54,19117,0,0,0,0,321,972,1293
2018-11-22,5,3212,4661,2044,8628,8495,1758,57,19129,0,0,0,0,318,1074,1392
2018-11-22,6,3268,4780,2137,8837,8695,1809,62,19594,0,0,0,0,299,1200,1499
2018-11-22,7,3272,4894,2292,9235,8871,1936,67,20301,3,108,7,118,284,1357,1641
2018-11-22,8,3265,5039,2463,9508,9048,2018,70,20834,151,1348,238,1737,334,1607,1941
2018-11-22,9,3342,5131,2594,9832,9237,2069,69,21394,524,3093,655,4272,396,1931,2327
2018-11-22,10,3418,5166,2640,10019,9407,2082,67,21762,642,3873,873,5388,396,2190,2586
2018-11-22,11,3474,5180,2649,10103,9465,2066,65,21886,624,4229,1004,5857,432,2357,2789
2018-11-22,12,3537,5118,2613,10230,9530,2073,63,22083,612,4317,1066,5995,478,2490,2968
2018-11-22,13,3572,4997,2503,10259,9639,2103,61,22248,614,4399,1091,6104,530,2683,3213
2018-11-22,14,3594,4868,2398,10291,9681,2126,58,22343,631,4348,1057,6036,474,2687,3161
2018-11-22,15,3610,4809,2284,10322,9651,2163,55,22379,570,3885,905,5360,452,2607,3059
2018-11-22,16,3634,4864,2239,10492,9707,2160,54,22601,276,2053,506,2835,427,2549,2976
2018-11-22,17,3760,5100,2269,10769,9846,2228,56,23088,20,169,56,245,419,2434,2853
2018-11-22,18,3893,5196,2330,11392,10371,2333,59,24344,0,0,0,0,472,2359,2831
2018-11-22,19,3841,5179,2291,11288,10211,2314,58,24060,0,0,0,0,541,2285,2826
2018-11-22,20,3787,5117,2253,11089,10113,2295,59,23745,0,0,0,0,634,2324,2958
2018-11-22,21,3731,5068,2225,10804,10050,2238,60,23341,0,0,0,0,715,2293,3008
2018-11-22,22,3658,4921,2166,10441,9839,2170,60,22699,0,0,0,0,797,2299,3096
2018-11-22,23,3578,4748,2078,10006,9516,2057,58,21828,0,0,0,0,796,2236,3032
2018-11-22,24,3446,4633,1974,9574,9156,1940,57,20917,0,0,0,0,803,2175,2978
2018-11-23,1,3340,4550,1939,9507,8816,1818,51,20385,0,0,0,0,516,2119,2635
2018-11-23,2,3257,4504,1905,9132,8520,1769,52,19664,0,0,0,0,518,2034,2552
2018-11-23,3,3201,4497,1904,8826,8337,1719,54,19127,0,0,0,0,520,1986,2506
2018-11-23,4,3184,4556,1931,8694,8285,1709,58,18936,0,0,0,0,514,1925,2439
2018-11-23,5,3225,4666,2015,8676,8418,1728,63,19076,0,0,0,0,522,1905,2427
2018-11-23,6,3318,4820,2144,8780,8783,1793,68,19615,0,0,0,0,537,1874,2411
2018-11-23,7,3357,4912,2303,9255,9146,1898,76,20567,2,133,6,141,574,1856,2430
2018-11-23,8,3345,4990,2441,9431,9214,1967,74,20877,69,1741,210,2020,605,1857,2462
2018-11-23,9,3405,4989,2500,9639,9398,1993,65,21285,248,3718,505,4471,633,1904,2537
2018-11-23,10,3442,4971,2501,10088,9494,1987,59,21819,323,4476,675,5474,637,1997,2634
2018-11-23,11,3450,4955,2480,10471,9543,2084,53,22341,319,4750,747,5816,621,2148,2769
2018-11-23,12,3428,4919,2421,10773,9531,2092,49,22634,289,4682,726,5697,600,2279,2879
2018-11-23,13,3425,4890,2359,10852,9546,2101,46,22733,274,4576,719,5569,608,2405,3013
2018-11-23,14,3445,4907,2296,10832,9654,2147,45,22865,265,4324,626,5215,601,2390,2991
2018-11-23,15,3485,4948,2286,10860,9767,2148,44,23008,244,3673,505,4422,575,2409,2984
2018-11-23,16,3567,5099,2319,10968,9924,2183,44,23310,108,1811,272,2191,557,2335,2892
2018-11-23,17,3810,5495,2463,11200,10360,2306,49,24104,9,155,34,198,555,2330,2885
2018-11-23,18,4054,5594,2610,11913,11529,2564,55,26250,0,0,0,0,524,2294,2818
2018-11-23,19,4050,5526,2584,12010,11603,2555,54,26412,0,0,0,0,515,2240,2755
2018-11-23,20,3979,5415,2516,11730,11461,2498,52,25931,0,0,0,0,506,2239,2745
2018-11-23,21,3919,5295,2453,11342,11224,2428,51,25235,0,0,0,0,494,2295,2789
2018-11-23,22,3805,5088,2345,10744,10848,2310,51,24143,0,0,0,0,517,2326,2843
2018-11-23,23,3677,4877,2237,10122,10330,2144,49,22837,0,0,0,0,519,2402,2921
2018-11-23,24,3520,4690,2114,9573,9716,1964,48,21492,0,0,0,0,512,2480,2992
2018-11-24,1,3265,4617,1991,9286,9365,1848,47,20738,0,0,0,0,504,2473,2977
2018-11-24,2,3177,4555,1946,8866,9018,1763,48,19886,0,0,0,0,493,2521,3014
2018-11-24,3,3131,4536,1932,8606,8777,1709,48,19334,0,0,0,0,481,2513,2994
2018-11-24,4,3120,4568,1951,8510,8598,1689,50,19039,0,0,0,0,469,2570,3039
2018-11-24,5,3152,4655,2015,8605,8681,1714,53,19246,0,0,0,0,398,2572,2970
2018-11-24,6,3227,4799,2137,8844,8990,1770,57,19854,0,0,0,0,325,2533,2858
2018-11-24,7,3262,4924,2302,9244,9289,1847,63,20634,1,167,5,173,276,2482,2758
2018-11-24,8,3251,5044,2482,9574,9373,1897,63,21099,73,1897,155,2125,230,2549,2779
2018-11-24,9,3303,5106,2587,10023,9599,1931,60,21805,325,4100,445,4870,206,2560,2766
2018-11-24,10,3340,5124,2585,10308,9635,1936,57,22130,455,4884,654,5993,234,2556,2790
2018-11-24,11,3357,5105,2493,10486,9640,1910,55,22284,470,5117,762,6349,217,2610,2827
2018-11-24,12,3362,5086,2412,10453,9595,1865,54,22160,496,5188,806,6490,189,2635,2824
2018-11-24,13,3359,5073,2316,10383,9635,1959,53,22223,538,5202,835,6575,174,2716,2890
2018-11-24,14,3378,5069,2235,10426,9681,2041,52,22393,564,5081,758,6403,131,2747,2878
2018-11-24,15,3424,5126,2184,10439,9700,2132,52,22516,541,4433,651,5625,106,2753,2859
2018-11-24,16,3507,5282,2221,10478,9817,2196,53,22736,315,2258,359,2932,96,2735,2831
2018-11-24,17,3752,5661,2369,10927,10295,2254,56,23724,22,218,42,282,84,2642,2726
2018-11-24,18,3983,5722,2534,11870,11152,2447,61,25721,0,0,0,0,86,2474,2560
2018-11-24,19,3957,5607,2533,11972,11252,2497,60,25971,0,0,0,0,107,2263,2370
2018-11-24,20,3887,5495,2478,11770,11133,2447,59,25601,0,0,0,0,112,1776,1888
2018-11-24,21,3807,5356,2418,11481,10891,2345,59,24966,0,0,0,0,115,1251,1366
2018-11-24,22,3694,5158,2314,11067,10550,2226,57,24091,0,0,0,0,155,754,909
2018-11-24,23,3562,4953,2192,10517,10089,2067,55,22919,0,0,0,0,173,491,664
2018-11-24,24,3429,4794,2085,9888,9581,1926,54,21640,0,0,0,0,184,334,518
2018-11-25,1,3299,4687,2019,9193,9049,1834,52,20320,0,0,0,0,104,255,359
2018-11-25,2,3222,4652,1982,8810,8666,1750,53,19471,0,0,0,0,96,232,328
2018-11-25,3,3172,4645,1979,8591,8431,1695,54,18964,0,0,0,0,91,218,309
2018-11-25,4,3161,4681,2007,8516,8321,1680,56,18765,0,0,0,0,109,208,317
2018-11-25,5,3187,4757,2073,8602,8357,1692,59,18902,0,0,0,0,99,190,289
2018-11-25,6,3254,4868,2177,8834,8521,1739,64,19351,0,0,0,0,89,188,277
2018-11-25,7,3292,4978,2315,9265,8672,1785,72,19985,1,163,5,169,86,193,279
2018-11-25,8,3288,5084,2489,9531,8717,1814,72,20328,99,1838,182,2119,69,206,275
2018-11-25,9,3351,5057,2595,9583,8868,1818,68,20530,380,3722,512,4614,62,238,300
2018-11-25,10,3414,5025,2593,9436,8876,1782,63,20348,534,4402,737,5673,56,325,381
2018-11-25,11,3439,4956,2490,9170,8897,1744,59,20062,590,4667,873,6130,43,329,372
2018-11-25,12,3434,4958,2414,8919,8898,1729,57,19794,604,4441,914,5959,35,311,346
2018-11-25,13,3417,4909,2341,8785,9056,1752,55,19839,661,4335,945,5941,30,288,318
2018-11-25,14,3424,4936,2270,8759,9269,1802,54,20076,684,4093,913,5690,20,251,271
2018-11-25,15,3456,5007,2224,8892,9534,1902,54,20571,648,3409,811,4868,17,209,226
2018-11-25,16,3521,5206,2265,9269,9828,2032,55,21375,392,1649,452,2493,14,178,192
2018-11-25,17,3773,5611,2428,10067,10334,2235,60,22887,30,141,55,226,8,158,166
2018-11-25,18,4039,5702,2636,11427,11365,2575,65,25622,0,0,0,0,10,155,165
2018-11-25,19,4036,5632,2654,11788,11455,2606,65,26105,0,0,0,0,22,176,198
2018-11-25,20,3990,5534,2613,11708,11307,2546,67,25817,0,0,0,0,22,163,185
2018-11-25,21,3899,5381,2532,11416,10938,2424,66,25034,0,0,0,0,20,163,183
2018-11-25,22,3762,5148,2393,10908,10492,2269,63,23922,0,0,0,0,24,168,192
2018-11-25,23,3611,4921,2229,10206,9863,2073,60,22395,0,0,0,0,36,136,172
2018-11-25,24,3454,4794,2083,9547,9321,1912,59,21032,0,0,0,0,53,116,169
2018-11-26,1,3356,4837,1946,8814,9034,1859,59,19959,0,0,0,0,60,110,170
2018-11-26,2,3292,4817,1912,8560,8746,1797,60,19355,0,0,0,0,58,113,171
2018-11-26,3,3265,4841,1920,8421,8561,1762,62,18999,0,0,0,0,51,118,169
2018-11-26,4,3279,4947,1960,8465,8549,1758,65,19029,0,0,0,0,45,126,171
2018-11-26,5,3360,5192,2081,8781,8874,1807,71,19722,0,0,0,0,43,133,176
2018-11-26,6,3546,5587,2340,9525,9553,1963,80,21311,0,0,0,0,37,140,177
2018-11-26,7,3732,5877,2697,10756,10440,2164,90,23640,2,139,6,147,35,146,181
2018-11-26,8,3773,5908,2899,11426,10790,2198,90,24696,133,2012,280,2425,43,136,179
2018-11-26,9,3774,5857,2857,11235,11220,2166,81,24896,471,4496,783,5750,43,140,183
2018-11-26,10,3764,5812,2778,10893,11384,2113,74,24658,612,5312,1038,6962,39,156,195
2018-11-26,11,3733,5749,2686,10604,11411,2084,68,24361,645,5468,1137,7250,34,163,197
2018-11-26,12,3695,5698,2625,10455,11382,2058,64,24153,641,5455,1163,7259,31,166,197
2018-11-26,13,3668,5688,2574,10403,11534,2087,62,24279,659,5529,1170,7358,35,166,201
2018-11-26,14,3656,5685,2530,10506,11717,2161,60,24634,650,5343,1120,7113,33,160,193
2018-11-26,15,3657,5718,2490,10682,11810,2266,59,25007,568,4593,975,6136,34,158,192
2018-11-26,16,3702,5856,2492,11065,11794,2398,60,25506,315,2320,530,3165,39,149,188
2018-11-26,17,3919,6228,2631,11578,12101,2556,64,26490,23,223,64,310,39,105,144
2018-11-26,18,4185,6305,2800,12538,12993,2786,70,28579,0,0,0,0,43,100,143
2018-11-26,19,4220,6182,2805,12829,12898,2749,69,28736,0,0,0,0,51,120,171
2018-11-26,20,4185,6046,2736,12607,12638,2687,71,28194,0,0,0,0,63,103,166
2018-11-26,21,4083,5831,2635,12151,12147,2577,71,27138,0,0,0,0,89,84,173
2018-11-26,22,3924,5515,2471,11449,11542,2413,69,25664,0,0,0,0,149,77,226
2018-11-26,23,3743,5225,2281,10581,10781,2189,65,23807,0,0,0,0,163,71,234
2018-11-26,24,3560,5042,2107,9835,10099,1997,64,22185,0,0,0,0,156,73,229
2018-11-27,1,3414,4896,1970,9606,9437,1882,64,21182,0,0,0,0,170,76,246
2018-11-27,2,3340,4861,1906,9264,9131,1818,65,20472,0,0,0,0,193,70,263
2018-11-27,3,3307,4865,1888,9043,8920,1780,66,20001,0,0,0,0,201,65,266
2018-11-27,4,3308,4960,1903,8979,8847,1769,69,19857,0,0,0,0,216,65,281
2018-11-27,5,3382,5197,1992,9211,9119,1816,74,20415,0,0,0,0,212,66,278
2018-11-27,6,3548,5564,2226,9803,9832,1977,82,21887,0,0,0,0,200,62,262
2018-11-27,7,3715,5838,2558,10791,10732,2196,92,24004,2,124,3,129,205,64,269
2018-11-27,8,3732,5843,2742,11460,10995,2258,89,24994,125,1683,233,2041,190,69,259
2018-11-27,9,3717,5766,2721,11675,11031,2214,81,25195,447,3764,688,4899,171,75,246
2018-11-27,10,3696,5701,2674,11805,11035,2148,74,25254,576,4585,906,6067,170,87,257
2018-11-27,11,3673,5625,2596,11754,11160,2105,68,25280,591,4858,985,6434,164,145,309
2018-11-27,12,3645,5569,2582,11718,11267,2081,64,25321,568,4788,1028,6384,167,283,450
2018-11-27,13,3631,5557,2560,11673,11432,2095,61,25451,571,4741,1039,6351,171,497,668
2018-11-27,14,3639,5558,2535,11778,11661,2167,59,25856,555,4480,986,6021,166,769,935
2018-11-27,15,3666,5591,2507,11828,11801,2261,58,26137,457,3756,842,5055,171,1088,1259
2018-11-27,16,3729,5738,2535,11874,11926,2383,58,26434,233,1809,456,2498,206,1368,1574
2018-11-27,17,3963,6110,2668,12112,12233,2546,62,27147,13,134,55,202,192,1447,1639
2018-11-27,18,4210,6183,2830,12804,13010,2782,68,28856,0,0,0,0,196,1469,1665
2018-11-27,19,4229,6055,2826,12927,12931,2763,67,28882,0,0,0,0,189,1489,1678
2018-11-27,20,4183,5922,2744,12668,12646,2692,67,28265,0,0,0,0,166,1553,1719
2018-11-27,21,4081,5712,2638,12193,12187,2559,65,27197,0,0,0,0,145,1593,1738
2018-11-27,22,3921,5397,2478,11477,11584,2388,63,25705,0,0,0,0,146,1642,1788
2018-11-27,23,3738,5111,2287,10709,10778,2171,60,23910,0,0,0,0,151,1663,1814
2018-11-27,24,3549,4915,2116,9983,10062,1996,57,22291,0,0,0,0,154,1665,1819
2018-11-28,1,3408,4788,1988,9368,9530,1897,56,21043,0,0,0,0,128,1722,1850
2018-11-28,2,3327,4737,1934,9022,9218,1829,57,20318,0,0,0,0,123,1683,1806
2018-11-28,3,3287,4737,1917,8803,8990,1792,59,19836,0,0,0,0,132,1618,1750
2018-11-28,4,3286,4815,1943,8747,8918,1775,61,19694,0,0,0,0,162,1519,1681
2018-11-28,5,3354,5025,2042,8976,9174,1821,66,20230,0,0,0,0,103,1420,1523
2018-11-28,6,3524,5390,2287,9591,9844,1947,74,21648,0,0,0,0,85,1286,1371
2018-11-28,7,3688,5683,2634,10691,10702,2172,83,23840,1,124,3,128,92,1216,1308
2018-11-28,8,3694,5702,2848,11433,11044,2247,81,24997,43,1649,116,1808,111,1249,1360
2018-11-28,9,3678,5661,2801,11655,11196,2238,73,25353,186,3829,334,4349,139,1303,1442
2018-11-28,10,3663,5633,2739,11664,11290,2194,68,25406,257,4632,489,5378,145,1423,1568
2018-11-28,11,3653,5592,2656,11594,11347,2151,65,25346,289,4838,551,5678,143,1449,1592
2018-11-28,12,3637,5560,2613,11523,11374,2117,62,25265,291,4789,503,5583,151,1475,1626
2018-11-28,13,3624,5574,2577,11438,11385,2132,60,25204,283,4790,475,5548,214,1548,1762
2018-11-28,14,3630,5589,2541,11484,11561,2189,59,25483,248,4399,405,5052,204,1591,1795
2018-11-28,15,3663,5635,2519,11453,11592,2274,58,25566,206,3471,336,4013,188,1581,1769
2018-11-28,16,3722,5783,2550,11431,11660,2388,58,25728,119,1643,187,1949,191,1545,1736
2018-11-28,17,3946,6146,2678,11737,11999,2539,61,26527,9,125,21,155,184,1448,1632
2018-11-28,18,4188,6179,2845,12535,12848,2755,66,28394,0,0,0,0,207,1390,1597
2018-11-28,19,4208,6048,2834,12620,12820,2748,65,28445,0,0,0,0,244,1340,1584
2018-11-28,20,4171,5913,2751,12390,12603,2683,64,27932,0,0,0,0,267,1259,1526
2018-11-28,21,4067,5707,2659,11958,12149,2582,62,26943,0,0,0,0,302,1173,1475
2018-11-28,22,3900,5399,2503,11298,11558,2430,60,25538,0,0,0,0,311,1090,1401
2018-11-28,23,3716,5114,2317,10531,10832,2218,56,23829,0,0,0,0,338,1116,1454
2018-11-28,24,3535,4916,2159,9815,10065,2038,53,22164,0,0,0,0,383,1149,1532
2018-11-29,1,3403,4777,2096,9327,9687,1937,50,21193,0,0,0,0,627,1160,1787
2018-11-29,2,3313,4729,2054,8968,9348,1862,50,20421,0,0,0,0,534,1190,1724
2018-11-29,3,3259,4726,2043,8735,9085,1806,51,19869,0,0,0,0,510,1211,1721
2018-11-29,4,3252,4807,2074,8672,9009,1782,52,19707,0,0,0,0,546,1234,1780
2018-11-29,5,3316,5027,2184,8893,9244,1824,55,20208,0,0,0,0,501,1286,1787
2018-11-29,6,3470,5394,2440,9500,9897,1944,61,21595,0,0,0,0,486,1217,1703
2018-11-29,7,3641,5675,2794,10634,10801,2157,67,23851,1,74,2,77,450,1202,1652
2018-11-29,8,3672,5710,2987,11265,11212,2296,69,25035,69,938,98,1105,429,1405,1834
2018-11-29,9,3697,5662,2929,11560,11419,2368,66,25606,264,2270,315,2849,479,1581,2060
2018-11-29,10,3717,5632,2851,11686,11560,2402,64,25902,340,2864,433,3637,494,1807,2301
2018-11-29,11,3739,5586,2762,11658,11610,2411,62,25931,340,3119,471,3930,441,1899,2340
2018-11-29,12,3749,5544,2702,11677,11633,2407,59,25966,368,3146,535,4049,389,2040,2429
2018-11-29,13,3749,5550,2655,11611,11640,2398,57,25895,342,3142,518,4002,384,2096,2480
2018-11-29,14,3772,5563,2609,11696,11651,2404,56,25995,329,2922,439,3690,380,2076,2456
2018-11-29,15,3814,5607,2587,11775,11577,2417,55,26013,314,2416,366,3096,420,1992,2412
2018-11-29,16,3894,5744,2611,11831,11584,2451,55,26112,198,1113,208,1519,465,1864,2329
2018-11-29,17,4121,6102,2738,12138,11830,2586,58,26802,16,77,30,123,529,1761,2290
2018-11-29,18,4344,6124,2908,12806,12750,2839,64,28650,0,0,0,0,582,1738,2320
2018-11-29,19,4338,5995,2905,12967,12732,2846,64,28802,0,0,0,0,627,1773,2400
2018-11-29,20,4281,5865,2825,12723,12584,2773,65,28336,0,0,0,0,579,1887,2466
2018-11-29,21,4164,5660,2739,12250,12196,2632,63,27334,0,0,0,0,512,2048,2560
2018-11-29,22,3995,5363,2576,11628,11670,2456,60,26006,0,0,0,0,462,2262,2724
2018-11-29,23,3798,5090,2392,10748,10966,2233,58,24196,0,0,0,0,465,2358,2823
2018-11-29,24,3610,4903,2238,9982,10238,2044,55,22511,0,0,0,0,471,2407,2878
2018-11-30,1,3482,4815,2101,9488,9691,1858,54,21283,0,0,0,0,659,2619,3278
2018-11-30,2,3397,4767,2052,9164,9356,1785,53,20551,0,0,0,0,636,2573,3209
2018-11-30,3,3351,4765,2035,8967,9146,1739,54,20098,0,0,0,0,586,2572,3158
2018-11-30,4,3356,4842,2062,8933,9091,1729,56,20002,0,0,0,0,554,2650,3204
2018-11-30,5,3424,5046,2161,9203,9367,1786,59,20609,0,0,0,0,507,2720,3227
2018-11-30,6,3582,5385,2392,9803,10065,1925,65,22052,0,0,0,0,458,2744,3202
2018-11-30,7,3776,5664,2724,10957,11052,2155,71,24428,1,89,3,93,426,2797,3223
2018-11-30,8,3805,5706,2925,11585,11440,2246,73,25536,113,1462,151,1726,350,2820,3170
2018-11-30,9,3805,5679,2893,11639,11363,2259,69,25522,422,3594,522,4538,270,2826,3096
2018-11-30,10,3786,5647,2834,11447,11187,2258,65,25147,567,4527,759,5853,215,2852,3067
2018-11-30,11,3762,5599,2744,11167,11048,2240,62,24707,597,4816,902,6315,187,2855,3042
2018-11-30,12,3729,5552,2678,10855,10968,2203,59,24275,607,4714,949,6270,175,2816,2991
2018-11-30,13,3691,5550,2622,10745,10936,2178,58,24107,612,4694,962,6268,187,2765,2952
2018-11-30,14,3668,5553,2571,10813,10963,2196,57,24217,610,4491,877,5978,247,2748,2995
2018-11-30,15,3683,5590,2540,10906,10996,2239,56,24386,545,3769,708,5022,301,2718,3019
2018-11-30,16,3739,5713,2569,11023,11040,2276,56,24585,307,1840,366,2513,372,2691,3063
2018-11-30,17,3994,6056,2703,11308,11416,2358,59,25332,23,162,44,229,436,2651,3087
2018-11-30,18,4253,6057,2852,12198,12358,2631,65,27442,0,0,0,0,475,2609,3084
2018-11-30,19,4251,5902,2819,12337,12282,2632,67,27508,0,0,0,0,538,2593,3131
2018-11-30,20,4212,5754,2726,12089,12122,2569,68,27039,0,0,0,0,495,2612,3107
2018-11-30,21,4124,5573,2628,11715,11751,2449,67,26173,0,0,0,0,507,2604,3111
2018-11-30,22,4008,5348,2497,11201,11238,2330,64,25025,0,0,0,0,509,2601,3110
2018-11-30,23,3837,5122,2352,10540,10417,2157,61,23368,0,0,0,0,454,2584,3038
2018-11-30,24,3672,4943,2215,9944,9670,2001,59,21867,0,0,0,0,393,2565,2958
2018-12-01,1,3558,4854,2126,9889,9736,1932,64,21814,0,0,0,0,450,2585,3035
2018-12-01,2,3466,4797,2072,9464,9339,1849,66,20911,0,0,0,0,420,2569,2989
2018-12-01,3,3413,4783,2051,9203,9061,1796,67,20317,0,0,0,0,399,2501,2900
2018-12-01,4,3400,4816,2064,9112,8981,1760,68,20110,0,0,0,0,400,2455,2855
2018-12-01,5,3431,4913,2124,9175,9065,1778,71,20279,0,0,0,0,419,2431,2850
2018-12-01,6,3511,5087,2242,9507,9427,1831,77,21033,0,0,0,0,419,2376,2795
2018-12-01,7,3592,5260,2416,10084,9722,1940,84,22020,1,74,3,78,422,2354,2776
2018-12-01,8,3596,5374,2608,10480,9754,1974,85,22484,90,1282,150,1522,389,2354,2743
2018-12-01,9,3633,5435,2712,10636,9870,2014,79,22790,337,3184,485,4006,377,2356,2733
2018-12-01,10,3668,5445,2727,10435,9740,1967,74,22405,397,4006,673,5076,355,2364,2719
2018-12-01,11,3663,5413,2684,10173,9694,1938,69,22065,376,4305,712,5393,397,2502,2899
2018-12-01,12,3650,5360,2593,9889,9585,1904,64,21631,372,4194,710,5276,457,2583,3040
2018-12-01,13,3644,5332,2506,9738,9545,1904,62,21439,358,4134,643,5135,526,2644,3170
2018-12-01,14,3660,5320,2439,9669,9511,1932,61,21363,369,3891,536,4796,500,2614,3114
2018-12-01,15,3704,5382,2393,9751,9420,1981,60,21403,341,3243,422,4006,454,2564,3018
2018-12-01,16,3811,5551,2422,10108,9578,2106,62,22043,212,1493,223,1928,429,2483,2912
2018-12-01,17,4095,5938,2579,10805,10135,2294,68,23491,17,122,28,167,406,2455,2861
2018-12-01,18,4379,6050,2725,12024,11437,2554,77,26283,0,0,0,0,390,2425,2815
2018-12-01,19,4355,5974,2703,12173,11670,2623,77,26735,0,0,0,0,383,2374,2757
2018-12-01,20,4272,5882,2648,12001,11513,2573,76,26357,0,0,0,0,360,2464,2824
2018-12-01,21,4194,5740,2580,11796,11325,2493,75,25882,0,0,0,0,339,2511,2850
2018-12-01,22,4065,5499,2477,11470,10976,2378,73,25089,0,0,0,0,315,2621,2936
2018-12-01,23,3904,5228,2338,10837,10406,2205,70,23710,0,0,0,0,278,2710,2988
2018-12-01,24,3748,5015,2216,10132,9838,2030,68,22260,0,0,0,0,251,2749,3000
2018-12-02,1,3603,4879,2171,9538,9400,1941,68,21142,0,0,0,0,256,2757,3013
2018-12-02,2,3519,4823,2127,9155,8997,1854,69,20267,0,0,0,0,200,2743,2943
2018-12-02,3,3466,4811,2117,8962,8857,1798,70,19880,0,0,0,0,143,2721,2864
2018-12-02,4,3449,4834,2134,8868,8737,1772,73,19641,0,0,0,0,107,2702,2809
2018-12-02,5,3474,4916,2200,8941,8758,1767,77,19734,0,0,0,0,91,2592,2683
2018-12-02,6,3540,5047,2316,9260,8955,1813,83,20302,0,0,0,0,82,2442,2524
2018-12-02,7,3590,5205,2482,9680,9134,1898,90,20994,1,72,4,77,79,2245,2324
2018-12-02,8,3583,5306,2679,9897,9167,1923,92,21273,117,1411,143,1671,64,1954,2018
2018-12-02,9,3616,5298,2803,10034,9134,1929,87,21377,467,3627,522,4616,53,1655,1708
2018-12-02,10,3632,5281,2809,9954,9019,1870,80,21116,621,4579,736,5936,52,1290,1342
2018-12-02,11,3618,5229,2739,9674,8851,1799,75,20592,623,4868,861,6352,41,1102,1143
2018-12-02,12,3606,5244,2639,9530,8830,1761,71,20385,635,4879,916,6430,34,918,952
2018-12-02,13,3595,5210,2558,9510,8723,1778,67,20269,621,4924,937,6482,28,790,818
2018-12-02,14,3601,5247,2507,9601,8700,1808,64,20364,628,4663,880,6171,24,878,902
2018-12-02,15,3641,5335,2463,9778,8758,1894,63,20682,546,3882,752,5180,23,1000,1023
2018-12-02,16,3742,5570,2508,10112,8984,2040,64,21392,311,1841,401,2553,17,1112,1129
2018-12-02,17,4036,5951,2677,10847,9893,2254,72,23258,22,139,45,206,13,1115,1128
2018-12-02,18,4338,6070,2866,12085,11569,2570,84,26500,0,0,0,0,18,1078,1096
2018-12-02,19,4347,6003,2866,12290,11905,2665,84,27134,0,0,0,0,16,979,995
2018-12-02,20,4296,5917,2838,12151,11721,2626,85,26773,0,0,0,0,16,691,707
2018-12-02,21,4223,5750,2759,11924,11419,2537,83,26154,0,0,0,0,20,468,488
2018-12-02,22,4085,5473,2622,11416,10964,2399,81,25052,0,0,0,0,21,334,355
2018-12-02,23,3893,5187,2443,10718,10364,2203,77,23556,0,0,0,0,26,214,240
2018-12-02,24,3724,5005,2297,10043,9723,2014,75,22048,0,0,0,0,28,157,185
2018-12-03,1,3606,4897,2243,9611,9329,1921,74,21113,0,0,0,0,36,199,235
2018-12-03,2,3540,4876,2220,9334,9123,1866,75,20576,0,0,0,0,48,164,212
2018-12-03,3,3519,4897,2226,9193,9000,1836,77,20287,0,0,0,0,55,132,187
2018-12-03,4,3537,5006,2279,9249,9012,1831,80,20344,0,0,0,0,61,112,173
2018-12-03,5,3625,5249,2420,9586,9400,1891,87,21137,0,0,0,0,81,79,160
2018-12-03,6,3827,5652,2713,10360,10218,2064,96,22906,0,0,0,0,83,74,157
2018-12-03,7,4047,5999,3122,11616,11267,2331,106,25481,1,80,2,83,104,77,181
2018-12-03,8,4056,6036,3369,12326,11626,2418,107,26658,114,1448,185,1747,97,86,183
2018-12-03,9,4013,5991,3322,12253,11425,2331,97,26287,467,3766,686,4919,87,87,174
2018-12-03,10,3957,5941,3216,11946,11124,2201,88,25539,640,4722,974,6336,76,110,186
2018-12-03,11,3905,5876,3120,11531,10853,2073,82,24718,676,4999,1092,6767,84,123,207
2018-12-03,12,3858,5821,2997,11214,10663,2002,76,24134,672,5039,1085,6796,78,133,211
2018-12-03,13,3818,5813,2914,10987,10603,1999,72,23840,680,5148,1104,6932,80,144,224
2018-12-03,14,3807,5808,2852,10962,10619,2042,68,23872,679,4901,985,6565,87,137,224
2018-12-03,15,3814,5861,2797,11051,10768,2137,65,24203,585,4199,783,5567,83,131,214
2018-12-03,16,3884,6043,2830,11323,10956,2271,66,24796,308,1947,383,2638,78,130,208
2018-12-03,17,4208,6423,2993,12127,11671,2471,72,26520,18,126,39,183,75,123,198
2018-12-03,18,4542,6522,3175,13316,13123,2830,85,29534,0,0,0,0,79,127,206
2018-12-03,19,4569,6423,3196,13671,13343,2917,87,30194,0,0,0,0,71,136,207
2018-12-03,20,4522,6310,3147,13491,13162,2865,87,29780,0,0,0,0,77,151,228
2018-12-03,21,4427,6094,3049,13106,12814,2739,85,28921,0,0,0,0,82,185,267
2018-12-03,22,4244,5740,2875,12392,12164,2563,83,27377,0,0,0,0,90,209,299
2018-12-03,23,4001,5406,2652,11375,11280,2309,80,25220,0,0,0,0,114,192,306
2018-12-03,24,3801,5195,2473,10528,10430,2094,78,23306,0,0,0,0,134,214,348
2018-12-04,1,3692,5156,2402,9860,9647,2000,76,21744,0,0,0,0,186,193,379
2018-12-04,2,3620,5121,2369,9491,9324,1932,77,20985,0,0,0,0,184,202,386
2018-12-04,3,3587,5131,2365,9284,9144,1897,79,20564,0,0,0,0,192,210,402
2018-12-04,4,3599,5222,2402,9275,9127,1887,82,20531,0,0,0,0,205,200,405
2018-12-04,5,3682,5454,2529,9585,9449,1950,88,21231,0,0,0,0,186,252,438
2018-12-04,6,3852,5851,2816,10324,10190,2120,97,22890,0,0,0,0,149,285,434
2018-12-04,7,4055,6172,3218,11590,11251,2391,106,25494,0,53,2,55,140,295,435
2018-12-04,8,4050,6191,3437,12320,11540,2463,107,26590,45,1093,113,1251,83,319,402
2018-12-04,9,4001,6126,3361,12139,11431,2356,96,26182,190,2987,391,3568,85,343,428
2018-12-04,10,3941,6054,3239,11893,11286,2227,86,25650,280,3910,566,4756,79,384,463
2018-12-04,11,3892,5963,3123,11536,11048,2159,78,24980,305,4248,639,5192,75,404,479
2018-12-04,12,3847,5885,3007,11207,10932,2116,71,24485,262,4277,611,5150,75,411,486
2018-12-04,13,3814,5871,2927,11060,10908,2135,65,24327,230,4222,576,5028,86,395,481
2018-12-04,14,3813,5861,2871,11056,11019,2190,62,24487,206,4004,499,4709,90,382,472
2018-12-04,15,3829,5915,2824,11069,11173,2266,61,24728,156,3275,391,3822,91,388,479
2018-12-04,16,3928,6112,2860,11253,11321,2423,61,25216,71,1481,195,1747,132,360,492
2018-12-04,17,4252,6491,3035,11999,11786,2619,67,26629,5,102,23,130,124,336,460
2018-12-04,18,4560,6596,3207,13321,12937,2895,78,29388,0,0,0,0,190,332,522
2018-12-04,19,4581,6498,3226,13508,13122,2916,79,29783,0,0,0,0,221,349,570
2018-12-04,20,4533,6400,3177,13314,12961,2854,81,29368,0,0,0,0,235,354,589
2018-12-04,21,4441,6184,3087,12907,12648,2745,81,28538,0,0,0,0,249,358,607
2018-12-04,22,4255,5832,2920,12193,12005,2565,78,26999,0,0,0,0,250,385,635
2018-12-04,23,4013,5498,2706,11230,11104,2306,75,24873,0,0,0,0,248,336,584
2018-12-04,24,3807,5291,2527,10398,10294,2093,73,23016,0,0,0,0,224,327,551
2018-12-05,1,3674,5159,2443,9799,9534,1979,77,21553,0,0,0,0,219,290,509
2018-12-05,2,3592,5126,2401,9418,9154,1908,78,20723,0,0,0,0,217,300,517
2018-12-05,3,3554,5143,2395,9193,8931,1861,80,20230,0,0,0,0,236,306,542
2018-12-05,4,3560,5221,2432,9165,8852,1851,82,20115,0,0,0,0,257,301,558
2018-12-05,5,3637,5445,2555,9433,9112,1922,88,20719,0,0,0,0,243,301,544
2018-12-05,6,3814,5834,2837,10140,9836,2086,96,22318,0,0,0,0,224,284,508
2018-12-05,7,4014,6153,3224,11374,10886,2348,104,24875,0,44,1,45,244,276,520
2018-12-05,8,4008,6152,3448,12198,11500,2478,107,26443,42,901,76,1019,217,262,479
2018-12-05,9,3961,6075,3375,12139,11780,2483,97,26662,209,2302,262,2773,193,261,454
2018-12-05,10,3911,5987,3258,11944,11860,2447,89,26506,308,3016,394,3718,144,298,442
2018-12-05,11,3874,5893,3156,11696,11704,2393,83,26044,334,3279,472,4085,129,266,395
2018-12-05,12,3830,5808,3039,11396,11638,2325,79,25605,339,3096,498,3933,114,255,369
2018-12-05,13,3804,5789,2961,11366,11503,2287,74,25398,334,2956,472,3762,106,269,375
2018-12-05,14,3806,5782,2904,11431,11463,2277,70,25408,331,2761,410,3502,135,253,388
2018-12-05,15,3831,5832,2879,11650,11319,2312,68,25515,287,2234,336,2857,161,248,409
2018-12-05,16,3934,6025,2901,11805,11310,2415,65,25762,135,915,168,1218,191,266,457
2018-12-05,17,4264,6404,3080,12268,11748,2607,75,26864,12,61,21,94,235,260,495
2018-12-05,18,4554,6500,3264,13439,12743,2901,86,29333,0,0,0,0,285,252,537
2018-12-05,19,4572,6396,3277,13545,12754,2914,85,29463,0,0,0,0,323,273,596
2018-12-05,20,4522,6301,3216,13328,12551,2859,85,28987,0,0,0,0,281,246,527
2018-12-05,21,4428,6099,3122,12921,12232,2727,84,28129,0,0,0,0,257,238,495
2018-12-05,22,4244,5757,2963,12233,11576,2554,81,26610,0,0,0,0,244,233,477
2018-12-05,23,4007,5423,2748,11309,10778,2306,77,24635,0,0,0,0,240,219,459
2018-12-05,24,3802,5206,2569,10402,9945,2099,75,22685,0,0,0,0,222,237,459
2018-12-06,1,3708,5114,2493,9588,9489,1946,82,21265,0,0,0,0,104,188,292
2018-12-06,2,3627,5078,2458,9239,9073,1871,83,20427,0,0,0,0,100,206,306
2018-12-06,3,3584,5085,2458,9037,8808,1820,85,19911,0,0,0,0,91,212,303
2018-12-06,4,3587,5176,2504,9017,8740,1803,87,19807,0,0,0,0,94,225,319
2018-12-06,5,3658,5402,2635,9295,8970,1865,92,20382,0,0,0,0,104,241,345
2018-12-06,6,3830,5789,2921,9985,9679,2019,99,21943,0,0,0,0,112,246,358
2018-12-06,7,4032,6108,3312,11224,10890,2313,105,24693,0,38,1,39,127,255,382
2018-12-06,8,4033,6116,3529,11950,11585,2484,106,26288,77,613,92,782,113,279,392
2018-12-06,9,4001,6050,3453,11764,11863,2540,101,26429,311,1647,319,2277,104,315,419
2018-12-06,10,3960,5975,3334,11481,11811,2518,94,26071,441,2273,511,3225,105,369,474
2018-12-06,11,3929,5892,3219,11107,11667,2445,88,25477,495,2455,623,3573,96,406,502
2018-12-06,12,3895,5812,3082,10827,11541,2377,83,24996,534,2368,708,3610,86,424,510
2018-12-06,13,3876,5797,2993,10764,11464,2370,79,24838,542,2314,694,3550,81,441,522
2018-12-06,14,3887,5792,2932,10841,11369,2394,74,24839,559,2114,636,3309,67,396,463
2018-12-06,15,3917,5848,2883,10982,11366,2391,77,24976,516,1800,549,2865,55,368,423
2018-12-06,16,4025,6038,2896,11284,11637,2378,80,25539,300,792,288,1380,44,351,395
2018-12-06,17,4345,6415,3075,11946,12279,2541,86,27013,22,60,40,122,28,285,313
2018-12-06,18,4622,6489,3254,12981,13034,2859,93,29131,0,0,0,0,20,234,254
2018-12-06,19,4629,6386,3277,13053,13105,2896,90,29308,0,0,0,0,20,212,232
2018-12-06,20,4571,6290,3233,12841,12942,2844,89,28878,0,0,0,0,23,194,217
2018-12-06,21,4473,6080,3153,12539,12643,2719,89,28153,0,0,0,0,33,167,200
2018-12-06,22,4292,5747,2989,11974,11968,2544,86,26735,0,0,0,0,53,165,218
2018-12-06,23,4055,5420,2786,11125,10978,2295,82,24645,0,0,0,0,44,152,196
2018-12-06,24,3848,5206,2606,10316,10100,2079,78,22733,0,0,0,0,40,156,196
2018-12-07,1,3727,5159,2501,9588,9446,1940,72,21210,0,0,0,0,43,115,158
2018-12-07,2,3645,5114,2464,9224,9023,1872,73,20354,0,0,0,0,34,115,149
2018-12-07,3,3599,5116,2457,9024,8834,1830,75,19926,0,0,0,0,22,111,133
2018-12-07,4,3598,5198,2498,9011,8746,1821,78,19818,0,0,0,0,23,119,142
2018-12-07,5,3669,5405,2624,9298,9100,1864,82,20507,0,0,0,0,32,114,146
2018-12-07,6,3834,5769,2889,10003,9713,2011,88,21977,0,0,0,0,44,113,157
2018-12-07,7,4035,6090,3261,11173,10747,2235,95,24411,0,52,2,54,69,111,180
2018-12-07,8,4032,6116,3492,11846,11054,2310,94,25467,128,1008,172,1308,60,108,168
2018-12-07,9,4003,6068,3424,11509,11065,2271,88,25097,509,2999,648,4156,50,107,157
2018-12-07,10,3961,6004,3312,11029,10924,2218,81,24416,684,4060,927,5671,32,119,151
2018-12-07,11,3915,5927,3200,10539,10654,2183,74,23612,711,4400,1009,6120,29,108,137
2018-12-07,12,3861,5847,3066,10189,10440,2155,69,23015,690,4482,1032,6204,23,94,117
2018-12-07,13,3820,5824,2969,9991,10451,2160,64,22828,678,4585,1045,6308,22,100,122
2018-12-07,14,3807,5814,2900,9994,10470,2208,61,22896,690,4502,991,6183,22,139,161
2018-12-07,15,3816,5859,2847,10066,10581,2268,59,23137,631,4127,862,5620,23,185,208
2018-12-07,16,3899,6027,2858,10423,10796,2383,60,23825,380,2071,489,2940,21,243,264
2018-12-07,17,4208,6387,3027,11225,11502,2561,65,25516,29,176,62,267,19,249,268
2018-12-07,18,4483,6444,3181,12494,12548,2797,73,28073,0,0,0,0,23,237,260
2018-12-07,19,4492,6312,3162,12647,12693,2770,75,28347,0,0,0,0,27,240,267
2018-12-07,20,4444,6184,3097,12469,12522,2696,77,27927,0,0,0,0,29,230,259
2018-12-07,21,4360,5994,3013,12154,12308,2604,77,27308,0,0,0,0,34,224,258
2018-12-07,22,4220,5734,2877,11673,11698,2461,75,26071,0,0,0,0,30,207,237
2018-12-07,23,4030,5450,2701,10982,10898,2266,72,24384,0,0,0,0,38,203,241
2018-12-07,24,3848,5229,2527,10245,10099,2074,70,22655,0,0,0,0,45,209,254
2018-12-08,1,3717,5042,2342,9570,9366,1961,67,21128,0,0,0,0,33,254,287
2018-12-08,2,3619,4976,2284,9211,9013,1878,68,20333,0,0,0,0,31,250,281
2018-12-08,3,3564,4961,2263,8961,8764,1826,70,19785,0,0,0,0,35,224,259
2018-12-08,4,3541,4999,2277,8865,8673,1803,72,19575,0,0,0,0,33,199,232
2018-12-08,5,3566,5094,2337,8936,8736,1815,76,19726,0,0,0,0,55,158,213
2018-12-08,6,3650,5249,2458,9245,9021,1871,81,20383,0,0,0,0,57,112,169
2018-12-08,7,3737,5430,2626,9701,9412,1955,87,21317,0,82,1,83,67,81,148
2018-12-08,8,3724,5543,2807,9993,9364,1989,88,21598,110,1617,172,1899,70,64,134
2018-12-08,9,3756,5625,2925,10258,9500,1984,82,21988,453,4082,624,5159,78,69,147
2018-12-08,10,3775,5630,2936,10221,9552,1915,75,21926,626,5069,916,6611,77,85,162
2018-12-08,11,3753,5584,2875,10061,9518,1834,69,21644,666,5215,1027,6908,54,100,154
2018-12-08,12,3714,5521,2765,9705,9526,1788,62,21246,670,5168,1072,6910,35,115,150
2018-12-08,13,3680,5478,2660,9550,9506,1822,59,21101,675,5162,1095,6932,29,107,136
2018-12-08,14,3662,5459,2576,9360,9481,1876,58,20939,673,4988,1015,6676,33,96,129
2018-12-08,15,3674,5512,2529,9543,9403,1962,57,21129,599,4243,847,5689,36,93,129
2018-12-08,16,3755,5706,2551,9972,9635,2161,58,21989,349,2081,461,2891,33,86,119
2018-12-08,17,4042,6098,2723,10677,10272,2401,64,23576,25,155,57,237,42,69,111
2018-12-08,18,4332,6188,2872,11795,11451,2652,69,26131,0,0,0,0,49,73,122
2018-12-08,19,4334,6108,2859,11987,11542,2671,71,26434,0,0,0,0,52,87,139
2018-12-08,20,4274,6024,2803,11814,11423,2611,73,26084,0,0,0,0,52,91,143
2018-12-08,21,4206,5875,2734,11560,11230,2529,73,25557,0,0,0,0,48,99,147
2018-12-08,22,4099,5633,2631,11187,10801,2416,71,24640,0,0,0,0,49,110,159
2018-12-08,23,3959,5350,2484,10556,10138,2245,68,23171,0,0,0,0,57,105,162
2018-12-08,24,3798,5128,2342,9907,9390,2065,67,21594,0,0,0,0,71,106,177
2018-12-09,1,3644,4942,2280,9376,9093,1918,66,20615,0,0,0,0,46,76,122
2018-12-09,2,3553,4888,2225,8980,8693,1835,67,19738,0,0,0,0,48,85,133
2018-12-09,3,3497,4872,2212,8773,8428,1781,69,19212,0,0,0,0,51,92,143
2018-12-09,4,3479,4895,2225,8696,8291,1759,71,18978,0,0,0,0,50,94,144
2018-12-09,5,3505,4969,2283,8747,8295,1765,75,19043,0,0,0,0,42,93,135
2018-12-09,6,3569,5101,2385,8960,8487,1814,81,19502,0,0,0,0,44,96,140
2018-12-09,7,3623,5271,2532,9360,8772,1885,86,20264,0,56,1,57,48,104,152
2018-12-09,8,3603,5371,2733,9640,8745,1906,88,20542,74,1131,108,1313,52,108,160
2018-12-09,9,3631,5372,2863,9846,8813,1895,82,20801,311,2943,418,3672,44,114,158
2018-12-09,10,3641,5356,2890,9844,8699,1831,75,20614,430,3796,659,4885,53,131,184
2018-12-09,11,3609,5300,2837,9633,8578,1767,69,20213,479,4030,795,5304,42,132,174
2018-12-09,12,3583,5312,2757,9399,8469,1719,64,19813,522,4097,883,5502,46,145,191
2018-12-09,13,3569,5270,2688,9361,8508,1716,60,19808,527,3972,881,5380,47,132,179
2018-12-09,14,3569,5303,2623,9346,8627,1768,58,19962,534,3657,798,4989,51,119,170
2018-12-09,15,3600,5385,2589,9495,8844,1901,58,20461,476,2954,670,4100,53,108,161
2018-12-09,16,3697,5618,2624,9836,9175,2064,59,21296,286,1349,364,1999,51,92,143
2018-12-09,17,3999,6031,2791,10518,9872,2293,65,22910,23,70,47,140,43,82,125
2018-12-09,18,4279,6119,2955,11804,11261,2610,72,25909,0,0,0,0,41,82,123
2018-12-09,19,4291,6045,2939,12014,11497,2660,72,26405,0,0,0,0,39,93,132
2018-12-09,20,4241,5969,2897,11890,11411,2629,74,26168,0,0,0,0,36,87,123
2018-12-09,21,4170,5806,2820,11609,11197,2532,73,25574,0,0,0,0,38,80,118
2018-12-09,22,4034,5539,2682,11075,10742,2375,72,24425,0,0,0,0,38,79,117
2018-12-09,23,3859,5250,2499,10345,10151,2166,68,22892,0,0,0,0,37,65,102
2018-12-09,24,3685,5065,2339,9621,9438,1976,66,21263,0,0,0,0,41,67,108
2018-12-10,1,3565,4904,2209,9159,8840,1891,65,20110,0,0,0,0,62,75,137
2018-12-10,2,3487,4884,2170,8836,8543,1833,65,19433,0,0,0,0,67,70,137
2018-12-10,3,3458,4910,2170,8678,8388,1798,67,19087,0,0,0,0,84,64,148
2018-12-10,4,3471,5015,2213,8704,8365,1785,69,19080,0,0,0,0,97,58,155
2018-12-10,5,3543,5259,2340,8997,8712,1839,75,19779,0,0,0,0,94,52,146
2018-12-10,6,3722,5669,2606,9717,9492,2000,82,21447,0,0,0,0,93,47,140
2018-12-10,7,3937,6011,2976,10956,10557,2232,91,23992,0,39,1,40,102,57,159
2018-12-10,8,3951,6038,3209,11777,10997,2337,93,25361,87,911,141,1139,89,55,144
2018-12-10,9,3927,5993,3173,11784,11089,2309,86,25430,360,2561,489,3410,73,64,137
2018-12-10,10,3891,5940,3112,11483,11095,2248,80,25067,513,3396,724,4633,76,81,157
2018-12-10,11,3857,5861,3038,11129,10989,2183,74,24533,533,3605,835,4973,77,89,166
2018-12-10,12,3826,5789,2948,10775,10903,2143,70,24049,518,3618,885,5021,86,119,205
2018-12-10,13,3800,5762,2888,10638,11032,2154,67,24050,501,3554,901,4956,97,170,267
2018-12-10,14,3800,5745,2838,10671,11233,2207,64,24336,471,3381,849,4701,92,220,312
2018-12-10,15,3815,5780,2803,10698,11318,2247,62,24484,379,2852,714,3945,96,290,386
2018-12-10,16,3896,5957,2823,10918,11340,2354,62,24833,213,1317,400,1930,101,408,509
2018-12-10,17,4200,6346,2987,11569,11924,2572,67,26293,22,94,56,172,95,528,623
2018-12-10,18,4490,6422,3155,12865,12879,2839,74,28817,0,0,0,0,108,743,851
2018-12-10,19,4516,6319,3167,13149,12905,2876,74,29168,0,0,0,0,143,989,1132
2018-12-10,20,4469,6227,3109,12985,12706,2820,75,28749,0,0,0,0,185,1092,1277
2018-12-10,21,4364,6015,3009,12596,12324,2687,74,27844,0,0,0,0,226,1215,1441
2018-12-10,22,4178,5667,2842,11909,11708,2504,72,26353,0,0,0,0,286,1363,1649
2018-12-10,23,3953,5327,2629,10975,10785,2248,69,24239,0,0,0,0,325,1510,1835
2018-12-10,24,3745,5107,2437,10171,9981,2046,67,22426,0,0,0,0,378,1597,1975
2018-12-11,1,3601,5016,2267,9633,9383,1957,65,21193,0,0,0,0,276,1047,1323
2018-12-11,2,3520,4971,2219,9253,9000,1877,66,20352,0,0,0,0,271,995,1266
2018-12-11,3,3481,4973,2207,9043,8799,1827,68,19892,0,0,0,0,266,925,1191
2018-12-11,4,3485,5061,2235,9020,8768,1809,70,19824,0,0,0,0,259,824,1083
2018-12-11,5,3554,5283,2344,9299,9073,1863,75,20466,0,0,0,0,216,631,847
2018-12-11,6,3727,5675,2602,10006,9861,2013,84,22120,0,0,0,0,180,474,654
2018-12-11,7,3941,6015,2968,11217,10998,2278,91,24741,0,45,0,45,144,349,493
2018-12-11,8,3937,6027,3185,11907,11322,2386,94,25864,100,1193,140,1433,116,260,376
2018-12-11,9,3906,5972,3139,11675,11175,2359,85,25451,456,3474,584,4514,91,221,312
2018-12-11,10,3859,5913,3064,11313,10989,2231,78,24767,652,4542,905,6099,87,216,303
2018-12-11,11,3820,5840,2976,10956,10804,2155,72,24144,679,4796,1040,6515,66,241,307
2018-12-11,12,3784,5773,2894,10653,10658,2106,67,23641,715,4935,1097,6747,65,274,339
2018-12-11,13,3752,5760,2831,10524,10650,2102,64,23497,727,4973,1126,6826,66,260,326
2018-12-11,14,3742,5749,2781,10609,10769,2160,62,23756,721,4845,1069,6635,47,243,290
2018-12-11,15,3742,5795,2741,10794,10884,2257,60,24151,691,4202,934,5827,45,244,289
2018-12-11,16,3819,5978,2741,11176,11019,2397,61,24808,414,2084,518,3016,64,269,333
2018-12-11,17,4122,6369,2903,11850,11708,2603,66,26381,41,157,67,265,103,348,451
2018-12-11,18,4389,6429,3050,13020,13114,2867,72,29228,0,0,0,0,155,446,601
2018-12-11,19,4422,6326,3034,13225,13041,2883,73,29378,0,0,0,0,209,541,750
2018-12-11,20,4382,6240,2962,13064,12877,2830,75,29001,0,0,0,0,214,540,754
2018-12-11,21,4290,6024,2868,12736,12443,2719,75,28128,0,0,0,0,205,534,739
2018-12-11,22,4113,5675,2723,12182,11883,2541,73,26834,0,0,0,0,215,542,757
2018-12-11,23,3892,5337,2523,11236,10895,2292,69,24648,0,0,0,0,205,498,703
2018-12-11,24,3686,5114,2341,10344,10066,2068,67,22701,0,0,0,0,203,468,671
2018-12-12,1,3531,5023,2176,9601,9529,1947,67,21300,0,0,0,0,266,923,1189
2018-12-12,2,3448,4977,2117,9234,9162,1879,68,20499,0,0,0,0,222,1164,1386
2018-12-12,3,3401,4976,2093,9016,8961,1836,70,20039,0,0,0,0,184,1355,1539
2018-12-12,4,3405,5051,2115,9006,8922,1831,72,19989,0,0,0,0,159,1500,1659
2018-12-12,5,3472,5269,2217,9284,9219,1882,78,20620,0,0,0,0,110,1565,1675
2018-12-12,6,3654,5645,2463,10003,9998,2045,86,22289,0,0,0,0,104,1562,1666
2018-12-12,7,3864,5984,2821,11244,11072,2312,94,24879,0,70,1,71,150,1544,1694
2018-12-12,8,3877,6011,3044,12004,11431,2394,96,26082,73,1445,148,1666,173,1535,1708
2018-12-12,9,3860,5970,3002,11976,11284,2321,88,25827,360,3762,614,4736,201,1514,1715
2018-12-12,10,3827,5920,2946,11820,11100,2217,80,25375,542,4806,931,6279,269,1406,1675
2018-12-12,11,3799,5857,2880,11537,10958,2159,74,24885,583,5001,1043,6627,341,1011,1352
2018-12-12,12,3759,5804,2810,11278,10771,2121,68,24393,587,5075,1095,6757,480,553,1033
2018-12-12,13,3733,5799,2764,11030,10679,2146,64,24075,599,5118,1110,6827,583,362,945
2018-12-12,14,3728,5798,2733,10883,10767,2194,62,24065,594,4969,1052,6615,537,233,770
2018-12-12,15,3741,5856,2708,10925,10952,2269,61,24366,534,4257,931,5722,493,165,658
2018-12-12,16,3829,6046,2737,11195,11254,2380,61,25047,327,2064,516,2907,460,175,635
2018-12-12,17,4129,6430,2889,11931,11859,2578,66,26591,26,170,68,264,350,187,537
2018-12-12,18,4383,6470,3050,13144,13122,2859,72,29352,0,0,0,0,244,216,460
2018-12-12,19,4405,6362,3049,13398,13229,2881,73,29737,0,0,0,0,183,317,500
2018-12-12,20,4369,6272,2985,13248,13016,2831,76,29327,0,0,0,0,133,328,461
2018-12-12,21,4280,6068,2892,12878,12810,2725,75,28645,0,0,0,0,100,361,461
2018-12-12,22,4110,5730,2735,12244,12074,2545,73,27092,0,0,0,0,75,421,496
2018-12-12,23,3898,5392,2524,11237,11073,2295,69,24831,0,0,0,0,52,394,446
2018-12-12,24,3694,5176,2331,10335,10156,2080,68,22796,0,0,0,0,41,361,402
2018-12-13,1,3594,5093,2202,9740,9627,1969,71,21563,0,0,0,0,26,292,318
2018-12-13,2,3518,5048,2152,9381,9342,1901,72,20852,0,0,0,0,19,298,317
2018-12-13,3,3474,5054,2138,9181,9133,1863,74,20407,0,0,0,0,37,309,346
2018-12-13,4,3476,5139,2167,9184,9095,1852,76,20364,0,0,0,0,40,294,334
2018-12-13,5,3549,5368,2280,9499,9397,1904,83,21040,0,0,0,0,40,274,314
2018-12-13,6,3733,5757,2540,10209,10079,2075,92,22612,0,0,0,0,33,262,295
2018-12-13,7,3952,6083,2907,11478,11224,2338,101,25299,0,75,0,75,38,259,297
2018-12-13,8,3954,6106,3108,12072,11384,2406,102,26122,68,1598,184,1850,53,262,315
2018-12-13,9,3937,6049,3043,11875,11184,2310,93,25619,387,4060,745,5192,57,271,328
2018-12-13,10,3900,5997,2969,11584,10957,2176,84,24959,590,5142,1068,6800,65,289,354
2018-12-13,11,3859,5928,2879,11204,10772,2098,78,24308,621,5243,1169,7033,62,307,369
2018-12-13,12,3809,5853,2781,10882,10663,2073,72,23846,690,5245,1258,7193,63,317,380
2018-12-13,13,3776,5832,2709,10645,10651,2099,67,23619,711,5300,1272,7283,66,309,375
2018-12-13,14,3765,5822,2649,10541,10830,2170,65,23763,673,5189,1199,7061,62,302,364
2018-12-13,15,3767,5864,2612,10622,10988,2280,63,24109,621,4507,1085,6213,60,296,356
2018-12-13,16,3834,6048,2633,10968,11234,2407,64,24831,395,2207,585,3187,59,273,332
2018-12-13,17,4148,6429,2787,11732,11877,2607,69,26444,35,179,73,287,49,277,326
2018-12-13,18,4411,6480,2942,12968,13043,2876,77,29124,0,0,0,0,51,282,333
2018-12-13,19,4429,6381,2954,13249,13082,2896,80,29466,0,0,0,0,51,309,360
2018-12-13,20,4389,6300,2914,13117,12904,2824,82,29086,0,0,0,0,44,274,318
2018-12-13,21,4308,6093,2841,12761,12614,2712,81,28327,0,0,0,0,52,272,324
2018-12-13,22,4146,5769,2694,12100,11987,2553,79,26874,0,0,0,0,63,259,322
2018-12-13,23,3931,5441,2498,11173,11033,2314,76,24751,0,0,0,0,66,225,291
2018-12-13,24,3733,5227,2314,10291,10167,2101,73,22789,0,0,0,0,70,218,288
2018-12-14,1,3579,5116,2173,9668,9649,1969,70,21516,0,0,0,0,88,172,260
2018-12-14,2,3511,5072,2116,9290,9251,1898,72,20669,0,0,0,0,87,167,254
2018-12-14,3,3469,5074,2089,9070,9019,1858,74,20179,0,0,0,0,97,165,262
2018-12-14,4,3482,5161,2107,9039,8963,1843,77,20080,0,0,0,0,114,161,275
2018-12-14,5,3563,5372,2197,9300,9282,1894,82,20718,0,0,0,0,99,160,259
2018-12-14,6,3738,5731,2421,9936,9906,2049,91,22140,0,0,0,0,108,163,271
2018-12-14,7,3954,6058,2753,11160,10916,2327,99,24660,0,31,0,31,127,162,289
2018-12-14,8,3953,6087,2959,12037,11360,2399,101,26055,27,849,67,943,119,158,277
2018-12-14,9,3924,6035,2942,12047,11299,2313,90,25907,152,2298,298,2748,117,140,257
2018-12-14,10,3876,5968,2899,11933,11305,2202,80,25678,224,3066,481,3771,121,135,256
2018-12-14,11,3821,5882,2836,11604,11132,2125,73,25093,240,3327,556,4123,121,110,231
2018-12-14,12,3753,5792,2762,11348,10994,2089,67,24657,264,3257,604,4125,141,95,236
2018-12-14,13,3717,5751,2707,11127,11012,2107,62,24466,274,3118,589,3981,166,83,249
2018-12-14,14,3707,5733,2669,11067,11107,2181,59,24572,251,2881,521,3653,167,77,244
2018-12-14,15,3718,5764,2632,11069,11120,2284,57,24689,218,2348,449,3015,160,78,238
2018-12-14,16,3799,5926,2656,11244,11331,2392,58,25182,118,997,211,1326,152,78,230
2018-12-14,17,4110,6298,2811,11874,11915,2592,64,26603,13,63,24,100,135,61,196
2018-12-14,18,4357,6341,2938,12834,12802,2862,74,28731,0,0,0,0,123,68,191
2018-12-14,19,4356,6209,2901,12853,12881,2857,74,28823,0,0,0,0,110,55,165
2018-12-14,20,4308,6091,2813,12582,12575,2770,74,28161,0,0,0,0,98,57,155
2018-12-14,21,4230,5908,2724,12175,12322,2671,74,27400,0,0,0,0,111,53,164
2018-12-14,22,4109,5656,2604,11638,11785,2529,73,26182,0,0,0,0,101,60,161
2018-12-14,23,3944,5372,2447,10980,11041,2314,70,24563,0,0,0,0,86,70,156
2018-12-14,24,3767,5151,2292,10221,10262,2117,69,22828,0,0,0,0,80,95,175
2018-12-15,1,3651,4986,2180,9407,9422,1973,69,21028,0,0,0,0,64,102,166
2018-12-15,2,3560,4916,2117,9019,8976,1893,70,20115,0,0,0,0,68,76,144
2018-12-15,3,3509,4902,2092,8772,8714,1843,73,19558,0,0,0,0,54,97,151
2018-12-15,4,3494,4935,2101,8670,8622,1807,74,19329,0,0,0,0,52,112,164
2018-12-15,5,3525,5024,2153,8726,8717,1816,78,19491,0,0,0,0,49,77,126
2018-12-15,6,3594,5178,2254,8964,9034,1884,84,20124,0,0,0,0,47,65,112
2018-12-15,7,3680,5369,2407,9467,9490,1990,90,21195,0,34,0,34,49,70,119
2018-12-15,8,3648,5488,2614,10122,9492,2025,92,21888,60,1079,135,1274,47,66,113
2018-12-15,9,3660,5566,2733,10428,9503,1997,85,22171,327,3350,572,4249,50,47,97
2018-12-15,10,3668,5570,2770,10481,9479,1926,77,22121,487,4423,884,5794,51,53,104
2018-12-15,11,3636,5524,2743,10316,9307,1853,68,21705,547,4716,1019,6282,53,53,106
2018-12-15,12,3589,5454,2670,9968,9195,1820,61,21205,574,4925,1079,6578,54,58,112
2018-12-15,13,3548,5403,2593,9829,9182,1841,58,21070,597,4987,1095,6679,56,67,123
2018-12-15,14,3535,5378,2521,9757,9273,1912,56,21157,601,4848,1046,6495,59,67,126
2018-12-15,15,3557,5415,2470,9870,9523,2014,55,21619,545,4147,901,5593,58,58,116
2018-12-15,16,3641,5618,2484,10143,9824,2159,56,22339,332,2070,483,2885,67,50,117
2018-12-15,17,3939,6035,2645,10718,10378,2393,62,23708,24,194,61,279,64,40,104
2018-12-15,18,4218,6104,2781,11743,11444,2657,67,26068,0,0,0,0,61,39,100
2018-12-15,19,4217,6020,2743,11910,11550,2675,68,26360,0,0,0,0,78,42,120
2018-12-15,20,4167,5951,2680,11720,11378,2610,72,25936,0,0,0,0,80,50,130
2018-12-15,21,4104,5809,2599,11469,11133,2524,72,25355,0,0,0,0,85,53,138
2018-12-15,22,4008,5576,2500,11107,10746,2413,71,24494,0,0,0,0,95,64,159
2018-12-15,23,3876,5297,2355,10582,10217,2245,69,23271,0,0,0,0,106,76,182
2018-12-15,24,3715,5073,2200,9920,9633,2072,68,21851,0,0,0,0,123,77,200
2018-12-16,1,3624,4921,2034,9240,9155,1940,65,20558,0,0,0,0,116,67,183
2018-12-16,2,3538,4865,1967,8855,8800,1850,66,19728,0,0,0,0,125,64,189
2018-12-16,3,3484,4854,1940,8562,8563,1801,68,19152,0,0,0,0,145,61,206
2018-12-16,4,3458,4880,1941,8462,8445,1781,70,18917,0,0,0,0,160,54,214
2018-12-16,5,3481,4952,1978,8502,8500,1779,74,19014,0,0,0,0,173,40,213
2018-12-16,6,3543,5082,2054,8694,8637,1825,81,19395,0,0,0,0,189,31,220
2018-12-16,7,3603,5261,2167,9150,8916,1916,88,20229,0,41,0,41,222,27,249
2018-12-16,8,3573,5360,2335,9607,8897,1936,89,20686,39,1337,125,1501,200,30,230
2018-12-16,9,3593,5356,2476,10030,9001,1924,82,21193,227,3626,533,4386,180,25,205
2018-12-16,10,3595,5339,2543,10257,8951,1854,73,21292,332,4646,818,5796,169,32,201
2018-12-16,11,3561,5279,2531,10266,8906,1780,65,21174,331,4854,877,6062,174,37,211
2018-12-16,12,3526,5280,2496,10219,8808,1728,59,20970,328,4729,906,5963,199,42,241
2018-12-16,13,3509,5224,2458,10217,8795,1736,55,20960,308,4724,902,5934,226,54,280
2018-12-16,14,3505,5246,2429,10308,8885,1777,54,21179,277,4537,806,5620,245,61,306
2018-12-16,15,3534,5327,2407,10334,9007,1936,53,21486,215,3826,622,4663,265,60,325
2018-12-16,16,3618,5544,2434,10396,9306,2097,55,22009,105,1888,283,2276,291,54,345
2018-12-16,17,3937,5977,2589,10943,10025,2373,61,23557,13,181,40,234,312,50,362
2018-12-16,18,4210,6044,2749,12110,11295,2676,66,26302,0,0,0,0,317,57,374
2018-12-16,19,4224,5972,2720,12248,11510,2715,65,26693,0,0,0,0,362,70,432
2018-12-16,20,4188,5916,2665,12065,11384,2686,65,26356,0,0,0,0,362,88,450
2018-12-16,21,4114,5761,2589,11647,11097,2585,66,25551,0,0,0,0,342,115,457
2018-12-16,22,3987,5492,2464,11049,10610,2436,66,24316,0,0,0,0,337,178,515
2018-12-16,23,3827,5210,2293,10246,10006,2210,63,22681,0,0,0,0,247,217,464
2018-12-16,24,3651,5017,2128,9450,9397,2009,61,21074,0,0,0,0,230,270,500
2018-12-17,1,3465,4813,1992,9076,9066,1887,62,20249,0,0,0,0,230,531,761
2018-12-17,2,3390,4783,1947,8743,8765,1823,62,19552,0,0,0,0,229,508,737
2018-12-17,3,3357,4801,1936,8569,8661,1781,63,19232,0,0,0,0,228,451,679
2018-12-17,4,3371,4905,1973,8563,8637,1772,66,19197,0,0,0,0,202,486,688
2018-12-17,5,3442,5136,2084,8825,9025,1822,71,19902,0,0,0,0,142,616,758
2018-12-17,6,3621,5528,2329,9513,9768,1983,80,21503,0,0,0,0,109,724,833
2018-12-17,7,3849,5891,2685,10701,10862,2252,87,24061,0,24,0,24,81,817,898
2018-12-17,8,3865,5937,2940,11728,11229,2366,88,25569,51,833,64,948,73,858,931
2018-12-17,9,3851,5901,2913,11694,11272,2326,82,25532,308,2653,314,3275,73,868,941
2018-12-17,10,3826,5859,2889,11579,11167,2253,76,25234,481,3663,544,4688,80,934,1014
2018-12-17,11,3792,5791,2839,11422,11021,2166,70,24837,509,4136,655,5300,75,1153,1228
2018-12-17,12,3747,5735,2769,11278,10897,2109,66,24508,520,4405,783,5708,64,1375,1439
2018-12-17,13,3716,5711,2723,11184,10888,2103,63,24395,528,4444,811,5783,59,1612,1671
2018-12-17,14,3720,5694,2676,11211,10997,2144,61,24569,544,4311,757,5612,66,1692,1758
2018-12-17,15,3747,5737,2641,11271,11089,2183,58,24759,516,3762,640,4918,79,1757,1836
2018-12-17,16,3835,5914,2654,11433,11194,2258,59,25101,304,1850,333,2487,90,1753,1843
2018-12-17,17,4144,6300,2808,11978,11741,2476,65,26418,23,181,41,245,98,1702,1800
2018-12-17,18,4403,6334,2952,12972,12968,2866,69,29034,0,0,0,0,121,1631,1752
2018-12-17,19,4418,6225,2931,13163,13104,2920,69,29414,0,0,0,0,146,1619,1765
2018-12-17,20,4373,6139,2855,12995,12934,2864,69,29020,0,0,0,0,159,1589,1748
2018-12-17,21,4271,5933,2756,12564,12545,2723,69,28059,0,0,0,0,158,1453,1611
2018-12-17,22,4101,5587,2604,11872,11913,2540,68,26550,0,0,0,0,160,1339,1499
2018-12-17,23,3895,5242,2396,10945,11076,2281,65,24525,0,0,0,0,158,1363,1521
2018-12-17,24,3682,5021,2205,10066,10156,2053,63,22497,0,0,0,0,157,1287,1444
2018-12-18,1,3563,4895,2061,10153,9562,1952,64,21890,0,0,0,0,196,1158,1354
2018-12-18,2,3483,4850,1993,9487,9201,1881,65,20793,0,0,0,0,181,1078,1259
2018-12-18,3,3445,4853,1964,9231,9008,1834,67,20300,0,0,0,0,165,994,1159
2018-12-18,4,3450,4942,1976,9176,8922,1822,69,20149,0,0,0,0,155,952,1107
2018-12-18,5,3522,5162,2058,9369,9162,1876,75,20642,0,0,0,0,142,884,1026
2018-12-18,6,3703,5545,2276,10054,9905,2037,83,22240,0,0,0,0,128,817,945
2018-12-18,7,3928,5888,2598,11260,11079,2318,92,24909,0,47,0,47,125,749,874
2018-12-18,8,3919,5914,2796,12104,11345,2395,94,26097,64,1111,90,1265,117,679,796
2018-12-18,9,3880,5858,2784,11968,11407,2320,86,25939,378,3463,466,4307,120,641,761
2018-12-18,10,3828,5801,2771,11462,11148,2229,78,25076,585,4549,767,5901,120,604,724
2018-12-18,11,3773,5726,2715,10842,10992,2153,73,24220,622,4766,897,6285,117,650,767
2018-12-18,12,3715,5660,2685,10538,10803,2112,67,23679,629,4823,914,6366,119,684,803
2018-12-18,13,3677,5636,2663,10413,10778,2125,63,23538,650,4878,931,6459,113,770,883
2018-12-18,14,3664,5617,2636,10415,10870,2179,62,23684,656,4740,904,6300,109,946,1055
2018-12-18,15,3675,5650,2608,10769,11060,2247,60,24295,666,4162,784,5612,101,1118,1219
2018-12-18,16,3752,5837,2633,11184,11235,2355,61,24993,396,2122,444,2962,95,1269,1364
2018-12-18,17,4062,6223,2778,11777,11820,2577,67,26400,37,198,58,293,99,1374,1473
2018-12-18,18,4321,6267,2917,12970,12935,2890,72,29027,0,0,0,0,109,1424,1533
2018-12-18,19,4351,6168,2890,13257,13079,2914,74,29482,0,0,0,0,123,1390,1513
2018-12-18,20,4317,6080,2817,13082,12916,2866,76,29099,0,0,0,0,128,1232,1360
2018-12-18,21,4232,5874,2724,12819,12586,2746,75,28385,0,0,0,0,136,1046,1182
2018-12-18,22,4074,5540,2583,12226,11973,2572,73,27003,0,0,0,0,145,715,860
2018-12-18,23,3870,5201,2393,11358,11133,2312,69,25029,0,0,0,0,157,463,620
2018-12-18,24,3666,4979,2203,10459,10270,2089,67,23044,0,0,0,0,160,343,503
2018-12-19,1,3534,4873,2094,9568,9549,1959,67,21300,0,0,0,0,131,342,473
2018-12-19,2,3442,4828,2030,9150,9153,1870,68,20399,0,0,0,0,89,260,349
2018-12-19,3,3394,4819,2000,8919,8951,1816,70,19915,0,0,0,0,61,221,282
2018-12-19,4,3397,4901,2019,8887,8912,1801,73,19831,0,0,0,0,42,202,244
2018-12-19,5,3459,5099,2106,9147,9198,1854,79,20437,0,0,0,0,30,171,201
2018-12-19,6,3614,5432,2323,9757,9903,2000,87,21907,0,0,0,0,27,148,175
2018-12-19,7,3795,5741,2617,10750,10827,2222,95,24051,0,46,0,46,28,143,171
2018-12-19,8,3796,5814,2844,11316,10808,2300,96,24678,63,1232,135,1430,35,143,178
2018-12-19,9,3778,5800,2871,11283,10718,2256,88,24504,372,3659,644,4675,43,159,202
2018-12-19,10,3755,5761,2851,11029,10573,2142,80,23982,580,4705,997,6282,55,185,240
2018-12-19,11,3722,5690,2800,10742,10327,2062,73,23362,614,4833,1110,6557,41,203,244
2018-12-19,12,3685,5612,2725,10483,10182,2015,67,22904,607,4827,1167,6601,35,218,253
2018-12-19,13,3649,5581,2662,10301,10200,2019,63,22743,623,4895,1171,6689,31,219,250
2018-12-19,14,3636,5568,2612,10304,10505,2100,60,23128,634,4809,1143,6586,29,197,226
2018-12-19,15,3653,5595,2570,10552,10756,2174,60,23701,605,4261,1026,5892,28,173,201
2018-12-19,16,3731,5744,2563,10976,11088,2307,61,24590,364,2217,569,3150,36,147,183
2018-12-19,17,3977,6113,2694,11561,11747,2510,66,26042,29,223,69,321,47,132,179
2018-12-19,18,4230,6181,2839,12787,12753,2830,70,28597,0,0,0,0,52,146,198
2018-12-19,19,4252,6104,2831,13097,12741,2867,70,28933,0,0,0,0,64,159,223
2018-12-19,20,4214,6044,2777,12962,12457,2814,71,28462,0,0,0,0,73,157,230
2018-12-19,21,4138,5883,2703,12662,12198,2712,72,27803,0,0,0,0,71,154,225
2018-12-19,22,4001,5595,2571,12083,11708,2562,70,26582,0,0,0,0,82,163,245
2018-12-19,23,3836,5263,2396,11204,10910,2329,67,24670,0,0,0,0,95,149,244
2018-12-19,24,3645,5037,2225,10364,10137,2115,67,22841,0,0,0,0,106,139,245
2018-12-20,1,3499,4861,2120,9731,9720,2017,67,21694,0,0,0,0,55,67,122
2018-12-20,2,3407,4820,2067,9325,9277,1932,68,20761,0,0,0,0,60,59,119
2018-12-20,3,3358,4822,2042,9089,9037,1868,70,20224,0,0,0,0,63,47,110
2018-12-20,4,3357,4906,2064,9050,8980,1849,73,20111,0,0,0,0,60,36,96
2018-12-20,5,3426,5116,2153,9278,9233,1895,79,20645,0,0,0,0,54,33,87
2018-12-20,6,3588,5455,2365,9887,9840,2033,87,22007,0,0,0,0,47,34,81
2018-12-20,7,3767,5757,2652,10916,10759,2247,95,24176,0,9,0,9,45,36,81
2018-12-20,8,3778,5828,2843,11581,11077,2304,96,25215,38,846,83,967,45,36,81
2018-12-20,9,3779,5791,2867,11566,11031,2259,88,25103,196,2740,406,3342,45,33,78
2018-12-20,10,3765,5739,2840,11281,10996,2143,79,24657,368,4001,766,5135,49,27,76
2018-12-20,11,3732,5653,2783,10978,10838,2103,72,24150,468,4276,938,5682,56,21,77
2018-12-20,12,3695,5549,2699,10715,10743,2100,66,23785,511,4246,980,5737,62,19,81
2018-12-20,13,3661,5498,2631,10478,10757,2150,62,23609,525,4186,980,5691,68,24,92
2018-12-20,14,3649,5472,2582,10426,11043,2216,60,23904,528,3907,908,5343,70,36,106
2018-12-20,15,3661,5482,2535,10550,11352,2284,59,24402,438,3175,718,4331,72,49,121
2018-12-20,16,3730,5626,2531,10858,11674,2383,60,25132,234,1686,384,2304,74,68,142
2018-12-20,17,3971,5998,2662,11585,11997,2561,65,26366,53,328,82,463,78,94,172
2018-12-20,18,4209,6080,2808,12812,12958,2836,70,28834,0,1,0,1,84,121,205
2018-12-20,19,4223,6006,2787,12996,12898,2857,69,28978,0,0,0,0,97,141,238
2018-12-20,20,4174,5960,2723,12843,12601,2800,71,28474,0,0,0,0,115,151,266
2018-12-20,21,4098,5806,2660,12434,12242,2699,71,27607,0,0,0,0,137,173,310
2018-12-20,22,3969,5530,2540,11846,11679,2554,69,26305,0,0,0,0,161,222,383
2018-12-20,23,3814,5210,2388,11101,10968,2327,66,24620,0,0,0,0,163,283,446
2018-12-20,24,3623,4987,2236,10312,10158,2118,64,22810,0,0,0,0,139,345,484
2018-12-21,1,3471,4883,2210,9700,9676,1958,61,21553,0,0,0,0,66,798,864
2018-12-21,2,3379,4836,2162,9283,9242,1893,61,20637,0,0,0,0,50,823,873
2018-12-21,3,3328,4831,2134,9054,9010,1852,63,20138,0,0,0,0,39,807,846
2018-12-21,4,3331,4918,2154,9013,8960,1838,65,20035,0,0,0,0,30,749,779
2018-12-21,5,3393,5096,2245,9247,9187,1879,72,20544,0,0,0,0,25,715,740
2018-12-21,6,3534,5403,2453,9807,9801,2038,77,21881,0,0,0,0,31,736,767
2018-12-21,7,3711,5698,2738,10756,10634,2295,84,23927,0,5,0,5,46,825,871
2018-12-21,8,3741,5776,2956,11602,10992,2392,84,25228,42,354,45,441,54,903,957
2018-12-21,9,3766,5763,3001,11678,11008,2320,78,25245,228,1231,235,1694,54,982,1036
2018-12-21,10,3778,5709,2977,11488,10971,2214,72,24902,419,2026,492,2937,56,1094,1150
2018-12-21,11,3761,5622,2929,11169,10786,2153,66,24332,510,2495,710,3715,57,1196,1253
2018-12-21,12,3725,5525,2840,10870,10592,2119,62,23799,549,2699,816,4064,55,1303,1358
2018-12-21,13,3689,5470,2767,10549,10501,2145,59,23411,565,2576,871,4012,50,1380,1430
2018-12-21,14,3681,5442,2709,10438,10624,2208,57,23484,579,2339,930,3848,42,1449,1491
2018-12-21,15,3703,5445,2659,10536,10835,2270,57,23854,540,1957,846,3343,34,1485,1519
2018-12-21,16,3772,5568,2656,10872,11022,2397,58,24505,319,1092,494,1905,28,1502,1530
2018-12-21,17,4014,5923,2775,11665,11652,2597,62,26133,66,253,112,431,27,1605,1632
2018-12-21,18,4224,5979,2897,12595,12589,2857,66,28262,0,3,1,4,33,1748,1781
2018-12-21,19,4208,5892,2875,12544,12466,2848,64,28078,0,0,0,0,41,1813,1854
2018-12-21,20,4152,5816,2812,12285,12189,2773,63,27467,0,0,0,0,49,1814,1863
2018-12-21,21,4079,5682,2740,12022,11895,2684,63,26823,0,0,0,0,68,1816,1884
2018-12-21,22,3985,5475,2626,11697,11611,2543,62,26069,0,0,0,0,102,1779,1881
2018-12-21,23,3865,5204,2492,11055,10982,2329,60,24583,0,0,0,0,145,1727,1872
2018-12-21,24,3693,4986,2343,10328,10217,2115,59,22877,0,0,0,0,185,1740,1925
2018-12-22,1,3540,4906,2253,9847,9566,1983,61,21616,0,0,0,0,170,1398,1568
2018-12-22,2,3446,4849,2206,9444,9134,1887,63,20687,0,0,0,0,168,1126,1294
2018-12-22,3,3402,4835,2191,9184,8874,1833,64,20114,0,0,0,0,148,893,1041
2018-12-22,4,3390,4874,2218,9062,8760,1807,66,19854,0,0,0,0,122,662,784
2018-12-22,5,3418,4972,2278,9131,8813,1812,71,19986,0,0,0,0,94,414,508
2018-12-22,6,3510,5136,2390,9409,9107,1876,77,20629,0,0,0,0,67,211,278
2018-12-22,7,3614,5343,2548,9945,9551,1969,84,21708,0,8,0,8,54,102,156
2018-12-22,8,3583,5450,2739,10381,9536,1993,84,22153,39,751,38,828,45,65,110
2018-12-22,9,3602,5509,2878,10520,9653,2006,78,22420,202,2480,198,2880,33,49,82
2018-12-22,10,3614,5522,2887,10363,9726,1941,71,22260,375,3746,399,4520,21,48,69
2018-12-22,11,3583,5496,2828,10032,9664,1858,64,21776,460,4137,564,5161,14,62,76
2018-12-22,12,3526,5453,2728,9647,9562,1818,60,21245,494,4152,638,5284,14,79,93
2018-12-22,13,3474,5415,2623,9529,9556,1850,57,21151,519,4061,647,5227,19,89,108
2018-12-22,14,3453,5385,2534,9559,9537,1920,56,21229,548,3747,658,4953,24,82,106
2018-12-22,15,3457,5434,2473,9624,9662,1996,55,21498,505,3001,581,4087,33,63,96
2018-12-22,16,3539,5607,2500,10127,9879,2158,57,22378,300,1603,336,2239,49,47,96
2018-12-22,17,3837,6016,2660,10907,10549,2424,63,24100,70,334,78,482,72,38,110
2018-12-22,18,4102,6057,2783,11970,11696,2688,68,26579,0,1,0,1,83,36,119
2018-12-22,19,4103,5982,2757,12089,11634,2694,69,26642,0,0,0,0,89,42,131
2018-12-22,20,4064,5932,2697,11955,11488,2636,70,26305,0,0,0,0,103,54,157
2018-12-22,21,4007,5802,2624,11731,11272,2548,69,25778,0,0,0,0,113,68,181
2018-12-22,22,3921,5570,2536,11416,10948,2437,67,25025,0,0,0,0,116,77,193
2018-12-22,23,3813,5300,2395,10812,10350,2257,65,23642,0,0,0,0,115,85,200
2018-12-22,24,3654,5086,2251,10148,9711,2072,64,22153,0,0,0,0,120,106,226
2018-12-23,1,3545,4931,2162,9350,9168,1952,62,20693,0,0,0,0,91,46,137
2018-12-23,2,3454,4875,2103,8928,8782,1863,63,19799,0,0,0,0,86,48,134
2018-12-23,3,3405,4873,2086,8658,8520,1804,65,19208,0,0,0,0,90,68,158
2018-12-23,4,3392,4895,2096,8576,8403,1774,68,18982,0,0,0,0,103,127,230
2018-12-23,5,3418,4964,2145,8618,8437,1782,73,19071,0,0,0,0,113,178,291
2018-12-23,6,3492,5081,2227,8842,8588,1816,78,19484,0,0,0,0,109,193,302
2018-12-23,7,3552,5257,2343,9295,8860,1908,86,20310,0,5,0,5,101,177,278
2018-12-23,8,3525,5360,2512,9675,8832,1930,87,20682,45,719,63,827,96,151,247
2018-12-23,9,3550,5349,2649,9837,8769,1930,80,20776,236,2367,303,2906,89,166,255
2018-12-23,10,3568,5320,2698,9938,8628,1868,72,20664,447,3549,589,4585,83,218,301
2018-12-23,11,3536,5239,2657,9768,8510,1802,65,20302,561,3919,778,5258,77,280,357
2018-12-23,12,3495,5224,2597,9513,8437,1750,60,19918,597,3989,860,5446,70,303,373
2018-12-23,13,3467,5162,2545,9586,8517,1753,57,20071,606,3966,890,5462,62,345,407
2018-12-23,14,3459,5183,2504,9625,8682,1812,55,20331,618,3768,873,5259,57,466,523
2018-12-23,15,3482,5253,2471,9721,8997,1884,54,20813,566,3136,743,4445,56,672,728
2018-12-23,16,3573,5486,2506,9939,9362,2006,56,21518,346,1696,428,2470,59,930,989
2018-12-23,17,3879,5916,2678,10521,10185,2257,63,23182,84,350,100,534,66,1143,1209
2018-12-23,18,4143,5972,2818,11739,11459,2636,68,26058,0,2,1,3,79,1326,1405
2018-12-23,19,4159,5916,2797,11959,11582,2709,67,26473,0,0,0,0,95,1497,1592
2018-12-23,20,4132,5873,2756,11803,11459,2683,70,26170,0,0,0,0,109,1623,1732
2018-12-23,21,4059,5721,2681,11584,11167,2575,69,25553,0,0,0,0,115,1682,1797
2018-12-23,22,3944,5453,2559,11084,10786,2421,68,24514,0,0,0,0,118,1692,1810
2018-12-23,23,3789,5161,2382,10294,10111,2206,64,22832,0,0,0,0,123,1632,1755
2018-12-23,24,3615,4973,2208,9667,9496,2019,63,21403,0,0,0,0,133,1492,1625
2018-12-24,1,3447,4817,2084,9390,9249,2006,61,20868,0,0,0,0,86,1811,1897
2018-12-24,2,3350,4772,2017,8975,8892,1913,62,20008,0,0,0,0,82,1714,1796
2018-12-24,3,3310,4777,2003,8725,8604,1863,63,19422,0,0,0,0,78,1654,1732
2018-12-24,4,3310,4836,2034,8646,8501,1832,66,19211,0,0,0,0,74,1597,1671
2018-12-24,5,3379,4978,2126,8782,8721,1860,72,19597,0,0,0,0,68,1496,1564
2018-12-24,6,3502,5202,2278,9267,9104,1962,77,20573,0,0,0,0,65,1314,1379
2018-12-24,7,3640,5433,2495,9958,9631,2132,86,21967,0,6,0,6,72,1100,1172
2018-12-24,8,3642,5585,2713,10527,9698,2189,88,22663,46,812,73,931,91,927,1018
2018-12-24,9,3645,5626,2850,10817,9785,2170,82,23022,251,2753,373,3377,121,799,920
2018-12-24,10,3636,5591,2893,10946,9555,2059,75,22794,466,4142,704,5312,131,741,872
2018-12-24,11,3589,5515,2884,10746,9237,1981,70,22195,563,4506,873,5942,118,791,909
2018-12-24,12,3562,5392,2820,10600,8932,1904,65,21663,597,4523,972,6092,121,913,1034
2018-12-24,13,3526,5304,2727,10434,8881,1885,62,21424,615,4484,1031,6130,149,1071,1220
2018-12-24,14,3495,5258,2660,10362,9098,1927,60,21609,626,4306,1038,5970,202,1221,1423
2018-12-24,15,3529,5285,2594,10333,9399,1977,59,21928,563,3659,918,5140,301,1320,1621
2018-12-24,16,3602,5421,2601,10430,9755,2103,60,22510,325,2016,540,2881,401,1406,1807
2018-12-24,17,3866,5744,2730,10893,10553,2328,67,24002,68,411,125,604,495,1557,2052
2018-12-24,18,4111,5719,2827,11567,11477,2738,73,26012,0,1,1,2,613,1746,2359
2018-12-24,19,4082,5603,2730,11448,11284,2740,72,25700,0,0,0,0,684,1857,2541
2018-12-24,20,3994,5550,2647,11057,10945,2646,70,24874,0,0,0,0,673,1861,2534
2018-12-24,21,3914,5473,2593,10773,10685,2524,70,24208,0,0,0,0,591,1794,2385
2018-12-24,22,3842,5339,2529,10593,10592,2440,70,23853,0,0,0,0,516,1735,2251
2018-12-24,23,3745,5131,2429,10170,10202,2315,68,22913,0,0,0,0,500,1759,2259
2018-12-24,24,3584,4926,2317,9734,9765,2149,66,21873,0,0,0,0,496,1937,2433
2018-12-25,1,3457,4769,2184,9121,9055,1991,63,20394,0,0,0,0,222,2386,2608
2018-12-25,2,3380,4695,2130,8713,8660,1875,63,19476,0,0,0,0,187,2427,2614
2018-12-25,3,3322,4674,2101,8482,8399,1827,64,18934,0,0,0,0,190,2376,2566
2018-12-25,4,3303,4727,2108,8366,8187,1790,65,18573,0,0,0,0,231,2243,2474
2018-12-25,5,3331,4813,2166,8431,8211,1795,69,18675,0,0,0,0,273,2065,2338
2018-12-25,6,3412,4978,2285,8729,8488,1849,75,19309,0,0,0,0,277,1923,2200
2018-12-25,7,3498,5160,2445,9270,8806,1971,80,20290,0,7,0,7,221,1882,2103
2018-12-25,8,3470,5229,2612,9604,8802,1998,83,20651,51,714,53,818,160,2021,2181
2018-12-25,9,3486,5223,2690,9702,8965,1977,81,20890,284,2397,269,2950,141,2316,2457
2018-12-25,10,3505,5142,2687,9484,8953,1918,75,20594,486,3570,508,4564,146,2559,2705
2018-12-25,11,3478,5049,2647,9125,8794,1848,69,20002,546,3784,656,4986,203,2648,2851
2018-12-25,12,3457,4986,2595,8854,8610,1780,66,19473,577,3737,732,5046,354,2671,3025
2018-12-25,13,3452,4934,2525,8689,8440,1755,61,19106,633,3560,738,4931,519,2663,3182
2018-12-25,14,3464,4902,2455,8743,8485,1759,57,19205,716,3117,710,4543,618,2636,3254
2018-12-25,15,3509,4923,2407,8799,8602,1823,57,19442,706,2474,622,3802,647,2637,3284
2018-12-25,16,3610,5077,2430,9069,8856,1939,58,20082,455,1350,382,2187,632,2649,3281
2018-12-25,17,3870,5456,2556,9714,9550,2182,63,21667,108,294,99,501,631,2647,3278
2018-12-25,18,4109,5569,2663,10806,10737,2559,71,24329,0,2,0,2,670,2623,3293
2018-12-25,19,4109,5555,2663,11022,11080,2627,75,24960,0,0,0,0,729,2566,3295
2018-12-25,20,4082,5547,2653,10976,11051,2627,75,24886,0,0,0,0,773,2504,3277
2018-12-25,21,4033,5419,2598,10862,10899,2555,75,24548,0,0,0,0,799,2428,3227
2018-12-25,22,3936,5179,2511,10587,10576,2441,73,23834,0,0,0,0,794,2303,3097
2018-12-25,23,3821,4931,2362,10082,10039,2241,70,22591,0,0,0,0,747,2095,2842
2018-12-25,24,3664,4759,2235,9471,9540,2051,70,21291,0,0,0,0,677,1802,2479
2018-12-26,1,3477,4709,2186,9081,9381,1931,68,20628,0,0,0,0,566,1894,2460
2018-12-26,2,3396,4683,2151,8765,9072,1847,69,19923,0,0,0,0,430,1763,2193
2018-12-26,3,3369,4695,2141,8600,8880,1802,72,19524,0,0,0,0,304,1618,1922
2018-12-26,4,3378,4782,2184,8593,8850,1794,75,19483,0,0,0,0,209,1470,1679
2018-12-26,5,3458,4965,2292,8841,9110,1843,82,20044,0,0,0,0,150,1303,1453
2018-12-26,6,3600,5229,2507,9442,9749,1991,88,21436,0,0,0,0,118,1110,1228
2018-12-26,7,3779,5476,2773,10316,10702,2196,98,23481,0,7,0,7,98,885,983
2018-12-26,8,3794,5567,2964,10862,10927,2253,99,24311,81,823,90,994,80,650,730
2018-12-26,9,3769,5576,3011,10744,10817,2237,92,24051,438,2814,439,3691,64,444,508
2018-12-26,10,3731,5538,2982,10381,10556,2143,84,23325,758,4283,801,5842,49,310,359
2018-12-26,11,3684,5483,2920,9989,10463,2061,79,22752,816,4712,987,6515,37,270,307
2018-12-26,12,3643,5389,2818,9637,10245,1983,73,22097,805,4764,1071,6640,32,312,344
2018-12-26,13,3613,5326,2732,9336,10082,1949,68,21595,808,4735,1094,6637,28,412,440
2018-12-26,14,3597,5274,2664,9322,10083,1985,63,21613,839,4577,1080,6496,34,561,595
2018-12-26,15,3622,5291,2610,9435,10200,2040,62,21902,816,3897,962,5675,54,743,797
2018-12-26,16,3706,5428,2619,9724,10314,2153,62,22414,525,2148,587,3260,83,955,1038
2018-12-26,17,3973,5799,2763,10434,10815,2384,67,23857,125,456,145,726,129,1194,1323
2018-12-26,18,4289,5905,2926,11893,12199,2774,79,27097,0,2,1,3,189,1444,1633
2018-12-26,19,4323,5867,2920,12315,12473,2852,82,27874,0,0,0,0,245,1618,1863
2018-12-26,20,4276,5803,2851,12209,12359,2808,83,27611,0,0,0,0,302,1666,1968
2018-12-26,21,4200,5621,2771,11861,12059,2697,82,26853,0,0,0,0,343,1652,1995
2018-12-26,22,4063,5334,2632,11306,11575,2542,80,25661,0,0,0,0,332,1656,1988
2018-12-26,23,3889,5047,2449,10552,10882,2313,77,23984,0,0,0,0,268,1748,2016
2018-12-26,24,3708,4870,2303,9785,10120,2108,75,22253,0,0,0,0,196,1913,2109
2018-12-27,1,3609,4900,2216,9342,9651,1999,75,21228,0,0,0,0,122,1793,1915
2018-12-27,2,3528,4875,2178,8967,9273,1926,77,20403,0,0,0,0,103,1991,2094
2018-12-27,3,3489,4886,2164,8768,9071,1879,79,19958,0,0,0,0,107,2160,2267
2018-12-27,4,3500,4971,2200,8754,9021,1866,83,19884,0,0,0,0,146,2308,2454
2018-12-27,5,3578,5145,2302,9002,9275,1915,88,20445,0,0,0,0,204,2374,2578
2018-12-27,6,3728,5408,2506,9584,9897,2086,96,21829,0,0,0,0,268,2382,2650
2018-12-27,7,3915,5650,2764,10451,10742,2317,102,23773,0,7,0,7,350,2381,2731
2018-12-27,8,3931,5742,2960,11005,11058,2409,104,24738,78,812,85,975,475,2371,2846
2018-12-27,9,3930,5761,3017,10974,11153,2335,97,24740,437,2790,427,3654,631,2331,2962
2018-12-27,10,3910,5728,3006,10716,10969,2201,89,24159,771,4168,774,5713,763,2279,3042
2018-12-27,11,3875,5675,2961,10333,10876,2122,82,23598,835,4506,932,6273,867,2248,3115
2018-12-27,12,3837,5582,2872,9973,10645,2054,76,22913,823,4545,1003,6371,940,2243,3183
2018-12-27,13,3804,5525,2798,9654,10451,2024,70,22362,833,4478,1024,6335,971,2230,3201
2018-12-27,14,3796,5486,2738,9673,10290,2052,65,22244,883,4197,1010,6090,982,2173,3155
2018-12-27,15,3820,5506,2688,9774,10165,2131,62,22295,865,3480,889,5234,981,2077,3058
2018-12-27,16,3909,5650,2694,10042,10260,2250,62,22775,559,1910,537,3006,965,1961,2926
2018-12-27,17,4191,6016,2838,10826,10828,2470,68,24352,136,408,133,677,945,1789,2734
2018-12-27,18,4511,6110,2989,12288,12267,2780,82,27576,0,3,1,4,933,1510,2443
2018-12-27,19,4533,6054,2985,12642,12549,2839,85,28274,0,0,0,0,928,1205,2133
2018-12-27,20,4481,5982,2924,12473,12472,2793,85,27982,0,0,0,0,923,967,1890
2018-12-27,21,4397,5800,2846,12104,12218,2715,83,27279,0,0,0,0,915,782,1697
2018-12-27,22,4252,5521,2705,11522,11680,2583,82,26026,0,0,0,0,908,630,1538
2018-12-27,23,4070,5229,2527,10727,10976,2360,79,24308,0,0,0,0,913,502,1415
2018-12-27,24,3884,5048,2380,9982,10221,2155,77,22596,0,0,0,0,931,408,1339
2018-12-28,1,3859,5102,2354,9281,9779,1986,76,21282,0,0,0,0,1001,324,1325
2018-12-28,2,3772,5063,2309,8950,9490,1895,77,20575,0,0,0,0,1011,273,1284
2018-12-28,3,3721,5063,2293,8803,9309,1855,80,20210,0,0,0,0,1010,248,1258
2018-12-28,4,3717,5140,2327,8797,9266,1847,83,20158,0,0,0,0,1002,220,1222
2018-12-28,5,3785,5304,2430,9047,9474,1903,88,20672,0,0,0,0,998,191,1189
2018-12-28,6,3916,5542,2623,9617,10085,2035,95,21992,0,0,0,0,999,182,1181
2018-12-28,7,4079,5781,2877,10449,10950,2241,101,23900,0,7,0,7,1000,191,1191
2018-12-28,8,4093,5904,3091,10928,11090,2307,102,24589,85,901,97,1083,897,217,1114
2018-12-28,9,4093,5959,3157,10863,11196,2281,95,24598,453,3075,470,3998,773,269,1042
2018-12-28,10,4079,5949,3154,10486,11138,2177,88,24050,781,4637,856,6274,739,348,1087
2018-12-28,11,4038,5913,3112,10243,11044,2060,82,23591,829,5057,1040,6926,714,439,1153
2018-12-28,12,3980,5835,3019,9867,10886,1968,77,22960,811,5097,1107,7015,692,498,1190
2018-12-28,13,3924,5783,2931,9559,10691,1916,73,22400,829,5113,1130,7072,660,483,1143
2018-12-28,14,3886,5752,2856,9475,10591,1923,69,22219,872,5065,1129,7066,585,408,993
2018-12-28,15,3889,5770,2791,9607,10579,1993,69,22410,846,4446,1005,6297,488,324,812
2018-12-28,16,3966,5898,2792,9995,10827,2115,66,23161,547,2546,611,3704,399,260,659
2018-12-28,17,4250,6263,2924,10766,11387,2360,76,24747,136,572,153,861,343,235,578
2018-12-28,18,4574,6343,3060,12051,12849,2737,87,27880,0,3,1,4,342,240,582
2018-12-28,19,4597,6247,3013,12294,12999,2796,90,28334,0,0,0,0,365,251,616
2018-12-28,20,4552,6123,2918,12107,12815,2731,89,27898,0,0,0,0,428,251,679
2018-12-28,21,4485,5954,2838,11808,12534,2639,87,27224,0,0,0,0,469,243,712
2018-12-28,22,4375,5740,2721,11377,12217,2528,86,26364,0,0,0,0,432,249,681
2018-12-28,23,4215,5498,2577,10622,11553,2362,83,24777,0,0,0,0,370,274,644
2018-12-28,24,4048,5287,2426,9903,10842,2178,82,23164,0,0,0,0,303,300,603
2018-12-29,1,3906,5186,2256,10006,10199,2066,84,22514,0,0,0,0,141,332,473
2018-12-29,2,3818,5128,2198,9627,9848,1982,87,21700,0,0,0,0,118,329,447
2018-12-29,3,3766,5115,2171,9376,9641,1928,89,21191,0,0,0,0,100,316,416
2018-12-29,4,3755,5150,2184,9265,9537,1913,91,20964,0,0,0,0,84,307,391
2018-12-29,5,3790,5246,2233,9334,9605,1951,95,21145,0,0,0,0,81,301,382
2018-12-29,6,3869,5396,2337,9597,9935,2034,102,21828,0,0,0,0,84,291,375
2018-12-29,7,3990,5589,2480,10135,10403,2178,111,22985,0,7,0,7,84,279,363
2018-12-29,8,3957,5706,2663,10438,10266,2188,110,23163,87,922,102,1111,71,273,344
2018-12-29,9,3941,5772,2792,10482,10134,2120,103,23002,466,3109,495,4070,49,276,325
2018-12-29,10,3917,5770,2822,10249,9766,1984,95,22256,791,4665,893,6349,29,290,319
2018-12-29,11,3866,5713,2772,9991,9384,1879,87,21502,834,5092,1062,6988,16,308,324
2018-12-29,12,3794,5633,2674,9700,9319,1802,81,21063,814,5145,1118,7077,11,320,331
2018-12-29,13,3729,5560,2587,9492,9227,1768,76,20728,813,5179,1138,7130,8,319,327
2018-12-29,14,3691,5521,2502,9418,9143,1756,73,20552,826,5158,1123,7107,6,297,303
2018-12-29,15,3693,5561,2459,9614,9233,1845,71,20927,780,4550,990,6320,7,248,255
2018-12-29,16,3773,5740,2485,10021,9503,2020,70,21770,497,2609,602,3708,10,191,201
2018-12-29,17,4108,6149,2641,10559,10387,2259,79,23441,124,587,152,863,15,159,174
2018-12-29,18,4410,6201,2757,11786,11894,2648,91,26575,0,4,1,5,21,161,182
2018-12-29,19,4427,6139,2724,12086,12117,2739,93,27192,0,0,0,0,29,175,204
2018-12-29,20,4399,6084,2659,12039,12020,2715,94,27023,0,0,0,0,39,184,223
2018-12-29,21,4348,5947,2585,11822,11865,2641,93,26577,0,0,0,0,50,190,240
2018-12-29,22,4260,5713,2495,11425,11551,2549,92,25773,0,0,0,0,57,202,259
2018-12-29,23,4105,5432,2361,10809,10978,2378,88,24410,0,0,0,0,60,222,282
2018-12-29,24,3934,5208,2221,10137,10371,2198,85,22949,0,0,0,0,62,242,304
2018-12-30,1,3839,5013,2121,9725,9963,2112,80,22039,0,0,0,0,96,262,358
2018-12-30,2,3757,4951,2062,9385,9640,2025,81,21290,0,0,0,0,89,264,353
2018-12-30,3,3704,4931,2038,9125,9367,1972,83,20706,0,0,0,0,79,266,345
2018-12-30,4,3681,4951,2044,9034,9257,1947,86,20483,0,0,0,0,69,277,346
2018-12-30,5,3703,5023,2088,9096,9297,1974,90,20616,0,0,0,0,58,322,380
2018-12-30,6,3767,5134,2168,9315,9465,2034,96,21069,0,0,0,0,67,383,450
2018-12-30,7,3845,5310,2291,9741,9767,2178,105,21950,0,6,0,6,96,425,521
2018-12-30,8,3797,5424,2480,10023,9661,2188,103,22134,83,863,111,1057,107,458,565
2018-12-30,9,3787,5421,2627,10099,9612,2120,94,22089,420,3031,541,3992,87,483,570
2018-12-30,10,3782,5395,2701,9960,9371,1984,85,21566,717,4625,970,6312,63,544,607
2018-12-30,11,3739,5319,2693,9712,9232,1879,74,21056,788,5075,1143,7006,57,726,783
2018-12-30,12,3670,5312,2657,9291,9108,1802,64,20425,798,5114,1203,7115,59,1048,1107
2018-12-30,13,3615,5255,2618,9081,8996,1768,57,20061,817,5148,1231,7196,67,1391,1458
2018-12-30,14,3599,5291,2587,9105,9103,1770,54,20192,860,5105,1227,7192,67,1641,1708
2018-12-30,15,3623,5382,2563,9261,9302,1845,52,20620,839,4462,1107,6408,76,1795,1871
2018-12-30,16,3729,5615,2597,9640,9681,2020,54,21558,547,2552,695,3794,87,1921,2008
2018-12-30,17,4085,6039,2748,10455,10543,2276,60,23488,133,581,180,894,99,2092,2191
2018-12-30,18,4389,6084,2878,11940,12124,2769,67,27055,0,3,0,3,121,2251,2372
2018-12-30,19,4405,6019,2845,12299,12416,2882,70,27823,0,0,0,0,151,2352,2503
2018-12-30,20,4381,5969,2802,12242,12382,2859,73,27706,0,0,0,0,167,2395,2562
2018-12-30,21,4301,5822,2730,11973,12079,2732,74,27014,0,0,0,0,170,2364,2534
2018-12-30,22,4176,5565,2603,11448,11630,2569,75,25878,0,0,0,0,177,2316,2493
2018-12-30,23,3999,5287,2431,10685,10937,2378,72,24229,0,0,0,0,189,2288,2477
2018-12-30,24,3831,5106,2272,9932,10210,2198,71,22569,0,0,0,0,221,2277,2498
2018-12-31,1,3766,5018,2234,9759,10193,2025,75,22210,0,0,0,0,305,2020,2325
2018-12-31,2,3682,4985,2200,9407,9853,1924,75,21417,0,0,0,0,422,1837,2259
2018-12-31,3,3638,4990,2196,9230,9588,1879,76,20930,0,0,0,0,584,1733,2317
2018-12-31,4,3632,5066,2235,9171,9530,1846,78,20781,0,0,0,0,775,1646,2421
2018-12-31,5,3691,5227,2350,9382,9729,1887,82,21236,0,0,0,0,946,1559,2505
2018-12-31,6,3818,5476,2543,9910,10175,2008,89,22340,0,0,0,0,1058,1468,2526
2018-12-31,7,3967,5716,2802,10628,10722,2222,95,23824,0,5,0,5,1136,1229,2365
2018-12-31,8,3974,5862,3032,11064,10968,2317,98,24606,77,531,63,671,1169,874,2043
2018-12-31,9,4000,5970,3097,11032,10700,2421,97,24408,421,1958,325,2704,1169,639,1808
2018-12-31,10,4027,5967,3094,10834,10539,2400,91,24030,734,3082,673,4489,1171,555,1726
2018-12-31,11,4022,5927,3054,10632,10372,2377,88,23633,799,3480,939,5218,1178,566,1744
2018-12-31,12,3977,5868,2964,10147,10270,2266,85,22928,794,3567,1071,5432,1184,677,1861
2018-12-31,13,3945,5809,2857,9827,10154,2240,81,22462,797,3391,1096,5284,1182,804,1986
2018-12-31,14,3935,5818,2759,9656,9999,2241,79,22134,819,3115,1078,5012,1187,833,2020
2018-12-31,15,3953,5786,2686,9645,9878,2263,77,22023,781,2671,966,4418,1185,751,1936
2018-12-31,16,4033,5910,2695,9941,10003,2309,78,22491,496,1570,600,2666,1179,634,1813
2018-12-31,17,4289,6257,2837,10669,10851,2446,87,24210,123,387,156,666,1175,551,1726
2018-12-31,18,4614,6275,3025,12121,12753,2854,96,27981,0,5,1,6,1173,509,1682
2018-12-31,19,4596,6142,2988,12363,12812,2895,96,28321,0,0,1,1,1161,510,1671
2018-12-31,20,4477,6012,2863,12008,12328,2795,95,27377,0,0,0,0,1146,540,1686
2018-12-31,21,4338,5865,2750,11509,11893,2640,93,26290,0,0,0,0,1121,583,1704
2018-12-31,22,4199,5710,2613,11065,11393,2520,90,25216,0,0,0,0,1085,625,1710
2018-12-31,23,4095,5577,2509,10558,11037,2394,89,24223,0,0,0,0,1056,655,1711
2018-12-31,24,3990,5432,2413,10284,10649,2260,87,23436,0,0,0,0,1027,665,1692
2019-01-01,1,3909,5308,2327,9910,10097,2110,87,22362,0,0,0,0,1082,676,1758
2019-01-01,2,3834,5225,2296,9506,9682,2010,89,21444,0,0,0,0,1074,641,1715
2019-01-01,3,3777,5196,2281,9214,9390,1952,91,20803,0,0,0,0,1049,558,1607
2019-01-01,4,3755,5225,2302,9057,9193,1914,94,20416,0,0,0,0,1019,453,1472
2019-01-01,5,3772,5322,2370,9060,9158,1890,98,20364,0,0,0,0,989,375,1364
2019-01-01,6,3821,5466,2505,9234,9326,1958,105,20781,0,0,0,0,937,323,1260
2019-01-01,7,3866,5589,2689,9583,9575,2087,113,21513,0,7,0,7,899,291,1190
2019-01-01,8,3803,5637,2824,9746,9408,2092,112,21516,86,927,104,1117,831,274,1105
2019-01-01,9,3756,5656,2875,9782,9260,2043,108,21356,471,3152,518,4141,716,274,990
2019-01-01,10,3742,5650,2847,9482,9042,1943,100,20731,808,4740,961,6509,582,313,895
2019-01-01,11,3727,5600,2790,8987,8848,1871,92,19959,861,5202,1165,7228,497,377,874
2019-01-01,12,3701,5562,2700,8811,8744,1816,85,19616,845,5261,1232,7338,448,420,868
2019-01-01,13,3656,5527,2596,8580,8753,1790,79,19364,853,5307,1263,7423,398,426,824
2019-01-01,14,3638,5469,2493,8734,8799,1792,76,19564,876,5316,1260,7452,322,390,712
2019-01-01,15,3653,5489,2419,8969,8844,1849,75,19900,838,4757,1136,6731,232,328,560
2019-01-01,16,3739,5676,2429,9448,8969,1973,71,20621,554,2860,721,4135,154,268,422
2019-01-01,17,4022,6150,2603,10040,9809,2235,83,22321,146,698,194,1038,104,229,333
2019-01-01,18,4413,6359,2805,11610,11366,2683,96,25910,0,2,1,3,81,215,296
2019-01-01,19,4462,6274,2850,12127,11767,2806,99,26953,0,0,1,1,67,208,275
2019-01-01,20,4442,6169,2819,12022,11689,2772,102,26739,0,0,0,0,57,193,250
2019-01-01,21,4386,5996,2739,11755,11532,2667,100,26209,0,0,0,0,52,177,229
2019-01-01,22,4263,5714,2603,11315,11217,2528,97,25313,0,0,0,0,50,176,226
2019-01-01,23,4097,5467,2444,10673,10718,2358,94,24000,0,0,0,0,47,190,237
2019-01-01,24,3936,5290,2304,9955,10103,2187,92,22495,0,0,0,0,43,201,244
2019-01-02,1,3748,5198,2265,9960,10182,2099,96,22496,0,0,0,0,52,220,272
2019-01-02,2,3694,5181,2245,9686,9907,2043,98,21893,0,0,0,0,50,233,283
2019-01-02,3,3683,5208,2246,9512,9724,2005,101,21502,0,0,0,0,45,247,292
2019-01-02,4,3718,5300,2290,9530,9705,2010,105,21509,0,0,0,0,42,257,299
2019-01-02,5,3821,5524,2416,9844,10014,2091,111,22220,0,0,0,0,39,262,301
2019-01-02,6,4030,5914,2692,10616,10867,2307,122,24072,0,0,0,0,35,255,290
2019-01-02,7,4275,6241,3071,11941,12107,2636,134,26978,0,7,0,7,33,242,275
2019-01-02,8,4252,6235,3267,12546,12420,2713,133,27968,87,941,113,1141,26,225,251
2019-01-02,9,4126,6139,3196,12062,12068,2563,122,26972,460,3203,544,4207,19,203,222
2019-01-02,10,4006,6009,3080,11452,11695,2358,109,25772,788,4827,983,6598,15,184,199
2019-01-02,11,3916,5852,2973,10863,11280,2151,98,24549,848,5314,1169,7331,13,173,186
2019-01-02,12,3838,5710,2838,10420,10956,2008,91,23631,839,5378,1227,7444,11,161,172
2019-01-02,13,3791,5614,2739,10184,10770,1919,85,23114,849,5420,1252,7521,9,145,154
2019-01-02,14,3772,5549,2664,10256,10673,1888,80,23053,881,5426,1244,7551,8,120,128
2019-01-02,15,3779,5548,2599,10414,10726,1917,79,23292,853,4858,1117,6828,10,92,102
2019-01-02,16,3860,5668,2600,10854,11025,2025,78,24139,563,2921,717,4201,14,74,88
2019-01-02,17,4115,5977,2721,11710,11654,2262,86,25867,144,711,197,1052,16,63,79
2019-01-02,18,4507,6159,2897,13054,13130,2772,100,29211,0,2,0,2,17,61,78
2019-01-02,19,4577,6111,2922,13356,13457,2932,104,30003,0,0,0,0,19,63,82
2019-01-02,20,4543,6054,2876,13244,13239,2908,104,29642,0,0,0,0,18,64,82
2019-01-02,21,4457,5857,2795,12938,12966,2798,102,28956,0,0,0,0,17,70,87
2019-01-02,22,4288,5549,2634,12302,12400,2620,99,27578,0,0,0,0,21,82,103
2019-01-02,23,4054,5285,2441,11415,11631,2382,95,25679,0,0,0,0,23,90,113
2019-01-02,24,3879,5140,2280,10566,10827,2181,93,23822,0,0,0,0,26,92,118
2019-01-03,1,3826,5143,2290,9846,10139,2087,91,22322,0,0,0,0,32,154,186
2019-01-03,2,3767,5129,2258,9527,9769,2029,93,21574,0,0,0,0,34,149,183
2019-01-03,3,3744,5151,2250,9355,9589,1995,96,21190,0,0,0,0,40,139,179
2019-01-03,4,3768,5244,2289,9363,9550,1995,100,21167,0,0,0,0,45,133,178
2019-01-03,5,3864,5465,2398,9680,9811,2083,107,21840,0,0,0,0,50,100,150
2019-01-03,6,4054,5848,2655,10410,10626,2287,117,23599,0,0,0,0,59,71,130
2019-01-03,7,4285,6181,3012,11578,11566,2597,128,26034,0,7,0,7,96,102,198
2019-01-03,8,4259,6176,3197,12260,11739,2671,126,26960,89,917,102,1108,125,125,250
2019-01-03,9,4147,6083,3148,11965,11674,2527,114,26439,468,3112,493,4073,103,107,210
2019-01-03,10,4042,5966,3073,11526,11300,2331,101,25425,788,4698,900,6386,56,89,145
2019-01-03,11,3959,5815,2997,10997,10943,2141,89,24336,836,5169,1082,7087,32,80,112
2019-01-03,12,3885,5681,2895,10569,10590,2003,80,23404,818,5227,1136,7181,29,73,102
2019-01-03,13,3838,5603,2824,10338,10383,1927,74,22883,809,5265,1158,7232,28,67,95
2019-01-03,14,3819,5560,2752,10310,10337,1919,68,22794,795,5261,1140,7196,29,62,91
2019-01-03,15,3823,5557,2685,10333,10480,1968,64,23007,720,4699,1007,6426,31,57,88
2019-01-03,16,3889,5673,2685,10565,10727,2080,63,23596,461,2842,640,3943,29,57,86
2019-01-03,17,4126,5960,2772,11301,11191,2298,68,25016,122,708,176,1006,29,59,88
2019-01-03,18,4495,6126,2932,12590,12612,2766,84,28209,0,3,0,3,29,63,92
2019-01-03,19,4561,6065,2951,13004,12945,2901,89,29097,0,0,0,0,28,67,95
2019-01-03,20,4522,5995,2900,12861,12748,2869,91,28726,0,0,0,0,30,66,96
2019-01-03,21,4435,5801,2816,12497,12480,2757,91,27982,0,0,0,0,35,61,96
2019-01-03,22,4268,5516,2666,11899,11973,2590,88,26706,0,0,0,0,41,57,98
2019-01-03,23,4050,5254,2478,11094,11217,2356,84,24909,0,0,0,0,45,56,101
2019-01-03,24,3875,5102,2310,10321,10470,2160,83,23193,0,0,0,0,48,58,106
2019-01-04,1,3894,5187,2230,9738,9902,2062,85,21957,0,0,0,0,47,70,117
2019-01-04,2,3822,5154,2174,9406,9532,1993,86,21188,0,0,0,0,48,65,113
2019-01-04,3,3785,5169,2157,9282,9340,1956,89,20839,0,0,0,0,47,57,104
2019-01-04,4,3795,5248,2185,9302,9299,1953,93,20816,0,0,0,0,43,49,92
2019-01-04,5,3866,5453,2284,9548,9593,2023,99,21433,0,0,0,0,37,45,82
2019-01-04,6,4029,5805,2513,10150,10301,2210,108,22947,0,0,0,0,30,47,77
2019-01-04,7,4259,6137,2843,11298,11392,2496,119,25472,0,7,0,7,28,51,79
2019-01-04,8,4243,6161,3055,11966,11390,2569,117,26210,75,929,113,1117,29,56,85
2019-01-04,9,4153,6103,3037,11559,11112,2445,105,25389,384,3174,546,4104,29,54,83
2019-01-04,10,4069,6023,2990,11190,10760,2271,93,24481,672,4796,972,6440,27,51,78
2019-01-04,11,3991,5920,2931,10716,10520,2100,82,23584,751,5266,1158,7175,24,48,72
2019-01-04,12,3919,5820,2845,10281,10228,1989,74,22738,755,5308,1219,7282,24,43,67
2019-01-04,13,3859,5758,2773,10002,10068,1942,68,22247,762,5356,1243,7361,26,43,69
2019-01-04,14,3818,5728,2707,9980,10169,1959,63,22343,785,5363,1242,7390,28,43,71
2019-01-04,15,3813,5728,2654,9995,10375,2022,59,22622,766,4794,1124,6684,28,42,70
2019-01-04,16,3875,5810,2639,10441,10673,2138,59,23479,521,2927,725,4173,26,41,67
2019-01-04,17,4082,6074,2738,11159,11164,2346,64,24897,140,727,197,1064,24,37,61
2019-01-04,18,4426,6206,2895,12297,12412,2721,76,27659,0,4,0,4,26,34,60
2019-01-04,19,4488,6095,2884,12488,12608,2808,82,28141,0,0,0,0,37,34,71
2019-01-04,20,4451,5972,2815,12285,12418,2751,83,27701,0,0,0,0,50,35,85
2019-01-04,21,4376,5794,2719,12023,12146,2671,83,27093,0,0,0,0,56,40,96
2019-01-04,22,4249,5577,2596,11569,11791,2545,82,26156,0,0,0,0,58,52,110
2019-01-04,23,4077,5351,2443,10840,11138,2353,79,24579,0,0,0,0,57,71,128
2019-01-04,24,3913,5174,2295,10068,10406,2159,77,22880,0,0,0,0,61,91,152
2019-01-05,1,3849,5069,2186,9788,9897,2056,78,22011,0,0,0,0,50,63,113
2019-01-05,2,3755,5006,2133,9344,9483,1978,79,21069,0,0,0,0,53,68,121
2019-01-05,3,3706,5001,2115,9105,9172,1924,81,20470,0,0,0,0,64,75,139
2019-01-05,4,3685,5039,2131,8996,8996,1902,84,20166,0,0,0,0,97,84,181
2019-01-05,5,3705,5136,2182,9027,9110,1932,88,20344,0,0,0,0,171,81,252
2019-01-05,6,3772,5293,2279,9279,9347,1959,94,20867,0,0,0,0,299,75,374
2019-01-05,7,3882,5479,2423,9759,9898,2092,103,22041,0,3,0,3,442,123,565
2019-01-05,8,3838,5597,2604,10033,10126,2259,104,22712,31,311,46,388,573,193,766
2019-01-05,9,3848,5667,2736,10459,10435,2347,98,23527,167,1123,235,1525,667,249,916
2019-01-05,10,3849,5657,2789,10645,10399,2318,90,23643,273,1811,445,2529,710,331,1041
2019-01-05,11,3826,5590,2775,10491,10258,2237,83,23262,298,2117,553,2968,690,486,1176
2019-01-05,12,3785,5500,2703,10243,10061,2154,76,22728,326,2341,602,3269,671,711,1382
2019-01-05,13,3749,5408,2624,10100,9832,2125,70,22317,315,2127,573,3015,666,902,1568
2019-01-05,14,3730,5374,2547,10108,9642,2080,64,22092,275,1721,469,2465,647,993,1640
2019-01-05,15,3739,5377,2491,10110,9533,2055,59,21953,247,1384,350,1981,639,1005,1644
2019-01-05,16,3822,5468,2507,10262,9544,2052,64,22112,176,746,203,1125,621,947,1568
2019-01-05,17,4034,5783,2605,10775,10137,2266,72,23425,60,166,57,283,562,833,1395
2019-01-05,18,4380,5946,2749,11580,11577,2640,83,26059,1,8,2,11,480,691,1171
2019-01-05,19,4401,5882,2717,11770,11869,2692,84,26596,0,0,0,0,412,575,987
2019-01-05,20,4336,5802,2643,11558,11598,2650,83,26069,0,0,0,0,365,522,887
2019-01-05,21,4251,5649,2552,11323,11318,2560,82,25463,0,0,0,0,339,520,859
2019-01-05,22,4130,5447,2448,10917,10905,2446,79,24531,0,0,0,0,320,569,889
2019-01-05,23,3960,5217,2318,10291,10397,2264,77,23205,0,0,0,0,308,663,971
2019-01-05,24,3811,5026,2195,9616,9791,2081,75,21746,0,0,0,0,287,752,1039
2019-01-06,1,3710,4927,2115,9493,9424,1973,74,21156,0,0,0,0,286,578,864
2019-01-06,2,3627,4863,2061,9131,9065,1890,75,20354,0,0,0,0,241,713,954
2019-01-06,3,3577,4844,2038,8939,8854,1831,76,19893,0,0,0,0,210,828,1038
2019-01-06,4,3551,4867,2045,8799,8702,1797,79,19570,0,0,0,0,194,892,1086
2019-01-06,5,3573,4933,2091,8813,8709,1797,83,19596,0,0,0,0,198,940,1138
2019-01-06,6,3629,5035,2174,8985,8888,1838,87,19990,0,0,0,0,213,1001,1214
2019-01-06,7,3709,5204,2306,9472,9231,1915,92,20904,0,3,0,3,236,1042,1278
2019-01-06,8,3675,5325,2498,10068,9267,1963,95,21585,39,612,59,710,262,1036,1298
2019-01-06,9,3676,5351,2650,10392,9317,1999,89,21987,214,2274,323,2811,304,991,1295
2019-01-06,10,3690,5363,2723,10712,9229,1981,83,22198,363,3696,616,4675,336,956,1292
2019-01-06,11,3688,5328,2733,10737,9039,1944,74,21990,395,4253,744,5392,362,1000,1362
2019-01-06,12,3666,5360,2698,10622,8986,1916,67,21782,404,4388,780,5572,421,1146,1567
2019-01-06,13,3654,5321,2653,10540,8986,1903,61,21681,355,4362,689,5406,487,1317,1804
2019-01-06,14,3658,5362,2603,10468,8949,1929,58,21596,242,4138,482,4862,528,1380,1908
2019-01-06,15,3696,5419,2568,10378,8914,1986,56,21528,157,3519,320,3996,572,1300,1872
2019-01-06,16,3788,5580,2584,10399,9058,2102,56,21803,93,2058,163,2314,619,1173,1792
2019-01-06,17,4026,5863,2689,10998,9708,2318,61,23267,27,518,35,580,625,1056,1681
2019-01-06,18,4380,5992,2857,12268,11403,2642,72,26563,1,5,1,7,578,974,1552
2019-01-06,19,4408,5920,2837,12677,11784,2729,75,27447,0,0,0,0,540,954,1494
2019-01-06,20,4346,5832,2783,12430,11539,2700,76,26927,0,0,0,0,509,995,1504
2019-01-06,21,4240,5665,2693,11921,11279,2610,76,26066,0,0,0,0,491,1121,1612
2019-01-06,22,4082,5424,2552,11225,10814,2471,74,24769,0,0,0,0,504,1252,1756
2019-01-06,23,3893,5178,2382,10410,10215,2264,71,23145,0,0,0,0,496,1318,1814
2019-01-06,24,3723,5024,2237,9608,9622,2067,69,21542,0,0,0,0,501,1312,1813
2019-01-07,1,3678,4939,2162,8837,9111,1933,64,20137,0,0,0,0,540,1591,2131
2019-01-07,2,3602,4900,2134,8550,8818,1876,65,19501,0,0,0,0,431,1647,2078
2019-01-07,3,3556,4911,2138,8428,8721,1839,67,19248,0,0,0,0,318,1625,1943
2019-01-07,4,3556,5000,2187,8439,8725,1835,70,19261,0,0,0,0,258,1567,1825
2019-01-07,5,3621,5226,2313,8719,9044,1896,75,19927,0,0,0,0,235,1461,1696
2019-01-07,6,3782,5599,2574,9408,9765,2069,82,21516,0,0,0,0,194,1262,1456
2019-01-07,7,4010,5966,2946,10534,10790,2343,89,23949,0,5,0,5,172,968,1140
2019-01-07,8,4040,6036,3181,11399,11297,2440,90,25419,54,490,50,594,150,682,832
2019-01-07,9,4011,6048,3151,11417,11510,2367,85,25571,292,1704,274,2270,126,493,619
2019-01-07,10,3978,6040,3097,11291,11371,2270,79,25201,523,2828,551,3902,99,410,509
2019-01-07,11,3942,6003,3041,11097,11246,2177,72,24784,598,3520,744,4862,77,426,503
2019-01-07,12,3901,5974,2953,10894,11030,2117,67,24300,611,3868,830,5309,62,494,556
2019-01-07,13,3886,5963,2890,10680,10787,2105,64,23827,599,4052,850,5501,57,567,624
2019-01-07,14,3867,5961,2831,10619,10679,2127,61,23678,561,4104,841,5506,56,588,644
2019-01-07,15,3879,5985,2767,10656,10683,2193,59,23782,467,3624,712,4803,55,553,608
2019-01-07,16,3936,6092,2768,10897,10739,2308,60,24195,292,2166,427,2885,56,501,557
2019-01-07,17,4134,6350,2881,11416,11211,2522,63,25403,87,566,121,774,55,458,513
2019-01-07,18,4465,6465,3054,12533,12500,2840,70,28134,0,5,0,5,61,408,469
2019-01-07,19,4534,6362,3063,12851,12789,2896,70,28799,0,0,0,0,72,345,417
2019-01-07,20,4486,6234,3003,12583,12597,2852,71,28296,0,0,0,0,69,261,330
2019-01-07,21,4378,6021,2901,12080,12271,2764,69,27378,0,0,0,0,57,170,227
2019-01-07,22,4192,5707,2727,11416,11627,2597,67,25900,0,0,0,0,45,130,175
2019-01-07,23,3973,5411,2521,10505,10849,2352,64,23963,0,0,0,0,42,138,180
2019-01-07,24,3775,5219,2352,9712,10105,2133,62,22206,0,0,0,0,45,157,202
2019-01-08,1,3621,5086,2292,9257,9434,1930,64,20877,0,0,0,0,50,168,218
2019-01-08,2,3555,5043,2246,8859,9077,1852,65,20045,0,0,0,0,48,219,267
2019-01-08,3,3514,5052,2236,8643,8878,1808,67,19589,0,0,0,0,45,257,302
2019-01-08,4,3525,5139,2267,8601,8857,1798,70,19518,0,0,0,0,44,279,323
2019-01-08,5,3599,5368,2373,8816,9160,1857,75,20099,0,0,0,0,51,281,332
2019-01-08,6,3774,5744,2614,9408,9888,2017,83,21588,0,0,0,0,66,264,330
2019-01-08,7,4011,6097,2960,10587,11017,2305,92,24193,0,6,0,6,91,231,322
2019-01-08,8,4024,6126,3164,11573,11560,2403,95,25824,37,594,64,695,114,202,316
2019-01-08,9,3967,6081,3130,11620,11538,2332,87,25770,199,1998,309,2506,135,189,324
2019-01-08,10,3907,6041,3077,11642,11530,2231,79,25676,364,3218,620,4202,152,191,343
2019-01-08,11,3863,5985,3013,11503,11468,2143,73,25380,449,3872,845,5166,171,196,367
2019-01-08,12,3814,5928,2952,11444,11387,2081,68,25176,490,4047,921,5458,178,194,372
2019-01-08,13,3770,5901,2902,11393,11359,2075,63,25085,488,4057,914,5459,186,183,369
2019-01-08,14,3749,5888,2851,11414,11273,2128,60,25070,450,3867,848,5165,198,159,357
2019-01-08,15,3756,5898,2807,11392,11260,2180,58,25084,361,3129,672,4162,234,132,366
2019-01-08,16,3820,6015,2798,11526,11433,2275,58,25484,216,1718,371,2305,288,112,400
2019-01-08,17,4029,6285,2905,11919,11742,2452,62,26366,63,412,96,571,351,99,450
2019-01-08,18,4359,6414,3080,12687,12736,2770,69,28454,1,3,0,4,411,89,500
2019-01-08,19,4418,6330,3067,13020,12921,2840,73,29047,0,0,0,0,478,83,561
2019-01-08,20,4375,6216,2996,12757,12690,2782,74,28496,0,0,0,0,537,77,614
2019-01-08,21,4282,5996,2890,12271,12375,2667,72,27578,0,0,0,0,582,71,653
2019-01-08,22,4109,5686,2724,11567,11770,2490,70,26087,0,0,0,0,628,66,694
2019-01-08,23,3905,5396,2525,10732,10965,2245,67,24200,0,0,0,0,589,64,653
2019-01-08,24,3719,5215,2351,9915,10145,2035,66,22352,0,0,0,0,534,71,605
2019-01-09,1,3580,5065,2177,9237,9446,1941,67,20884,0,0,0,0,441,82,523
2019-01-09,2,3509,5024,2119,8891,9070,1871,68,20092,0,0,0,0,427,103,530
2019-01-09,3,3473,5037,2101,8659,8855,1829,71,19607,0,0,0,0,387,117,504
2019-01-09,4,3486,5119,2124,8592,8801,1817,74,19477,0,0,0,0,359,121,480
2019-01-09,5,3562,5341,2224,8806,9073,1873,80,20025,0,0,0,0,379,108,487
2019-01-09,6,3740,5709,2469,9408,9800,2038,88,21528,0,0,0,0,421,84,505
2019-01-09,7,3976,6050,2808,10575,10948,2316,96,24129,0,5,0,5,469,59,528
2019-01-09,8,3978,6070,3008,11646,11389,2406,99,25732,20,753,54,827,490,42,532
2019-01-09,9,3911,6023,2986,11698,11332,2327,89,25639,116,2708,266,3090,463,34,497
2019-01-09,10,3846,5965,2944,11675,11203,2209,80,25360,209,4281,480,4970,392,31,423
2019-01-09,11,3793,5898,2888,11562,11085,2099,72,25011,273,4874,580,5727,319,33,352
2019-01-09,12,3741,5826,2819,11512,10869,2016,66,24656,328,4996,630,5954,264,40,304
2019-01-09,13,3708,5791,2772,11463,10776,1999,62,24493,312,5018,596,5926,222,52,274
2019-01-09,14,3696,5781,2727,11452,10720,2030,59,24456,251,4879,487,5617,200,77,277
2019-01-09,15,3714,5791,2682,11395,10802,2094,57,24542,190,4189,361,4740,188,120,308
2019-01-09,16,3783,5891,2698,11539,10952,2206,57,24948,119,2482,182,2783,169,178,347
2019-01-09,17,3990,6176,2793,11936,11341,2398,61,25930,38,631,39,708,150,275,425
2019-01-09,18,4312,6302,2960,12748,12501,2757,68,28267,1,9,1,11,133,422,555
2019-01-09,19,4364,6213,2951,13011,12710,2815,69,28799,0,0,0,0,119,551,670
2019-01-09,20,4320,6118,2875,12702,12379,2754,71,28098,0,0,0,0,113,573,686
2019-01-09,21,4232,5914,2782,12216,12058,2645,70,27182,0,0,0,0,108,478,586
2019-01-09,22,4064,5615,2631,11505,11470,2475,68,25711,0,0,0,0,105,355,460
2019-01-09,23,3871,5329,2441,10657,10762,2244,65,23921,0,0,0,0,105,281,386
2019-01-09,24,3692,5154,2273,9891,9963,2051,63,22161,0,0,0,0,101,255,356
2019-01-10,1,3505,4956,2149,9175,9458,1920,62,20808,0,0,0,0,85,341,426
2019-01-10,2,3438,4927,2101,8830,9104,1858,63,20046,0,0,0,0,78,401,479
2019-01-10,3,3404,4942,2084,8626,8888,1810,65,19581,0,0,0,0,69,537,606
2019-01-10,4,3418,5035,2111,8608,8847,1798,68,19513,0,0,0,0,61,634,695
2019-01-10,5,3502,5258,2213,8861,9115,1854,74,20097,0,0,0,0,54,623,677
2019-01-10,6,3685,5632,2461,9525,9850,2019,82,21670,0,0,0,0,47,550,597
2019-01-10,7,3929,5978,2817,10697,10969,2301,91,24252,0,5,0,5,39,428,467
2019-01-10,8,3926,5981,3028,11532,11380,2404,92,25600,45,759,64,868,30,299,329
2019-01-10,9,3864,5909,2990,11444,11255,2338,85,25314,229,2745,349,3323,23,191,214
2019-01-10,10,3802,5838,2943,11261,11028,2227,77,24786,388,4282,701,5371,18,114,132
2019-01-10,11,3755,5752,2885,11058,10856,2128,70,24307,455,4830,916,6201,18,83,101
2019-01-10,12,3712,5661,2807,10888,10596,2046,65,23792,500,4975,1017,6492,20,77,97
2019-01-10,13,3677,5615,2754,10734,10415,2012,61,23417,537,5035,1083,6655,21,86,107
2019-01-10,14,3663,5586,2699,10662,10435,2035,59,23387,592,5053,1124,6769,21,106,127
2019-01-10,15,3669,5582,2643,10688,10557,2077,57,23570,590,4572,1035,6197,21,127,148
2019-01-10,16,3713,5689,2637,10860,10732,2156,57,23996,428,2899,708,4035,20,143,163
2019-01-10,17,3911,5952,2735,11308,11019,2327,60,24906,136,795,212,1143,21,148,169
2019-01-10,18,4231,6070,2908,12288,12171,2699,67,27418,0,9,0,9,23,129,152
2019-01-10,19,4279,6002,2917,12598,12425,2784,68,28068,0,0,0,0,25,98,123
2019-01-10,20,4233,5918,2863,12400,12215,2721,70,27600,0,0,0,0,30,85,115
2019-01-10,21,4145,5718,2770,11998,11923,2596,69,26780,0,0,0,0,41,85,126
2019-01-10,22,3987,5430,2622,11415,11497,2422,68,25594,0,0,0,0,53,84,137
2019-01-10,23,3799,5166,2432,10586,10803,2204,64,23850,0,0,0,0,64,78,142
2019-01-10,24,3629,5013,2279,9810,10029,2016,63,22111,0,0,0,0,67,72,139
2019-01-11,1,3501,4913,2203,9301,9494,1930,67,20984,0,0,0,0,34,68,102
2019-01-11,2,3435,4885,2159,8982,9190,1859,68,20291,0,0,0,0,34,64,98
2019-01-11,3,3404,4898,2143,8785,8975,1811,70,19834,0,0,0,0,31,61,92
2019-01-11,4,3418,4981,2175,8766,8929,1805,73,19764,0,0,0,0,27,59,86
2019-01-11,5,3498,5190,2271,9023,9191,1857,79,20342,0,0,0,0,33,65,98
2019-01-11,6,3669,5533,2503,9654,9879,2011,88,21825,0,0,0,0,43,76,119
2019-01-11,7,3899,5864,2843,10758,10905,2281,98,24236,0,7,0,7,55,82,137
2019-01-11,8,3920,5894,3055,11663,11316,2376,98,25646,28,752,54,834,78,79,157
2019-01-11,9,3864,5839,3035,11691,11235,2316,89,25523,159,2443,278,2880,100,71,171
2019-01-11,10,3811,5765,2987,11571,11028,2205,79,25076,349,3766,580,4695,117,70,187
2019-01-11,11,3758,5671,2926,11351,10847,2090,71,24553,512,4291,830,5633,134,77,211
2019-01-11,12,3706,5573,2841,11098,10564,1999,65,23921,576,4367,937,5880,145,85,230
2019-01-11,13,3670,5512,2771,10880,10409,1953,61,23502,569,4306,915,5790,147,98,245
2019-01-11,14,3648,5472,2713,10830,10392,1973,58,23451,530,4057,839,5426,140,124,264
2019-01-11,15,3648,5467,2650,10910,10541,2032,55,23734,430,3304,672,4406,143,166,309
2019-01-11,16,3694,5541,2646,10908,10751,2115,55,24021,253,1846,370,2469,142,203,345
2019-01-11,17,3886,5782,2741,11354,11047,2293,59,24944,67,452,87,606,129,220,349
2019-01-11,18,4192,5894,2897,12079,12161,2655,66,27154,0,2,0,2,126,249,375
2019-01-11,19,4228,5819,2879,12373,12353,2716,69,27702,0,0,0,0,126,270,396
2019-01-11,20,4178,5721,2802,12097,12065,2640,70,27064,0,0,0,0,125,251,376
2019-01-11,21,4099,5545,2711,11658,11726,2527,69,26172,0,0,0,0,122,236,358
2019-01-11,22,3976,5335,2580,11117,11264,2393,68,25034,0,0,0,0,121,238,359
2019-01-11,23,3831,5118,2428,10468,10710,2211,66,23647,0,0,0,0,116,251,367
2019-01-11,24,3679,4972,2291,9876,10058,2038,64,22228,0,0,0,0,109,267,376
2019-01-12,1,3598,4931,2172,9351,9573,1966,69,21151,0,0,0,0,101,401,502
2019-01-12,2,3517,4893,2125,8947,9209,1867,71,20285,0,0,0,0,113,341,454
2019-01-12,3,3477,4895,2107,8721,8920,1810,72,19714,0,0,0,0,115,293,408
2019-01-12,4,3471,4934,2123,8615,8757,1788,74,19426,0,0,0,0,113,266,379
2019-01-12,5,3505,5032,2180,8646,8810,1808,77,19533,0,0,0,0,104,249,353
2019-01-12,6,3585,5184,2295,8931,9101,1860,81,20166,0,0,0,0,90,240,330
2019-01-12,7,3692,5373,2458,9473,9597,1978,87,21327,0,4,0,4,85,248,333
2019-01-12,8,3681,5486,2647,9807,9752,2046,91,21888,43,302,47,392,80,246,326
2019-01-12,9,3698,5545,2777,9831,9995,2126,88,22233,255,1029,255,1539,75,234,309
2019-01-12,10,3699,5541,2805,9664,10164,2109,85,22214,497,1698,543,2738,63,257,320
2019-01-12,11,3678,5488,2765,9462,10190,2038,82,21964,636,2179,763,3578,55,300,355
2019-01-12,12,3647,5414,2671,9248,10048,1975,80,21542,695,2506,912,4113,48,347,395
2019-01-12,13,3621,5347,2575,9092,9986,1968,77,21315,725,2499,925,4149,47,398,445
2019-01-12,14,3600,5307,2484,9170,9931,1954,75,21321,765,2326,859,3950,38,430,468
2019-01-12,15,3606,5313,2417,9335,9860,1964,76,21427,740,1999,760,3499,30,413,443
2019-01-12,16,3658,5435,2424,9713,9928,2016,78,21937,521,1186,531,2238,28,360,388
2019-01-12,17,3872,5720,2524,10241,10351,2216,82,23081,161,366,172,699,27,303,330
2019-01-12,18,4195,5857,2691,11163,11343,2554,87,25340,0,6,1,7,25,262,287
2019-01-12,19,4215,5809,2693,11500,11510,2624,86,25913,0,0,0,0,28,228,256
2019-01-12,20,4153,5742,2647,11341,11379,2570,83,25567,0,0,0,0,31,181,212
2019-01-12,21,4082,5603,2584,11034,11081,2482,82,24872,0,0,0,0,27,138,165
2019-01-12,22,3973,5407,2482,10621,10673,2368,80,23933,0,0,0,0,24,118,142
2019-01-12,23,3824,5184,2352,10152,10168,2201,78,22790,0,0,0,0,26,112,138
2019-01-12,24,3689,5020,2241,9612,9704,2038,76,21621,0,0,0,0,30,108,138
2019-01-13,1,3617,4962,2177,8916,9263,1936,73,20381,0,0,0,0,44,72,116
2019-01-13,2,3548,4929,2139,8553,8892,1853,74,19564,0,0,0,0,52,65,117
2019-01-13,3,3507,4931,2132,8344,8641,1803,77,19057,0,0,0,0,49,66,115
2019-01-13,4,3497,4962,2152,8256,8432,1766,80,18726,0,0,0,0,37,69,106
2019-01-13,5,3527,5039,2214,8306,8459,1770,84,18811,0,0,0,0,33,73,106
2019-01-13,6,3595,5153,2319,8491,8675,1826,90,19274,0,0,0,0,39,84,123
2019-01-13,7,3680,5326,2468,8881,9028,1910,98,20108,0,6,0,6,51,101,152
2019-01-13,8,3655,5431,2672,9487,9176,1967,99,20920,57,710,78,845,58,123,181
2019-01-13,9,3661,5410,2803,9624,9198,2013,93,21120,279,2395,354,3028,59,145,204
2019-01-13,10,3674,5378,2831,9598,9040,1982,86,20899,475,3694,640,4809,56,186,242
2019-01-13,11,3663,5299,2788,9461,8840,1943,79,20515,532,4210,796,5538,55,253,308
2019-01-13,12,3624,5275,2696,9279,8760,1899,71,20201,555,4323,843,5721,58,322,380
2019-01-13,13,3588,5197,2617,9043,8654,1894,66,19848,558,4236,804,5598,65,372,437
2019-01-13,14,3569,5197,2544,9024,8636,1903,63,19817,525,3889,671,5085,71,390,461
2019-01-13,15,3584,5230,2481,9104,8709,1943,61,20009,431,3124,499,4054,78,386,464
2019-01-13,16,3658,5392,2487,9367,8947,2053,60,20617,259,1768,275,2302,80,348,428
2019-01-13,17,3876,5688,2587,10019,9642,2277,64,22194,74,443,68,585,78,303,381
2019-01-13,18,4224,5850,2803,11192,11091,2620,76,25172,0,5,0,5,79,298,377
2019-01-13,19,4266,5818,2826,11591,11571,2669,79,26104,0,0,0,0,80,302,382
2019-01-13,20,4229,5758,2803,11487,11474,2625,79,25859,0,0,0,0,77,301,378
2019-01-13,21,4152,5599,2721,11167,11187,2535,78,25161,0,0,0,0,76,306,382
2019-01-13,22,4002,5370,2578,10607,10751,2397,76,24024,0,0,0,0,74,320,394
2019-01-13,23,3828,5147,2408,9943,10140,2191,73,22539,0,0,0,0,78,347,425
2019-01-13,24,3668,5029,2277,9277,9548,2002,71,21090,0,0,0,0,81,380,461
2019-01-14,1,3569,5029,2219,8829,9248,1914,71,20253,0,0,0,0,117,726,843
2019-01-14,2,3505,5020,2203,8527,8801,1859,72,19451,0,0,0,0,126,767,893
2019-01-14,3,3478,5055,2212,8351,8585,1831,74,19035,0,0,0,0,135,779,914
2019-01-14,4,3492,5163,2266,8359,8578,1825,77,19032,0,0,0,0,159,796,955
2019-01-14,5,3577,5403,2402,8646,8878,1877,82,19678,0,0,0,0,234,837,1071
2019-01-14,6,3763,5792,2674,9303,9475,2046,89,21107,0,0,0,0,276,894,1170
2019-01-14,7,3988,6153,3062,10498,10558,2338,97,23684,0,6,0,6,236,945,1181
2019-01-14,8,4009,6187,3294,11470,11366,2433,99,25559,28,448,30,506,189,954,1143
2019-01-14,9,3962,6148,3251,11450,11536,2433,95,25705,161,1473,173,1807,178,927,1105
2019-01-14,10,3913,6083,3179,11263,11620,2404,90,25568,280,2298,339,2917,171,942,1113
2019-01-14,11,3867,5994,3102,10999,11654,2346,85,25276,327,2726,461,3514,164,1027,1191
2019-01-14,12,3813,5914,2987,10784,11630,2349,81,25036,364,2919,534,3817,164,1148,1312
2019-01-14,13,3787,5871,2910,10570,11578,2350,79,24769,345,2743,500,3588,162,1224,1386
2019-01-14,14,3755,5842,2835,10481,11577,2361,75,24686,270,2235,409,2914,142,1173,1315
2019-01-14,15,3755,5843,2765,10636,11477,2374,74,24750,196,1700,304,2200,129,1025,1154
2019-01-14,16,3803,5958,2765,10908,11429,2413,70,25012,121,913,161,1195,134,819,953
2019-01-14,17,4014,6239,2880,11478,11759,2560,78,26062,38,215,41,294,144,604,748
2019-01-14,18,4346,6387,3060,12489,12890,2848,87,28506,1,11,1,13,150,487,637
2019-01-14,19,4401,6313,3088,12785,13051,2931,88,29048,0,0,0,0,158,413,571
2019-01-14,20,4356,6214,3040,12563,12869,2852,86,28564,0,0,0,0,164,348,512
2019-01-14,21,4261,5998,2944,12078,12501,2717,83,27569,0,0,0,0,178,324,502
2019-01-14,22,4086,5683,2774,11359,11835,2514,81,25980,0,0,0,0,195,314,509
2019-01-14,23,3868,5393,2569,10513,10963,2256,76,23998,0,0,0,0,198,295,493
2019-01-14,24,3690,5227,2409,9704,10126,2037,72,22132,0,0,0,0,181,260,441
2019-01-15,1,3586,5147,2341,9075,9424,1932,72,20700,0,0,0,0,278,126,404
2019-01-15,2,3519,5122,2310,8738,9008,1857,73,19871,0,0,0,0,268,130,398
2019-01-15,3,3487,5146,2303,8576,8777,1811,76,19435,0,0,0,0,286,130,416
2019-01-15,4,3499,5232,2340,8591,8719,1798,77,19381,0,0,0,0,324,129,453
2019-01-15,5,3576,5460,2458,8860,8998,1858,82,19993,0,0,0,0,400,134,534
2019-01-15,6,3750,5847,2720,9562,9703,2018,89,21565,0,0,0,0,475,141,616
2019-01-15,7,3976,6185,3092,10804,10882,2345,96,24320,0,3,0,3,543,158,701
2019-01-15,8,3988,6190,3303,11865,11597,2555,99,26308,18,236,25,279,585,178,763
2019-01-15,9,3934,6117,3259,11912,11944,2570,94,26713,97,844,151,1092,615,198,813
2019-01-15,10,3868,6034,3175,11844,11896,2493,87,26514,173,1309,312,1794,658,236,894
2019-01-15,11,3824,5939,3088,11663,11714,2431,81,26083,232,1613,450,2295,688,288,976
2019-01-15,12,3778,5852,2989,11402,11533,2379,76,25584,289,1903,547,2739,710,332,1042
2019-01-15,13,3744,5811,2918,11237,11485,2370,72,25357,292,1897,550,2739,734,345,1079
2019-01-15,14,3725,5782,2854,11143,11480,2372,68,25256,264,1790,533,2587,774,335,1109
2019-01-15,15,3734,5789,2795,11090,11372,2362,66,25083,215,1602,455,2272,812,330,1142
2019-01-15,16,3807,5905,2781,11098,11399,2363,63,25116,138,965,281,1384,822,341,1163
2019-01-15,17,4016,6175,2901,11601,11658,2533,68,26053,48,319,87,454,796,344,1140
2019-01-15,18,4339,6320,3080,12576,12821,2825,80,28495,1,12,1,14,751,330,1081
2019-01-15,19,4392,6233,3084,12955,13089,2905,82,29223,0,0,0,0,702,323,1025
2019-01-15,20,4345,6140,3026,12752,12904,2835,81,28764,0,0,0,0,632,326,958
2019-01-15,21,4248,5919,2934,12332,12563,2692,79,27859,0,0,0,0,577,326,903
2019-01-15,22,4073,5613,2765,11630,11915,2501,77,26315,0,0,0,0,529,325,854
2019-01-15,23,3861,5333,2562,10696,11006,2251,73,24219,0,0,0,0,483,320,803
2019-01-15,24,3680,5155,2396,9838,10116,2043,70,22260,0,0,0,0,469,321,790
2019-01-16,1,3618,5062,2324,9160,9249,1902,66,20573,0,0,0,0,316,529,845
2019-01-16,2,3534,5027,2284,8801,8812,1830,67,19707,0,0,0,0,317,575,892
2019-01-16,3,3500,5042,2276,8593,8556,1784,68,19200,0,0,0,0,305,578,883
2019-01-16,4,3502,5124,2311,8553,8504,1769,71,19094,0,0,0,0,310,576,886
2019-01-16,5,3573,5336,2427,8792,8743,1820,78,19626,0,0,0,0,342,567,909
2019-01-16,6,3737,5704,2680,9442,9442,1977,84,21137,0,0,0,0,397,547,944
2019-01-16,7,3961,6042,3041,10650,10653,2289,91,23875,0,6,0,6,448,545,993
2019-01-16,8,3965,6054,3239,11723,11409,2489,93,25907,36,457,80,573,475,511,986
2019-01-16,9,3902,6000,3210,11844,11825,2525,88,26479,182,1574,370,2126,469,430,899
2019-01-16,10,3832,5926,3133,11892,11882,2486,80,26536,327,2612,671,3610,460,363,823
2019-01-16,11,3783,5839,3058,11818,11820,2433,73,26339,407,3335,847,4589,474,364,838
2019-01-16,12,3734,5757,2961,11688,11726,2379,67,26055,467,3646,917,5030,520,455,975
2019-01-16,13,3707,5721,2892,11649,11696,2363,63,25968,443,3603,846,4892,613,569,1182
2019-01-16,14,3697,5703,2831,11639,11679,2363,59,25936,327,3373,650,4350,714,602,1316
2019-01-16,15,3712,5718,2781,11582,11583,2380,57,25797,220,2837,459,3516,766,555,1321
2019-01-16,16,3787,5816,2794,11589,11622,2355,57,25813,127,1696,237,2060,813,464,1277
2019-01-16,17,3986,6083,2896,11904,11908,2464,60,26526,35,472,49,556,835,377,1212
2019-01-16,18,4312,6209,3066,12711,12882,2793,68,28645,1,8,1,10,823,341,1164
2019-01-16,19,4370,6128,3053,13087,13046,2881,70,29282,0,0,0,0,842,345,1187
2019-01-16,20,4324,6036,2981,12902,12833,2810,71,28811,0,0,0,0,877,380,1257
2019-01-16,21,4228,5838,2887,12458,12482,2668,70,27877,0,0,0,0,883,419,1302
2019-01-16,22,4049,5534,2727,11697,11864,2482,68,26306,0,0,0,0,868,459,1327
2019-01-16,23,3843,5248,2528,10742,10956,2238,65,24197,0,0,0,0,788,505,1293
2019-01-16,24,3660,5071,2359,9875,10077,2034,62,22248,0,0,0,0,685,561,1246
2019-01-17,1,3525,4985,2241,9029,9226,1936,57,20442,0,0,0,0,720,671,1391
2019-01-17,2,3441,4945,2192,8661,8815,1848,58,19577,0,0,0,0,658,717,1375
2019-01-17,3,3393,4946,2180,8481,8570,1781,59,19091,0,0,0,0,619,767,1386
2019-01-17,4,3392,5021,2206,8439,8506,1762,62,18968,0,0,0,0,626,808,1434
2019-01-17,5,3461,5231,2307,8660,8744,1834,66,19495,0,0,0,0,638,843,1481
2019-01-17,6,3624,5587,2547,9312,9456,1991,71,21022,0,0,0,0,651,892,1543
2019-01-17,7,3851,5922,2895,10526,10726,2280,78,23801,0,9,0,9,665,929,1594
2019-01-17,8,3879,5955,3088,11700,11399,2488,80,25857,35,407,31,473,673,961,1634
2019-01-17,9,3852,5937,3062,11811,11817,2552,78,26451,176,1324,177,1677,704,972,1676
2019-01-17,10,3818,5900,3021,11877,11875,2518,73,26537,324,2039,370,2733,714,973,1687
2019-01-17,11,3796,5843,2961,11806,11814,2458,68,26340,415,2407,520,3342,702,1032,1734
2019-01-17,12,3771,5788,2881,11676,11717,2418,64,26071,456,2646,597,3699,733,1170,1903
2019-01-17,13,3754,5777,2831,11635,11684,2373,61,25950,429,2614,546,3589,730,1330,2060
2019-01-17,14,3761,5773,2785,11625,11660,2375,59,25913,346,2335,444,3125,683,1467,2150
2019-01-17,15,3783,5796,2736,11567,11561,2362,57,25742,253,1912,324,2489,660,1583,2243
2019-01-17,16,3849,5895,2734,11568,11603,2412,57,25837,160,1083,177,1420,604,1629,2233
2019-01-17,17,4027,6120,2835,11885,11890,2602,59,26629,52,292,47,391,525,1576,2101
2019-01-17,18,4327,6222,2996,12516,12635,2848,66,28256,0,7,1,8,440,1493,1933
2019-01-17,19,4366,6136,2983,12764,12682,2848,66,28551,0,0,0,0,355,1526,1881
2019-01-17,20,4311,6037,2914,12596,12499,2755,65,28107,0,0,0,0,310,1729,2039
2019-01-17,21,4206,5827,2823,12136,12145,2667,64,27204,0,0,0,0,272,1981,2253
2019-01-17,22,4029,5533,2670,11445,11537,2497,62,25734,0,0,0,0,218,2131,2349
2019-01-17,23,3837,5253,2480,10545,10719,2251,59,23766,0,0,0,0,200,2177,2377
2019-01-17,24,3656,5080,2318,9730,9882,2037,57,21898,0,0,0,0,174,2207,2381
2019-01-18,1,3552,4915,2214,9144,9110,1897,56,20403,0,0,0,0,123,1950,2073
2019-01-18,2,3474,4874,2167,8788,8729,1828,57,19594,0,0,0,0,106,1860,1966
2019-01-18,3,3433,4883,2150,8590,8498,1778,58,19116,0,0,0,0,91,1815,1906
2019-01-18,4,3435,4959,2173,8561,8443,1767,60,19027,0,0,0,0,83,1782,1865
2019-01-18,5,3501,5163,2271,8809,8688,1813,64,19564,0,0,0,0,80,1766,1846
2019-01-18,6,3670,5507,2497,9449,9346,1961,71,21017,0,0,0,0,75,1767,1842
2019-01-18,7,3900,5838,2835,10639,10395,2288,79,23590,0,10,0,10,70,1765,1835
2019-01-18,8,3925,5893,3037,11515,10908,2432,82,25128,86,796,92,974,65,1783,1848
2019-01-18,9,3900,5879,3034,11442,10873,2400,78,24990,422,2750,433,3605,62,1721,1783
2019-01-18,10,3866,5844,2991,11280,10687,2276,73,24507,716,4390,814,5920,62,1495,1557
2019-01-18,11,3825,5789,2937,11023,10566,2155,68,24004,786,5043,1048,6877,58,1137,1195
2019-01-18,12,3784,5719,2855,10735,10388,2056,64,23435,791,5137,1151,7079,54,725,779
2019-01-18,13,3749,5685,2795,10558,10233,2010,61,23055,785,5161,1185,7131,50,422,472
2019-01-18,14,3722,5660,2736,10511,10227,2031,59,23021,783,5159,1196,7138,47,301,348
2019-01-18,15,3722,5667,2680,10637,10322,2078,57,23285,755,4708,1096,6559,45,283,328
2019-01-18,16,3769,5741,2688,10822,10462,2175,57,23707,575,3149,777,4501,47,291,338
2019-01-18,17,3933,5954,2761,11316,10830,2353,60,24750,202,973,255,1430,48,303,351
2019-01-18,18,4231,6048,2900,12129,11820,2640,66,26845,0,11,1,12,51,316,367
2019-01-18,19,4269,5954,2848,12321,12107,2715,66,27401,0,0,0,0,60,318,378
2019-01-18,20,4217,5835,2746,12053,11888,2644,67,26842,0,0,0,0,69,300,369
2019-01-18,21,4136,5655,2645,11666,11563,2529,67,26016,0,0,0,0,75,275,350
2019-01-18,22,4004,5431,2522,11157,11132,2394,67,24941,0,0,0,0,81,250,331
2019-01-18,23,3854,5207,2372,10455,10499,2210,64,23419,0,0,0,0,86,221,307
2019-01-18,24,3694,5040,2223,9750,9787,2041,63,21836,0,0,0,0,89,196,285
2019-01-19,1,3586,4945,2091,9024,9142,1890,64,20311,0,0,0,0,83,187,270
2019-01-19,2,3498,4890,2031,8634,8720,1809,65,19419,0,0,0,0,81,191,272
2019-01-19,3,3455,4891,2001,8397,8470,1760,66,18887,0,0,0,0,78,192,270
2019-01-19,4,3439,4924,2002,8307,8354,1751,68,18672,0,0,0,0,73,188,261
2019-01-19,5,3470,5013,2048,8312,8435,1771,71,18780,0,0,0,0,64,183,247
2019-01-19,6,3549,5163,2146,8574,8767,1827,76,19437,0,0,0,0,63,182,245
2019-01-19,7,3647,5344,2290,8993,9181,1950,84,20401,0,12,0,12,70,179,249
2019-01-19,8,3635,5471,2448,9466,9186,1967,86,20899,64,927,98,1089,75,177,252
2019-01-19,9,3667,5555,2580,9708,9257,1971,81,21208,308,2945,464,3717,68,173,241
2019-01-19,10,3676,5562,2638,9613,9222,1873,75,20975,574,4503,866,5943,56,170,226
2019-01-19,11,3632,5515,2621,9468,9087,1790,69,20605,705,5129,1096,6930,49,171,220
2019-01-19,12,3597,5444,2556,9244,8946,1746,63,20190,731,5209,1189,7129,44,169,213
2019-01-19,13,3563,5390,2488,9149,8937,1767,60,20105,744,5203,1211,7158,44,160,204
2019-01-19,14,3548,5358,2426,9232,9002,1791,59,20274,762,5131,1199,7092,46,143,189
2019-01-19,15,3547,5376,2382,9445,9183,1893,58,20769,718,4647,1076,6441,49,121,170
2019-01-19,16,3608,5471,2393,9829,9483,2036,59,21598,538,3162,749,4449,51,106,157
2019-01-19,17,3789,5733,2488,10387,10063,2210,62,22912,190,1016,246,1452,55,99,154
2019-01-19,18,4100,5862,2631,11169,11085,2498,69,25010,0,16,0,16,62,98,160
2019-01-19,19,4120,5818,2611,11485,11336,2570,69,25649,0,0,0,0,74,103,177
2019-01-19,20,4059,5744,2544,11271,11081,2505,70,25115,0,0,0,0,87,107,194
2019-01-19,21,3983,5598,2469,10940,10810,2407,70,24414,0,0,0,0,99,104,203
2019-01-19,22,3872,5397,2360,10447,10395,2286,68,23384,0,0,0,0,109,95,204
2019-01-19,23,3751,5163,2224,9879,9847,2117,66,22100,0,0,0,0,122,85,207
2019-01-19,24,3606,4976,2100,9315,9221,1961,64,20756,0,0,0,0,136,77,213
2019-01-20,1,3433,4763,2031,8968,8661,1880,61,19758,0,0,0,0,118,57,175
2019-01-20,2,3351,4713,1979,8607,8279,1803,62,18941,0,0,0,0,129,55,184
2019-01-20,3,3305,4708,1957,8365,8023,1747,64,18389,0,0,0,0,152,51,203
2019-01-20,4,3291,4731,1963,8248,7897,1717,67,18117,0,0,0,0,188,49,237
2019-01-20,5,3321,4802,2010,8264,7935,1723,71,18181,0,0,0,0,207,60,267
2019-01-20,6,3379,4908,2095,8444,8064,1768,77,18541,0,0,0,0,223,90,313
2019-01-20,7,3448,5073,2229,8855,8342,1845,82,19311,0,10,0,10,260,118,378
2019-01-20,8,3435,5191,2407,9316,8334,1874,83,19801,37,681,71,789,303,156,459
2019-01-20,9,3462,5198,2551,9648,8402,1879,79,20199,177,2269,339,2785,326,218,544
2019-01-20,10,3497,5184,2629,9813,8380,1828,72,20283,338,3617,634,4589,349,270,619
2019-01-20,11,3501,5122,2626,9805,8285,1769,66,20114,465,4294,819,5578,397,325,722
2019-01-20,12,3471,5119,2583,9725,8201,1722,60,19898,533,4465,884,5882,480,434,914
2019-01-20,13,3461,5060,2542,9679,8277,1739,57,19941,569,4445,883,5897,544,617,1161
2019-01-20,14,3468,5073,2504,9717,8424,1778,56,20162,613,4197,869,5679,594,876,1470
2019-01-20,15,3503,5117,2468,9776,8634,1857,54,20509,587,3447,762,4796,679,1188,1867
2019-01-20,16,3573,5260,2481,10005,8963,1975,54,21185,436,2034,527,2997,814,1448,2262
2019-01-20,17,3768,5533,2577,10557,9517,2178,58,22500,157,536,185,878,897,1587,2484
2019-01-20,18,4075,5679,2748,11575,10611,2450,65,24890,1,3,1,5,914,1608,2522
2019-01-20,19,4102,5637,2733,11977,11027,2572,65,25830,0,0,0,0,880,1571,2451
2019-01-20,20,4041,5580,2686,11814,10941,2532,63,25541,0,0,0,0,826,1627,2453
2019-01-20,21,3946,5426,2604,11408,10650,2425,62,24734,0,0,0,0,823,1821,2644
2019-01-20,22,3799,5190,2470,10775,10183,2285,60,23492,0,0,0,0,812,2096,2908
2019-01-20,23,3646,4956,2301,10028,9550,2094,57,21916,0,0,0,0,786,2381,3167
2019-01-20,24,3489,4819,2166,9296,8962,1929,55,20429,0,0,0,0,728,2607,3335
2019-01-21,1,3405,4826,2118,8665,8744,1848,62,19507,0,0,0,0,901,2729,3630
2019-01-21,2,3332,4798,2095,8366,8431,1794,62,18846,0,0,0,0,795,2791,3586
2019-01-21,3,3293,4815,2096,8235,8228,1757,64,18472,0,0,0,0,695,2738,3433
2019-01-21,4,3299,4901,2130,8237,8159,1744,65,18393,0,0,0,0,640,2618,3258
2019-01-21,5,3360,5087,2242,8479,8408,1792,68,18936,0,0,0,0,551,2486,3037
2019-01-21,6,3483,5373,2476,9030,9061,1949,74,20301,0,0,0,0,436,2354,2790
2019-01-21,7,3648,5642,2760,9912,9956,2197,80,22333,0,11,0,11,345,2290,2635
2019-01-21,8,3697,5772,2966,10466,10279,2329,84,23349,82,811,109,1002,254,2396,2650
2019-01-21,9,3729,5839,3051,10584,10556,2341,84,23757,402,2663,479,3544,168,2634,2802
2019-01-21,10,3754,5879,3073,10371,10599,2271,82,23515,669,4251,816,5736,98,2857,2955
2019-01-21,11,3760,5866,3047,10121,10577,2210,78,23177,718,5048,952,6718,69,2969,3038
2019-01-21,12,3736,5819,2944,9793,10469,2141,75,22670,722,5247,997,6966,64,3013,3077
2019-01-21,13,3734,5811,2861,9645,10439,2123,71,22470,719,5274,979,6972,86,3025,3111
2019-01-21,14,3744,5775,2796,9561,10440,2138,67,22398,689,5254,906,6849,125,3006,3131
2019-01-21,15,3783,5800,2729,9544,10461,2180,67,22441,629,4822,788,6239,175,2978,3153
2019-01-21,16,3855,5880,2744,9731,10594,2279,65,22859,498,3310,578,4386,221,2939,3160
2019-01-21,17,4013,6106,2827,10277,11067,2451,70,24053,192,1064,208,1464,227,2894,3121
2019-01-21,18,4352,6257,3011,11530,12396,2726,81,26920,1,16,1,18,226,2845,3071
2019-01-21,19,4411,6160,3037,12200,12845,2778,85,28097,0,0,0,0,249,2771,3020
2019-01-21,20,4349,6052,2979,12102,12617,2739,84,27729,0,0,0,0,310,2630,2940
2019-01-21,21,4234,5845,2891,11729,12246,2630,82,26876,0,0,0,0,405,2407,2812
2019-01-21,22,4052,5546,2716,11082,11640,2453,79,25443,0,0,0,0,509,2078,2587
2019-01-21,23,3826,5266,2514,10242,10788,2209,75,23503,0,0,0,0,627,1711,2338
2019-01-21,24,3642,5109,2350,9500,10003,2012,74,21778,0,0,0,0,783,1453,2236
2019-01-22,1,3537,5009,2299,9157,9305,1937,75,20665,0,0,0,0,845,1082,1927
2019-01-22,2,3479,4984,2269,8861,8944,1881,76,19955,0,0,0,0,875,834,1709
2019-01-22,3,3456,5000,2270,8717,8758,1840,78,19586,0,0,0,0,861,705,1566
2019-01-22,4,3478,5094,2311,8730,8740,1836,81,19584,0,0,0,0,858,668,1526
2019-01-22,5,3561,5329,2430,9023,9041,1900,87,20239,0,0,0,0,846,566,1412
2019-01-22,6,3751,5717,2703,9761,9847,2085,96,21977,0,0,0,0,804,407,1211
2019-01-22,7,3987,6067,3081,11024,11093,2401,104,24810,0,16,0,16,747,280,1027
2019-01-22,8,4011,6096,3287,11760,11429,2477,107,25964,111,1106,131,1348,614,228,842
2019-01-22,9,3952,6040,3229,11371,11240,2375,100,25277,513,3460,602,4575,433,255,688
2019-01-22,10,3888,5982,3145,10806,10959,2225,93,24273,846,5083,1028,6957,291,349,640
2019-01-22,11,3844,5915,3053,10217,10697,2099,86,23289,914,5596,1219,7729,230,502,732
2019-01-22,12,3800,5835,2947,9736,10408,2002,81,22418,909,5650,1295,7854,196,650,846
2019-01-22,13,3766,5805,2872,9538,10261,1956,78,22023,906,5654,1273,7833,165,732,897
2019-01-22,14,3745,5774,2804,9548,10260,1977,75,22050,918,5634,1272,7824,133,730,863
2019-01-22,15,3746,5789,2744,9629,10356,2034,74,22283,902,5258,1218,7378,94,655,749
2019-01-22,16,3807,5902,2735,9922,10580,2164,71,22927,746,3781,931,5458,60,553,613
2019-01-22,17,4006,6150,2842,10541,11071,2362,79,24241,291,1288,335,1914,41,479,520
2019-01-22,18,4338,6283,3018,11772,12243,2742,90,27034,0,24,0,24,39,443,482
2019-01-22,19,4393,6227,3028,12508,12701,2879,93,28367,0,0,0,0,49,429,478
2019-01-22,20,4347,6134,2966,12429,12555,2821,93,28086,0,0,0,0,50,415,465
2019-01-22,21,4260,5911,2872,12057,12271,2711,91,27320,0,0,0,0,40,389,429
2019-01-22,22,4087,5596,2708,11394,11715,2543,89,25931,0,0,0,0,31,359,390
2019-01-22,23,3874,5317,2513,10540,10887,2304,84,24008,0,0,0,0,27,329,356
2019-01-22,24,3701,5157,2349,9781,10118,2104,82,22279,0,0,0,0,28,297,325
2019-01-23,1,3666,5101,2176,9459,9361,1980,78,21067,0,0,0,0,36,263,299
2019-01-23,2,3608,5079,2134,9152,9007,1918,79,20344,0,0,0,0,36,241,277
2019-01-23,3,3584,5087,2123,8979,8843,1878,81,19970,0,0,0,0,37,207,244
2019-01-23,4,3602,5170,2153,8985,8817,1876,85,19951,0,0,0,0,35,178,213
2019-01-23,5,3691,5390,2259,9283,9140,1948,90,20650,0,0,0,0,35,162,197
2019-01-23,6,3892,5770,2515,10023,9979,2146,100,22434,0,0,0,0,34,151,185
2019-01-23,7,4105,6103,2875,11293,11114,2450,111,25155,0,16,0,16,40,144,184
2019-01-23,8,4104,6115,3055,11951,11370,2517,110,26139,117,1089,140,1346,42,135,177
2019-01-23,9,4016,6055,3016,11555,11014,2390,101,25251,540,3407,616,4563,40,114,154
2019-01-23,10,3922,5981,2944,10985,10646,2224,90,24136,888,5010,1047,6945,36,92,128
2019-01-23,11,3850,5893,2858,10473,10408,2076,82,23230,958,5521,1236,7715,34,80,114
2019-01-23,12,3775,5808,2759,10017,10094,1963,75,22339,952,5594,1304,7850,32,84,116
2019-01-23,13,3726,5766,2692,9755,9959,1919,69,21891,949,5612,1288,7849,31,101,132
2019-01-23,14,3699,5744,2640,9658,10052,1940,65,21906,957,5614,1283,7854,32,126,158
2019-01-23,15,3698,5754,2599,9853,10270,2008,63,22383,930,5235,1240,7405,32,155,187
2019-01-23,16,3756,5856,2594,10313,10571,2114,63,23250,756,3756,949,5461,29,192,221
2019-01-23,17,3963,6101,2691,11100,11033,2300,67,24689,292,1284,343,1919,24,255,279
2019-01-23,18,4307,6239,2869,12067,12136,2668,75,27133,1,24,1,26,18,334,352
2019-01-23,19,4366,6166,2894,12492,12583,2813,79,28155,0,0,0,0,19,375,394
2019-01-23,20,4331,6076,2833,12427,12399,2758,81,27852,0,0,0,0,28,339,367
2019-01-23,21,4256,5873,2755,12071,12065,2640,81,27043,0,0,0,0,39,257,296
2019-01-23,22,4092,5569,2604,11490,11529,2476,79,25763,0,0,0,0,50,196,246
2019-01-23,23,3889,5285,2416,10668,10732,2248,76,23912,0,0,0,0,52,160,212
2019-01-23,24,3723,5104,2252,9898,9959,2054,73,22173,0,0,0,0,50,132,182
2019-01-24,1,3629,5007,2171,9384,9341,1934,69,20921,0,0,0,0,96,165,261
2019-01-24,2,3563,4971,2128,9075,8992,1872,70,20203,0,0,0,0,100,122,222
2019-01-24,3,3531,4984,2117,8916,8776,1836,72,19794,0,0,0,0,105,108,213
2019-01-24,4,3540,5069,2145,8939,8787,1828,75,19823,0,0,0,0,110,117,227
2019-01-24,5,3615,5286,2252,9231,9101,1894,80,20496,0,0,0,0,106,136,242
2019-01-24,6,3789,5658,2510,9890,9898,2067,88,22133,0,0,0,0,111,168,279
2019-01-24,7,4008,5991,2878,11223,11036,2357,98,24902,0,16,0,16,124,201,325
2019-01-24,8,4005,6023,3077,11971,11475,2419,97,26151,110,1060,133,1303,130,222,352
2019-01-24,9,3938,5972,3034,11511,11182,2312,90,25285,512,3279,574,4365,131,223,354
2019-01-24,10,3869,5913,2973,10914,10753,2160,82,24099,861,4869,1001,6731,133,217,350
2019-01-24,11,3816,5839,2905,10395,10447,2040,74,23146,950,5443,1214,7607,141,225,366
2019-01-24,12,3777,5763,2813,9956,10312,1967,68,22493,948,5546,1275,7769,147,261,408
2019-01-24,13,3744,5732,2746,9770,10336,1962,64,22322,949,5577,1264,7790,134,303,437
2019-01-24,14,3729,5710,2683,9805,10480,2004,61,22541,969,5550,1272,7791,104,316,420
2019-01-24,15,3734,5721,2628,9910,10694,2113,59,22967,953,5115,1229,7297,86,298,384
2019-01-24,16,3786,5832,2600,10222,10961,2208,59,23639,795,3654,952,5401,76,270,346
2019-01-24,17,3975,6056,2685,10960,11375,2381,62,24967,317,1249,354,1920,74,251,325
2019-01-24,18,4292,6182,2868,12152,12269,2672,69,27350,0,20,1,21,77,250,327
2019-01-24,19,4339,6113,2907,12593,12523,2731,72,28106,0,0,0,0,81,261,342
2019-01-24,20,4295,6022,2866,12381,12303,2678,73,27622,0,0,0,0,78,263,341
2019-01-24,21,4209,5811,2793,12089,11951,2572,73,26872,0,0,0,0,68,251,319
2019-01-24,22,4043,5518,2637,11545,11337,2412,71,25552,0,0,0,0,62,237,299
2019-01-24,23,3849,5242,2450,10677,10513,2192,68,23640,0,0,0,0,62,224,286
2019-01-24,24,3681,5075,2299,10046,9743,1998,66,22046,0,0,0,0,65,213,278
2019-01-25,1,3596,5003,2197,9506,9280,1917,68,20965,0,0,0,0,60,258,318
2019-01-25,2,3532,4965,2160,9170,8920,1855,70,20210,0,0,0,0,53,253,306
2019-01-25,3,3500,4978,2152,8993,8715,1809,72,19782,0,0,0,0,56,247,303
2019-01-25,4,3514,5063,2186,8979,8675,1800,75,19721,0,0,0,0,79,239,318
2019-01-25,5,3596,5268,2295,9279,8940,1854,81,20344,0,0,0,0,141,225,366
2019-01-25,6,3767,5620,2544,9972,9660,2013,90,21922,0,0,0,0,211,205,416
2019-01-25,7,3986,5946,2909,11152,10741,2285,98,24465,0,19,0,19,229,187,416
2019-01-25,8,3990,5997,3103,11985,11021,2355,100,25652,105,1146,153,1404,210,167,377
2019-01-25,9,3936,5964,3056,11692,10757,2248,89,24977,495,3564,656,4715,167,150,317
2019-01-25,10,3873,5914,2977,10855,10503,2115,80,23744,847,5233,1103,7183,107,136,243
2019-01-25,11,3809,5843,2885,10352,10273,2005,71,22892,953,5726,1292,7971,75,122,197
2019-01-25,12,3750,5762,2762,9959,10115,1938,65,22266,960,5768,1355,8083,69,112,181
2019-01-25,13,3702,5719,2672,9692,10045,1930,61,21917,965,5767,1365,8097,66,103,169
2019-01-25,14,3673,5688,2593,9645,10156,1972,58,22022,994,5759,1365,8118,57,86,143
2019-01-25,15,3663,5687,2523,9759,10300,2033,56,22338,980,5404,1284,7668,49,75,124
2019-01-25,16,3701,5769,2492,10027,10512,2131,56,22915,822,3971,988,5781,48,80,128
2019-01-25,17,3872,5976,2580,10571,10938,2307,59,24065,334,1402,374,2110,53,90,143
2019-01-25,18,4190,6092,2743,11452,11765,2575,66,26048,1,31,3,35,61,92,153
2019-01-25,19,4231,5996,2770,12168,11961,2632,70,27018,0,0,0,0,68,92,160
2019-01-25,20,4187,5876,2722,12050,11746,2569,71,26623,0,0,0,0,73,94,167
2019-01-25,21,4115,5692,2652,11709,11419,2482,71,25869,0,0,0,0,73,101,174
2019-01-25,22,3993,5472,2527,11211,10972,2354,71,24794,0,0,0,0,73,110,183
2019-01-25,23,3849,5253,2382,10590,10338,2185,68,23375,0,0,0,0,73,119,192
2019-01-25,24,3699,5085,2252,9901,9690,2015,67,21866,0,0,0,0,75,131,206
2019-01-26,1,3586,4940,2136,9343,9214,1907,67,20722,0,0,0,0,86,188,274
2019-01-26,2,3504,4893,2091,8968,8816,1836,69,19881,0,0,0,0,82,185,267
2019-01-26,3,3464,4898,2081,8734,8548,1794,70,19338,0,0,0,0,75,194,269
2019-01-26,4,3452,4937,2099,8633,8431,1777,72,19106,0,0,0,0,81,219,300
2019-01-26,5,3478,5038,2161,8702,8491,1798,77,19260,0,0,0,0,86,241,327
2019-01-26,6,3556,5185,2283,9025,8799,1856,83,19953,0,0,0,0,91,284,375
2019-01-26,7,3651,5367,2439,9519,9264,1973,90,21036,0,19,0,19,98,327,425
2019-01-26,8,3632,5488,2614,9853,9347,1986,93,21471,77,1148,130,1355,97,344,441
2019-01-26,9,3655,5559,2729,9843,9294,1958,85,21371,349,3421,552,4322,97,347,444
2019-01-26,10,3652,5560,2741,9555,9080,1870,76,20770,653,5002,961,6616,82,361,443
2019-01-26,11,3620,5512,2678,9220,8980,1774,66,20229,811,5597,1179,7587,61,386,447
2019-01-26,12,3578,5437,2563,8970,8845,1704,61,19768,832,5675,1264,7771,51,410,461
2019-01-26,13,3535,5371,2454,8739,8834,1684,57,19504,837,5658,1289,7784,42,415,457
2019-01-26,14,3513,5326,2356,8746,8919,1703,55,19612,840,5543,1268,7651,36,383,419
2019-01-26,15,3514,5347,2283,8902,9122,1781,53,20046,788,4981,1148,6917,31,316,347
2019-01-26,16,3554,5428,2286,9281,9453,1990,54,20968,608,3488,845,4941,29,247,276
2019-01-26,17,3734,5689,2368,9913,9993,2192,58,22344,231,1167,312,1710,27,210,237
2019-01-26,18,4055,5848,2536,11012,10940,2469,65,24679,2,22,3,27,23,194,217
2019-01-26,19,4090,5805,2570,11679,11283,2526,66,25747,0,0,0,0,20,189,209
2019-01-26,20,4035,5730,2528,11562,11059,2472,67,25352,0,0,0,0,19,188,207
2019-01-26,21,3967,5595,2473,11239,10736,2390,68,24623,0,0,0,0,19,189,208
2019-01-26,22,3859,5391,2375,10766,10317,2271,67,23612,0,0,0,0,19,188,207
2019-01-26,23,3741,5169,2252,10164,9768,2110,65,22298,0,0,0,0,19,184,203
2019-01-26,24,3605,4999,2134,9531,9151,1947,63,20882,0,0,0,0,20,179,199
2019-01-27,1,3502,4864,2035,8985,8584,1871,61,19693,0,0,0,0,12,178,190
2019-01-27,2,3427,4822,1992,8618,8217,1800,63,18891,0,0,0,0,12,156,168
2019-01-27,3,3386,4819,1982,8407,7968,1749,65,18384,0,0,0,0,14,142,156
2019-01-27,4,3376,4850,2000,8284,7833,1718,68,18094,0,0,0,0,19,131,150
2019-01-27,5,3406,4917,2060,8344,7853,1727,72,18189,0,0,0,0,23,119,142
2019-01-27,6,3479,5032,2157,8572,8038,1768,78,18655,0,0,0,0,26,105,131
2019-01-27,7,3534,5186,2298,9008,8316,1849,86,19457,0,20,0,20,27,90,117
2019-01-27,8,3513,5308,2458,9243,8267,1863,88,19653,92,967,129,1188,28,78,106
2019-01-27,9,3537,5304,2577,9188,8261,1844,80,19567,408,3048,548,4004,32,65,97
2019-01-27,10,3548,5275,2604,8960,8159,1792,72,19175,735,4746,948,6429,38,53,91
2019-01-27,11,3532,5212,2538,8689,8074,1718,65,18736,889,5460,1168,7517,34,43,77
2019-01-27,12,3497,5197,2445,8386,8062,1674,60,18374,903,5563,1258,7724,26,42,68
2019-01-27,13,3468,5131,2370,8274,8177,1684,58,18385,902,5570,1292,7764,20,45,65
2019-01-27,14,3464,5139,2282,8342,8367,1711,56,18667,909,5492,1284,7685,16,48,64
2019-01-27,15,3485,5182,2223,8558,8671,1791,54,19265,869,5005,1153,7027,16,56,72
2019-01-27,16,3539,5313,2227,9060,9057,1918,54,20279,714,3580,860,5154,19,78,97
2019-01-27,17,3716,5576,2322,9681,9628,2102,58,21660,300,1243,330,1873,23,104,127
2019-01-27,18,4017,5751,2520,10934,10675,2419,65,24285,4,28,8,40,29,145,174
2019-01-27,19,4067,5719,2585,11649,11046,2554,65,25507,0,0,0,0,43,188,231
2019-01-27,20,4023,5648,2563,11530,10881,2529,64,25194,0,0,0,0,64,189,253
2019-01-27,21,3960,5493,2506,11154,10593,2409,64,24411,0,0,0,0,97,164,261
2019-01-27,22,3819,5255,2380,10569,10112,2256,63,23194,0,0,0,0,146,142,288
2019-01-27,23,3673,5029,2221,9868,9481,2069,60,21670,0,0,0,0,171,127,298
2019-01-27,24,3516,4900,2088,9228,8877,1914,58,20268,0,0,0,0,175,113,288
2019-01-28,1,3412,4808,2070,8721,8292,1819,54,19078,0,0,0,0,177,89,266
2019-01-28,2,3345,4796,2043,8437,8021,1770,55,18477,0,0,0,0,140,82,222
2019-01-28,3,3317,4830,2044,8290,7894,1735,57,18173,0,0,0,0,108,78,186
2019-01-28,4,3327,4938,2088,8304,7916,1723,60,18197,0,0,0,0,88,72,160
2019-01-28,5,3408,5171,2212,8609,8238,1778,65,18882,0,0,0,0,77,56,133
2019-01-28,6,3589,5567,2477,9350,9005,1941,73,20559,0,0,0,0,76,47,123
2019-01-28,7,3810,5919,2843,10847,10146,2201,82,23466,0,21,0,21,77,47,124
2019-01-28,8,3838,5965,3062,11692,10456,2285,83,24710,64,850,90,1004,73,47,120
2019-01-28,9,3812,5939,3035,11435,10337,2226,75,24265,271,2661,386,3318,69,52,121
2019-01-28,10,3777,5903,2990,11004,10194,2130,69,23590,420,4069,655,5144,66,59,125
2019-01-28,11,3745,5851,2942,10642,10113,2041,63,23054,457,4663,783,5903,62,65,127
2019-01-28,12,3708,5792,2864,10301,10067,1990,60,22609,481,4771,840,6092,59,70,129
2019-01-28,13,3690,5762,2807,10047,10075,2007,57,22380,502,4611,848,5961,52,72,124
2019-01-28,14,3671,5731,2745,10036,10278,2031,55,22597,501,4123,843,5467,42,78,120
2019-01-28,15,3683,5737,2695,10137,10525,2060,54,22967,451,3357,760,4568,36,89,125
2019-01-28,16,3716,5826,2676,10493,10740,2152,55,23630,362,2142,555,3059,37,92,129
2019-01-28,17,3869,6051,2762,10951,11192,2312,58,24703,168,665,228,1061,35,87,122
2019-01-28,18,4143,6201,2927,12022,12037,2586,64,26900,10,7,12,29,30,93,123
2019-01-28,19,4203,6136,2981,12670,12267,2716,65,27909,0,0,0,0,25,103,128
2019-01-28,20,4155,6035,2931,12453,11971,2664,62,27341,0,0,0,0,24,106,130
2019-01-28,21,4060,5819,2842,11958,11537,2534,59,26283,0,0,0,0,26,104,130
2019-01-28,22,3886,5504,2675,11236,10900,2353,56,24736,0,0,0,0,33,104,137
2019-01-28,23,3694,5226,2476,10376,10065,2127,53,22813,0,0,0,0,32,110,142
2019-01-28,24,3519,5074,2314,9583,9325,1946,51,21096,0,0,0,0,35,123,158
2019-01-29,1,3410,5028,2241,9011,8887,1870,54,20015,0,0,0,0,52,65,117
2019-01-29,2,3340,5008,2205,8694,8519,1811,55,19271,0,0,0,0,69,57,126
2019-01-29,3,3307,5029,2201,8529,8325,1766,57,18869,0,0,0,0,92,49,141
2019-01-29,4,3316,5122,2235,8513,8288,1753,59,18805,0,0,0,0,118,46,164
2019-01-29,5,3391,5355,2350,8770,8570,1804,64,19399,0,0,0,0,119,52,171
2019-01-29,6,3573,5746,2619,9461,9294,1968,71,20987,0,0,0,0,104,63,167
2019-01-29,7,3780,6073,2995,10635,10400,2250,80,23556,0,10,0,10,98,75,173
2019-01-29,8,3804,6092,3186,11453,10772,2337,82,24837,70,624,121,815,90,89,179
2019-01-29,9,3774,6027,3125,11253,10667,2260,75,24447,311,2028,527,2866,96,100,196
2019-01-29,10,3733,5956,3047,10916,10538,2156,68,23870,507,3333,919,4759,101,113,214
2019-01-29,11,3709,5875,2955,10623,10432,2057,63,23367,579,4138,1109,5826,95,151,246
2019-01-29,12,3673,5788,2861,10371,10318,1994,59,22937,605,4375,1164,6144,81,219,300
2019-01-29,13,3644,5749,2793,10153,10333,1970,57,22706,625,4390,1135,6150,70,311,381
2019-01-29,14,3632,5711,2732,10160,10491,2015,55,22918,651,4304,1042,5997,59,442,501
2019-01-29,15,3646,5710,2668,10276,10713,2076,54,23314,620,3860,887,5367,51,622,673
2019-01-29,16,3693,5809,2653,10539,10943,2186,54,23914,515,2624,632,3771,56,822,878
2019-01-29,17,3850,6041,2752,11015,11282,2339,58,24884,239,869,256,1364,77,997,1074
2019-01-29,18,4125,6214,2919,11993,12042,2577,64,26868,15,9,16,40,129,1102,1231
2019-01-29,19,4189,6160,2983,12616,12329,2695,65,27897,0,0,0,0,190,1114,1304
2019-01-29,20,4138,6060,2955,12426,12138,2650,63,27472,0,0,0,0,234,1049,1283
2019-01-29,21,4045,5847,2863,11924,11749,2523,61,26450,0,0,0,0,254,944,1198
2019-01-29,22,3875,5538,2704,11206,11121,2345,58,24922,0,0,0,0,259,790,1049
2019-01-29,23,3691,5267,2507,10343,10283,2121,54,22995,0,0,0,0,256,599,855
2019-01-29,24,3515,5113,2348,9606,9515,1939,53,21305,0,0,0,0,274,440,714
2019-01-30,1,3412,5012,2267,9114,8926,1899,51,20182,0,0,0,0,215,95,310
2019-01-30,2,3347,4995,2233,8802,8563,1831,52,19440,0,0,0,0,172,76,248
2019-01-30,3,3314,5016,2235,8634,8360,1794,54,19034,0,0,0,0,127,76,203
2019-01-30,4,3325,5112,2271,8622,8309,1784,56,18962,0,0,0,0,94,78,172
2019-01-30,5,3404,5337,2389,8898,8583,1846,61,19579,0,0,0,0,75,75,150
2019-01-30,6,3589,5722,2658,9617,9306,2007,69,21189,0,0,0,0,61,79,140
2019-01-30,7,3814,6042,3037,10762,10426,2295,78,23752,0,21,0,21,60,88,148
2019-01-30,8,3815,6054,3225,11470,10821,2367,80,24934,78,990,123,1191,59,89,148
2019-01-30,9,3768,5982,3164,11346,10847,2277,73,24735,347,3068,516,3931,48,81,129
2019-01-30,10,3720,5898,3074,11062,10762,2152,66,24233,630,4682,921,6233,34,76,110
2019-01-30,11,3687,5804,2982,10783,10677,2058,61,23770,784,5383,1163,7330,22,71,93
2019-01-30,12,3641,5704,2866,10394,10656,1996,58,23295,831,5492,1263,7586,17,66,83
2019-01-30,13,3610,5654,2787,10137,10571,1976,56,22930,872,5484,1302,7658,16,62,78
2019-01-30,14,3593,5614,2718,10122,10583,2009,54,22960,934,5320,1321,7575,18,57,75
2019-01-30,15,3601,5615,2673,10202,10690,2058,54,23194,930,4790,1222,6942,22,48,70
2019-01-30,16,3648,5698,2642,10634,10901,2201,54,23981,771,3418,882,5071,23,40,63
2019-01-30,17,3808,5932,2748,11266,11225,2407,57,25145,338,1199,332,1869,25,35,60
2019-01-30,18,4093,6109,2914,12192,11974,2691,63,27111,16,17,15,48,31,40,71
2019-01-30,19,4163,6063,2976,12710,12351,2728,64,28046,0,0,0,0,37,52,89
2019-01-30,20,4123,5972,2934,12519,12159,2672,62,27605,0,0,0,0,41,61,102
2019-01-30,21,4038,5767,2858,12025,11769,2578,61,26624,0,0,0,0,47,66,113
2019-01-30,22,3876,5471,2705,11322,11142,2413,59,25127,0,0,0,0,79,69,148
2019-01-30,23,3691,5201,2511,10391,10319,2202,56,23161,0,0,0,0,80,76,156
2019-01-30,24,3523,5046,2351,9620,9563,1999,55,21429,0,0,0,0,81,90,171
2019-01-31,1,3387,4973,2214,9110,9160,1907,57,20429,0,0,0,0,132,128,260
2019-01-31,2,3324,4949,2177,8762,8845,1848,58,19708,0,0,0,0,103,171,274
2019-01-31,3,3293,4975,2174,8581,8601,1804,60,19241,0,0,0,0,81,220,301
2019-01-31,4,3312,5065,2208,8548,8538,1786,62,19127,0,0,0,0,68,260,328
2019-01-31,5,3397,5290,2327,8790,8776,1856,66,19681,0,0,0,0,60,271,331
2019-01-31,6,3580,5672,2589,9493,9491,2017,74,21267,0,0,0,0,56,266,322
2019-01-31,7,3796,5987,2962,10674,10551,2303,82,23803,0,23,0,23,60,252,312
2019-01-31,8,3817,6001,3146,11552,11234,2416,85,25483,36,763,24,823,52,210,262
2019-01-31,9,3777,5931,3090,11429,11431,2407,78,25544,164,2330,140,2634,40,167,207
2019-01-31,10,3733,5853,3008,11214,11565,2349,72,25394,350,3452,319,4121,31,170,201
2019-01-31,11,3699,5759,2912,10978,11573,2302,66,25114,555,3832,516,4903,34,205,239
2019-01-31,12,3663,5664,2794,10767,11360,2314,62,24702,671,3920,650,5241,47,260,307
2019-01-31,13,3638,5613,2714,10632,11267,2331,59,24486,714,3853,732,5299,71,313,384
2019-01-31,14,3629,5583,2647,10657,11272,2341,58,24523,768,3501,855,5124,68,362,430
2019-01-31,15,3642,5579,2585,10663,11364,2351,57,24628,766,3043,847,4656,66,416,482
2019-01-31,16,3690,5670,2548,10840,11399,2378,57,24871,641,2079,634,3354,67,499,566
2019-01-31,17,3836,5879,2639,11271,11637,2488,60,25646,293,691,275,1259,71,516,587
2019-01-31,18,4118,6048,2793,12153,12462,2709,66,27580,23,22,27,72,86,446,532
2019-01-31,19,4176,6000,2852,12567,12620,2761,70,28209,0,0,0,0,115,398,513
2019-01-31,20,4129,5906,2815,12324,12441,2696,70,27720,0,0,0,0,133,323,456
2019-01-31,21,4041,5709,2747,11909,12127,2610,68,26904,0,0,0,0,147,232,379
2019-01-31,22,3879,5425,2597,11254,11522,2446,65,25477,0,0,0,0,168,198,366
2019-01-31,23,3703,5162,2410,10399,10658,2229,62,23540,0,0,0,0,176,210,386
2019-01-31,24,3535,5007,2253,9642,9816,2023,60,21733,0,0,0,0,168,239,407
2019-02-01,1,3426,4952,2181,9192,9256,1917,60,20617,0,0,0,0,276,141,417
2019-02-01,2,3357,4929,2130,8837,8866,1838,61,19795,0,0,0,0,204,163,367
2019-02-01,3,3322,4941,2113,8654,8643,1786,63,19340,0,0,0,0,160,167,327
2019-02-01,4,3326,5029,2134,8623,8597,1772,67,19252,0,0,0,0,128,149,277
2019-02-01,5,3406,5235,2228,8881,8811,1835,72,19792,0,0,0,0,119,140,259
2019-02-01,6,3567,5591,2457,9516,9472,1979,81,21241,0,0,0,0,128,149,277
2019-02-01,7,3785,5902,2794,10631,10567,2208,88,23686,0,25,0,25,146,123,269
2019-02-01,8,3785,5930,2987,11606,11016,2290,87,25189,52,1001,86,1139,148,90,238
2019-02-01,9,3741,5868,2956,11655,11069,2264,80,25258,228,3008,354,3590,137,85,222
2019-02-01,10,3699,5794,2902,11578,10972,2186,71,24997,394,4533,634,5561,131,94,225
2019-02-01,11,3663,5701,2849,11310,10906,2135,64,24605,490,5128,818,6436,143,97,240
2019-02-01,12,3628,5596,2774,11019,10774,2088,59,24128,546,5174,898,6618,156,92,248
2019-02-01,13,3596,5537,2722,10843,10679,2039,56,23807,527,4887,840,6254,179,95,274
2019-02-01,14,3578,5494,2668,10751,10652,2050,54,23690,412,4258,667,5337,205,112,317
2019-02-01,15,3580,5479,2613,10763,10665,2100,52,23762,286,3441,499,4226,249,165,414
2019-02-01,16,3603,5510,2609,10811,10718,2188,51,23954,173,2163,289,2625,320,251,571
2019-02-01,17,3694,5632,2652,11194,11000,2401,53,24833,60,647,97,804,437,339,776
2019-02-01,18,3977,5834,2752,11972,11861,2655,59,26734,8,15,11,34,585,424,1009
2019-02-01,19,4079,5798,2777,12159,12280,2686,61,27374,0,0,0,0,774,496,1270
2019-02-01,20,4026,5709,2697,11885,12103,2631,60,26871,0,0,0,0,941,548,1489
2019-02-01,21,3953,5558,2608,11541,11803,2546,60,26140,0,0,0,0,1033,609,1642
2019-02-01,22,3829,5353,2494,11061,11318,2429,59,25058,0,0,0,0,1082,667,1749
2019-02-01,23,3686,5132,2348,10368,10624,2251,56,23492,0,0,0,0,1094,709,1803
2019-02-01,24,3538,4949,2205,9677,9901,2085,55,21911,0,0,0,0,1077,735,1812
2019-02-02,1,3443,4785,2058,9319,9289,1949,55,20854,0,0,0,0,999,797,1796
2019-02-02,2,3354,4745,2001,8919,8840,1867,56,19911,0,0,0,0,1033,585,1618
2019-02-02,3,3302,4737,1976,8705,8548,1798,58,19351,0,0,0,0,1063,355,1418
2019-02-02,4,3279,4780,1988,8605,8315,1775,61,18995,0,0,0,0,1078,239,1317
2019-02-02,5,3298,4869,2041,8668,8359,1791,64,19122,0,0,0,0,1076,230,1306
2019-02-02,6,3365,5010,2157,8938,8603,1845,69,19701,0,0,0,0,1052,298,1350
2019-02-02,7,3446,5178,2323,9463,9116,1947,75,20855,0,6,0,6,1012,395,1407
2019-02-02,8,3428,5275,2502,9929,9521,2104,77,21872,17,356,32,405,944,463,1407
2019-02-02,9,3496,5331,2617,10338,9828,2205,73,22638,84,1096,171,1351,765,499,1264
2019-02-02,10,3545,5314,2638,10581,10070,2257,68,23172,203,1655,346,2204,568,542,1110
2019-02-02,11,3572,5250,2601,10555,10120,2258,62,23194,360,2096,509,2965,469,641,1110
2019-02-02,12,3571,5163,2519,10469,10030,2228,58,22982,459,2439,605,3503,470,795,1265
2019-02-02,13,3562,5095,2442,10357,9926,2186,56,22723,547,2397,645,3589,482,932,1414
2019-02-02,14,3549,5043,2363,10303,9834,2150,54,22544,673,2214,759,3646,473,1026,1499
2019-02-02,15,3563,5042,2310,10311,9842,2113,53,22527,703,2039,781,3523,444,1114,1558
2019-02-02,16,3626,5127,2297,10414,9763,2133,54,22577,587,1493,631,2711,398,1175,1573
2019-02-02,17,3733,5286,2363,10712,10015,2307,57,23326,275,593,306,1174,346,1130,1476
2019-02-02,18,4030,5503,2491,11454,10773,2537,62,25077,26,31,37,94,337,1068,1405
2019-02-02,19,4104,5518,2533,11850,11310,2623,65,26102,0,0,0,0,371,1077,1448
2019-02-02,20,4019,5465,2488,11725,11234,2573,65,25845,0,0,0,0,459,1087,1546
2019-02-02,21,3938,5337,2426,11333,11016,2504,65,25164,0,0,0,0,572,1121,1693
2019-02-02,22,3818,5149,2333,10875,10671,2406,63,24257,0,0,0,0,671,1222,1893
2019-02-02,23,3688,4937,2205,10238,10126,2243,61,22899,0,0,0,0,764,1366,2130
2019-02-02,24,3552,4757,2091,9574,9512,2067,59,21455,0,0,0,0,833,1530,2363
2019-02-03,1,3510,4638,2032,9110,8970,1921,61,20246,0,0,0,0,1021,1552,2573
2019-02-03,2,3439,4591,1988,8727,8616,1836,63,19424,0,0,0,0,973,1645,2618
2019-02-03,3,3386,4574,1970,8424,8374,1774,65,18819,0,0,0,0,905,1644,2549
2019-02-03,4,3364,4603,1981,8346,8215,1754,68,18567,0,0,0,0,804,1547,2351
2019-02-03,5,3388,4669,2033,8389,8216,1759,70,18610,0,0,0,0,649,1380,2029
2019-02-03,6,3450,4777,2126,8593,8372,1789,75,19003,0,0,0,0,435,1172,1607
2019-02-03,7,3511,4925,2273,8907,8751,1881,81,19791,0,26,0,26,307,1003,1310
2019-02-03,8,3485,5035,2448,9270,8905,1939,82,20436,84,820,71,975,265,930,1195
2019-02-03,9,3510,5045,2568,9660,9181,1954,78,21091,354,2391,305,3050,257,964,1221
2019-02-03,10,3541,5049,2621,9767,9160,1968,72,21176,536,3617,562,4715,270,1090,1360
2019-02-03,11,3540,5006,2612,9701,9150,1984,66,21114,568,4259,739,5566,333,1253,1586
2019-02-03,12,3512,5017,2558,9678,9132,1948,61,21019,598,4498,838,5934,414,1418,1832
2019-02-03,13,3496,4980,2516,9590,9113,1983,58,20947,623,4521,806,5950,511,1547,2058
2019-02-03,14,3500,4993,2469,9704,8980,2007,57,20941,630,4408,741,5779,664,1552,2216
2019-02-03,15,3527,5035,2431,9837,8938,2039,55,21059,589,4007,636,5232,810,1444,2254
2019-02-03,16,3587,5137,2431,10042,8986,2118,56,21389,461,2882,457,3800,913,1317,2230
2019-02-03,17,3703,5304,2497,10518,9390,2266,59,22419,216,1047,197,1460,889,1232,2121
2019-02-03,18,4007,5523,2652,11216,10470,2547,65,24483,29,40,28,97,757,1161,1918
2019-02-03,19,4121,5533,2709,11731,11114,2624,68,25721,0,0,0,0,564,1087,1651
2019-02-03,20,4084,5481,2669,11766,11095,2591,68,25702,0,0,0,0,398,1038,1436
2019-02-03,21,4028,5343,2594,11493,10824,2511,68,25077,0,0,0,0,308,1021,1329
2019-02-03,22,3889,5115,2464,10963,10383,2376,66,23970,0,0,0,0,295,1051,1346
2019-02-03,23,3727,4881,2295,10184,9704,2181,63,22315,0,0,0,0,322,1100,1422
2019-02-03,24,3562,4731,2165,9481,9083,1990,61,20798,0,0,0,0,363,1161,1524
2019-02-04,1,3484,4643,2203,9014,8991,1923,63,20156,0,0,0,0,514,1213,1727
2019-02-04,2,3416,4624,2186,8705,8710,1849,64,19490,0,0,0,0,545,1192,1737
2019-02-04,3,3379,4646,2187,8544,8502,1798,66,19078,0,0,0,0,601,1180,1781
2019-02-04,4,3388,4750,2233,8552,8480,1786,68,19055,0,0,0,0,644,1167,1811
2019-02-04,5,3460,4972,2357,8870,8768,1852,73,19731,0,0,0,0,591,1149,1740
2019-02-04,6,3635,5362,2621,9546,9497,2012,80,21307,0,0,0,0,517,1175,1692
2019-02-04,7,3850,5699,3000,10731,10638,2291,89,23916,0,28,0,28,519,1221,1740
2019-02-04,8,3874,5764,3228,11803,11277,2450,89,25783,100,682,85,867,578,1264,1842
2019-02-04,9,3859,5764,3197,11931,11564,2484,85,26230,420,1957,368,2745,611,1376,1987
2019-02-04,10,3843,5750,3151,11774,11615,2447,80,26085,654,3108,696,4458,600,1487,2087
2019-02-04,11,3835,5714,3110,11521,11593,2368,75,25723,686,3645,897,5228,579,1525,2104
2019-02-04,12,3819,5673,3038,11316,11553,2280,71,25386,693,3844,974,5511,610,1533,2143
2019-02-04,13,3797,5662,3000,11211,11484,2303,68,25232,703,3858,965,5526,657,1530,2187
2019-02-04,14,3773,5637,2952,11163,11479,2358,66,25231,712,3670,941,5323,668,1553,2221
2019-02-04,15,3775,5643,2916,11130,11398,2377,64,25139,676,3342,862,4880,676,1578,2254
2019-02-04,16,3815,5695,2921,11303,11357,2429,64,25320,524,2477,661,3662,634,1578,2212
2019-02-04,17,3934,5806,2993,11645,11546,2514,68,25938,240,1001,302,1543,560,1530,2090
2019-02-04,18,4233,6007,3143,12474,12193,2745,76,27653,29,47,37,113,484,1439,1923
2019-02-04,19,4385,5982,3210,13075,12566,2842,79,28727,0,0,0,0,412,1347,1759
2019-02-04,20,4357,5889,3154,12969,12464,2800,78,28478,0,0,0,0,363,1281,1644
2019-02-04,21,4252,5687,3051,12610,12131,2695,77,27679,0,0,0,0,331,1265,1596
2019-02-04,22,4071,5381,2874,11965,11585,2517,74,26306,0,0,0,0,315,1292,1607
2019-02-04,23,3853,5091,2665,11068,10813,2275,70,24392,0,0,0,0,304,1333,1637
2019-02-04,24,3671,4907,2504,10229,10052,2065,68,22579,0,0,0,0,313,1375,1688
2019-02-05,1,3569,4816,2451,9735,9887,1955,69,21802,0,0,0,0,468,1608,2076
2019-02-05,2,3495,4778,2429,9392,9559,1890,70,21065,0,0,0,0,457,1584,2041
2019-02-05,3,3464,4783,2432,9211,9295,1838,71,20570,0,0,0,0,456,1507,1963
2019-02-05,4,3472,4869,2478,9219,9254,1828,74,20530,0,0,0,0,455,1437,1892
2019-02-05,5,3547,5087,2607,9531,9510,1883,78,21158,0,0,0,0,416,1383,1799
2019-02-05,6,3726,5467,2896,10268,10239,2050,85,22802,0,0,0,0,364,1349,1713
2019-02-05,7,3942,5789,3296,11552,11339,2314,93,25453,0,29,0,29,294,1329,1623
2019-02-05,8,3950,5831,3505,12266,12009,2478,95,27006,99,730,113,942,215,1356,1571
2019-02-05,9,3909,5814,3425,11963,12345,2451,90,27015,387,2123,441,2951,128,1503,1631
2019-02-05,10,3867,5790,3318,11635,12217,2426,84,26532,603,3202,759,4564,113,1775,1888
2019-02-05,11,3848,5759,3218,11181,12093,2382,80,25904,663,3671,930,5264,127,2036,2163
2019-02-05,12,3830,5719,3102,10836,12026,2324,76,25430,682,3851,1005,5538,134,2217,2351
2019-02-05,13,3811,5714,3030,10573,12107,2323,73,25245,711,3864,1024,5599,139,2350,2489
2019-02-05,14,3803,5693,2968,10521,12051,2338,71,25148,753,3783,1020,5556,136,2418,2554
2019-02-05,15,3812,5709,2925,10570,12001,2342,72,25154,748,3450,961,5159,124,2399,2523
2019-02-05,16,3876,5780,2924,10895,11806,2342,75,25288,654,2580,773,4007,94,2329,2423
2019-02-05,17,4017,5893,3000,11504,12185,2501,80,26438,341,1036,385,1762,61,2238,2299
2019-02-05,18,4326,6089,3158,12376,12828,2777,84,28236,46,53,58,157,48,2186,2234
2019-02-05,19,4471,6077,3242,13095,13518,2953,87,29820,0,0,0,0,59,2192,2251
2019-02-05,20,4435,5981,3208,13043,13478,2911,85,29687,0,0,0,0,79,2222,2301
2019-02-05,21,4343,5777,3124,12685,13211,2770,84,28920,0,0,0,0,100,2266,2366
2019-02-05,22,4163,5474,2955,12102,12687,2575,81,27607,0,0,0,0,124,2349,2473
2019-02-05,23,3924,5198,2755,11259,11819,2325,78,25641,0,0,0,0,124,2486,2610
2019-02-05,24,3741,5035,2599,10464,10917,2117,76,23733,0,0,0,0,121,2642,2763
2019-02-06,1,3646,5010,2556,10192,10054,2002,81,22484,0,0,0,0,218,2809,3027
2019-02-06,2,3586,4987,2527,9902,9685,1936,82,21760,0,0,0,0,206,2858,3064
2019-02-06,3,3566,4991,2531,9722,9496,1889,84,21347,0,0,0,0,170,2781,2951
2019-02-06,4,3588,5082,2579,9718,9498,1886,87,21345,0,0,0,0,131,2648,2779
2019-02-06,5,3680,5313,2709,10054,9793,1951,94,22047,0,0,0,0,101,2486,2587
2019-02-06,6,3880,5692,3005,10822,10607,2142,103,23829,0,0,0,0,94,2293,2387
2019-02-06,7,4100,6009,3402,12094,11810,2452,112,26623,0,51,0,51,104,2090,2194
2019-02-06,8,4085,6039,3591,12608,12104,2547,113,27528,165,1457,195,1817,93,1964,2057
2019-02-06,9,3997,5998,3506,12225,11890,2466,104,26840,635,4004,708,5347,63,1983,2046
2019-02-06,10,3909,5961,3390,11788,11582,2321,94,25940,993,5592,1143,7728,40,2092,2132
2019-02-06,11,3848,5917,3287,11303,11195,2160,87,24901,1072,6089,1325,8486,31,2218,2249
2019-02-06,12,3792,5853,3157,10852,10831,2071,82,23990,1055,6150,1372,8577,27,2301,2328
2019-02-06,13,3753,5838,3082,10629,10614,2023,78,23499,1034,6130,1365,8529,21,2328,2349
2019-02-06,14,3728,5810,3014,10649,10513,2005,75,23397,1034,6110,1325,8469,19,2308,2327
2019-02-06,15,3719,5825,2975,10699,10352,2052,74,23332,1017,5833,1240,8090,20,2216,2236
2019-02-06,16,3780,5903,2971,11017,10496,2167,72,23907,903,4571,1010,6484,23,2060,2083
2019-02-06,17,3943,6036,3041,11668,11060,2336,79,25299,475,1922,495,2892,23,1875,1898
2019-02-06,18,4280,6238,3207,12908,12136,2685,86,27970,63,121,69,253,22,1723,1745
2019-02-06,19,4437,6237,3304,13789,12945,2930,90,29910,0,0,0,0,22,1628,1650
2019-02-06,20,4419,6139,3280,13724,12935,2905,90,29811,0,0,0,0,21,1572,1593
2019-02-06,21,4348,5929,3204,13293,12729,2791,90,29058,0,0,0,0,20,1503,1523
2019-02-06,22,4187,5627,3039,12576,12170,2624,87,27612,0,0,0,0,20,1357,1377
2019-02-06,23,3954,5349,2833,11627,11379,2379,85,25626,0,0,0,0,20,1090,1110
2019-02-06,24,3788,5195,2682,10757,10510,2166,83,23671,0,0,0,0,20,754,774
2019-02-07,1,3773,5155,2631,10065,10223,2037,87,22567,0,0,0,0,50,306,356
2019-02-07,2,3721,5138,2617,9752,9836,1974,88,21806,0,0,0,0,48,161,209
2019-02-07,3,3699,5151,2629,9570,9614,1951,91,21381,0,0,0,0,42,134,176
2019-02-07,4,3718,5246,2682,9574,9572,1938,94,21333,0,0,0,0,36,158,194
2019-02-07,5,3811,5473,2820,9887,9868,2015,101,22026,0,0,0,0,42,195,237
2019-02-07,6,4014,5859,3116,10647,10645,2212,110,23771,0,0,0,0,49,232,281
2019-02-07,7,4220,6166,3494,11896,11743,2520,119,26422,0,57,0,57,52,258,310
2019-02-07,8,4192,6182,3677,12483,12033,2586,119,27377,184,1570,217,1971,44,270,314
2019-02-07,9,4099,6125,3590,12050,11838,2444,108,26596,656,4280,776,5712,28,281,309
2019-02-07,10,4011,6052,3463,11448,11472,2243,97,25417,996,5838,1202,8036,23,295,318
2019-02-07,11,3945,5959,3347,10832,11070,2066,87,24211,1079,6230,1362,8671,23,299,322
2019-02-07,12,3882,5862,3196,10386,10805,1934,80,23362,1062,6266,1400,8728,28,291,319
2019-02-07,13,3833,5826,3107,10166,10650,1865,76,22913,1035,6249,1399,8683,30,274,304
2019-02-07,14,3800,5793,3032,10153,10630,1851,72,22861,1017,6229,1392,8638,31,239,270
2019-02-07,15,3776,5803,2974,10288,10659,1920,70,23092,977,5884,1323,8184,34,194,228
2019-02-07,16,3816,5875,2954,10526,10819,2102,69,23671,835,4625,1054,6514,38,156,194
2019-02-07,17,3986,6009,3024,11169,11234,2345,75,24978,427,1942,496,2865,39,135,174
2019-02-07,18,4320,6239,3169,12318,12400,2678,82,27633,60,129,66,255,40,130,170
2019-02-07,19,4479,6254,3265,13239,13220,2826,86,29527,0,0,0,0,37,136,173
2019-02-07,20,4463,6183,3246,13203,13116,2801,88,29363,0,0,0,0,31,143,174
2019-02-07,21,4398,5988,3175,12816,12855,2740,88,28655,0,0,0,0,28,147,175
2019-02-07,22,4238,5701,3014,12167,12298,2599,86,27305,0,0,0,0,31,145,176
2019-02-07,23,4009,5430,2809,11307,11581,2392,84,25519,0,0,0,0,32,136,168
2019-02-07,24,3845,5268,2651,10507,10768,2178,82,23690,0,0,0,0,36,121,157
2019-02-08,1,3803,5209,2590,10078,9986,2034,86,22319,0,0,0,0,22,78,100
2019-02-08,2,3752,5186,2560,9741,9584,1961,88,21501,0,0,0,0,22,66,88
2019-02-08,3,3721,5202,2557,9549,9376,1924,90,21057,0,0,0,0,20,53,73
2019-02-08,4,3743,5293,2599,9534,9346,1925,94,21009,0,0,0,0,24,43,67
2019-02-08,5,3836,5490,2718,9815,9637,1996,100,21666,0,0,0,0,25,37,62
2019-02-08,6,4015,5849,2977,10514,10392,2197,110,23309,0,0,0,0,27,36,63
2019-02-08,7,4220,6144,3346,11626,11443,2486,118,25782,0,63,0,63,29,37,66
2019-02-08,8,4210,6173,3528,12229,11675,2539,116,26703,154,1584,208,1946,32,38,70
2019-02-08,9,4115,6123,3456,12118,11443,2366,104,26173,572,4226,721,5519,34,39,73
2019-02-08,10,4023,6040,3353,11923,11210,2149,92,25517,887,5712,1156,7755,37,42,79
2019-02-08,11,3947,5919,3250,11603,10914,1986,81,24727,953,6144,1333,8430,41,49,90
2019-02-08,12,3873,5807,3123,11309,10646,1868,74,24040,931,6183,1353,8467,52,63,115
2019-02-08,13,3801,5743,3047,11192,10463,1820,69,23686,853,6142,1270,8265,56,97,153
2019-02-08,14,3746,5698,2974,11240,10425,1818,63,23688,738,6115,1103,7956,66,158,224
2019-02-08,15,3712,5694,2925,11286,10466,1875,60,23830,618,5798,942,7358,67,243,310
2019-02-08,16,3735,5739,2913,11402,10541,2000,58,24142,395,4555,685,5635,87,336,423
2019-02-08,17,3885,5859,2961,11768,10948,2218,61,25135,140,1893,294,2327,94,407,501
2019-02-08,18,4203,6091,3084,12368,11945,2527,73,27051,19,117,39,175,111,448,559
2019-02-08,19,4354,6068,3136,13010,12623,2707,80,28555,0,0,0,0,108,475,583
2019-02-08,20,4341,5948,3076,12909,12457,2679,81,28261,0,0,0,0,106,511,617
2019-02-08,21,4298,5787,2997,12570,12226,2614,83,27626,0,0,0,0,104,553,657
2019-02-08,22,4180,5568,2863,12042,11788,2498,82,26544,0,0,0,0,97,610,707
2019-02-08,23,4002,5344,2690,11358,11225,2315,78,25111,0,0,0,0,89,682,771
2019-02-08,24,3858,5173,2543,10595,10486,2131,77,23423,0,0,0,0,102,769,871
2019-02-09,1,3833,5104,2549,9731,9711,2010,77,21622,0,0,0,0,79,846,925
2019-02-09,2,3751,5058,2503,9330,9262,1922,77,20686,0,0,0,0,89,940,1029
2019-02-09,3,3704,5045,2486,9118,8992,1875,79,20160,0,0,0,0,99,992,1091
2019-02-09,4,3690,5097,2504,9050,8875,1847,82,19951,0,0,0,0,111,1022,1133
2019-02-09,5,3722,5177,2564,9146,8904,1864,86,20096,0,0,0,0,110,1044,1154
2019-02-09,6,3795,5329,2683,9452,9178,1955,93,20775,0,0,0,0,121,1115,1236
2019-02-09,7,3861,5490,2849,9909,9561,2063,99,21729,0,48,0,48,134,1222,1356
2019-02-09,8,3830,5613,3010,10248,9647,2139,101,22226,165,946,183,1294,164,1343,1507
2019-02-09,9,3845,5698,3140,10450,9888,2160,94,22687,579,2748,662,3989,197,1520,1717
2019-02-09,10,3841,5697,3182,10358,9768,2105,87,22413,851,4204,1037,6092,238,1740,1978
2019-02-09,11,3836,5649,3168,10237,9678,1964,80,22053,862,4934,1135,6931,298,1969,2267
2019-02-09,12,3802,5575,3095,9990,9453,1853,73,21462,818,5181,1152,7151,375,2140,2515
2019-02-09,13,3748,5523,3023,9971,9232,1798,68,21162,792,5269,1103,7164,496,2217,2713
2019-02-09,14,3698,5487,2936,10015,9117,1776,66,21066,748,5268,979,6995,622,2222,2844
2019-02-09,15,3683,5509,2892,10082,9110,1789,64,21138,695,4907,840,6442,732,2153,2885
2019-02-09,16,3751,5583,2889,10192,9294,1903,65,21547,572,3858,661,5091,787,2002,2789
2019-02-09,17,3894,5724,2956,10380,9730,2106,70,22378,295,1659,345,2299,814,1786,2600
2019-02-09,18,4199,5955,3079,11115,10691,2418,77,24392,50,114,61,225,794,1548,2342
2019-02-09,19,4323,5959,3141,11912,11330,2611,82,26020,0,0,0,0,796,1359,2155
2019-02-09,20,4275,5866,3093,11837,11221,2582,83,25807,0,0,0,0,744,1253,1997
2019-02-09,21,4210,5720,3016,11522,11047,2512,84,25249,0,0,0,0,677,1220,1897
2019-02-09,22,4101,5512,2909,11094,10716,2414,82,24399,0,0,0,0,630,1238,1868
2019-02-09,23,3942,5275,2753,10558,10288,2260,79,23269,0,0,0,0,560,1285,1845
2019-02-09,24,3797,5083,2630,9942,9769,2100,77,21975,0,0,0,0,537,1336,1873
2019-02-10,1,3691,4963,2584,9561,9352,2008,78,21078,0,0,0,0,345,1353,1698
2019-02-10,2,3626,4919,2556,9173,9075,1920,78,20335,0,0,0,0,329,1364,1693
2019-02-10,3,3580,4900,2574,8960,8823,1868,79,19824,0,0,0,0,312,1347,1659
2019-02-10,4,3560,4931,2608,8865,8679,1840,81,19559,0,0,0,0,284,1327,1611
2019-02-10,5,3584,4996,2693,8924,8704,1854,84,19659,0,0,0,0,299,1309,1608
2019-02-10,6,3643,5119,2826,9181,8883,1908,89,20155,0,0,0,0,310,1305,1615
2019-02-10,7,3691,5251,3016,9624,9129,1957,96,20900,0,70,0,70,312,1327,1639
2019-02-10,8,3648,5370,3192,9778,8989,2063,96,21023,50,1237,53,1340,333,1385,1718
2019-02-10,9,3647,5385,3312,9913,9098,2088,92,21287,226,3237,236,3699,346,1545,1891
2019-02-10,10,3650,5377,3317,9680,9141,2066,86,21068,488,4336,450,5274,359,1749,2108
2019-02-10,11,3632,5335,3241,9380,9132,1998,80,20683,745,4525,644,5914,387,1908,2295
2019-02-10,12,3624,5343,3104,9061,9100,1950,74,20271,853,4522,771,6146,423,2207,2630
2019-02-10,13,3611,5300,3010,8978,9207,1955,70,20299,862,4393,879,6134,430,2568,2998
2019-02-10,14,3593,5316,2924,9000,9158,1986,68,20296,890,4032,1050,5972,380,2746,3126
2019-02-10,15,3620,5365,2862,8991,9201,1987,70,20336,878,3608,1066,5552,302,2775,3077
2019-02-10,16,3675,5472,2871,9316,9460,2065,73,20999,765,2853,856,4474,236,2707,2943
2019-02-10,17,3825,5619,2939,9974,9824,2271,80,22236,412,1288,455,2155,176,2615,2791
2019-02-10,18,4135,5874,3107,10922,10523,2554,86,24179,69,120,83,272,144,2547,2691
2019-02-10,19,4268,5892,3195,11840,11133,2689,89,25846,0,0,0,0,151,2468,2619
2019-02-10,20,4259,5809,3183,11994,11137,2678,89,25992,0,0,0,0,142,2332,2474
2019-02-10,21,4212,5658,3101,11783,10965,2588,89,25519,0,0,0,0,145,2102,2247
2019-02-10,22,4065,5433,2946,11295,10610,2459,86,24541,0,0,0,0,166,1871,2037
2019-02-10,23,3885,5200,2755,10551,10113,2263,82,23104,0,0,0,0,188,1779,1967
2019-02-10,24,3723,5055,2615,9864,9499,2083,80,21609,0,0,0,0,180,1796,1976
2019-02-11,1,3673,4929,2506,9406,9440,1927,81,20948,0,0,0,0,154,1642,1796
2019-02-11,2,3614,4921,2477,9140,9241,1873,83,20429,0,0,0,0,146,1512,1658
2019-02-11,3,3588,4950,2495,9036,9095,1843,86,20154,0,0,0,0,127,1340,1467
2019-02-11,4,3609,5061,2557,9105,9147,1848,90,20283,0,0,0,0,104,1180,1284
2019-02-11,5,3691,5307,2693,9481,9509,1924,96,21099,0,0,0,0,80,1069,1149
2019-02-11,6,3903,5707,2968,10275,10392,2121,107,22989,0,0,0,0,62,995,1057
2019-02-11,7,4120,6034,3356,11533,11574,2428,119,25748,0,91,0,91,56,894,950
2019-02-11,8,4126,6081,3550,12130,11882,2490,116,26713,196,1723,244,2163,47,708,755
2019-02-11,9,4082,6048,3501,11695,11605,2371,106,25869,676,4385,814,5875,44,452,496
2019-02-11,10,4025,6005,3418,11149,11163,2198,96,24696,1019,5840,1234,8093,37,242,279
2019-02-11,11,3975,5945,3327,10574,10789,2006,89,23541,1100,6274,1412,8786,35,141,176
2019-02-11,12,3922,5878,3216,10085,10507,1911,84,22676,1079,6295,1456,8830,31,107,138
2019-02-11,13,3874,5846,3154,9869,10353,1848,80,22246,1057,6250,1463,8770,33,96,129
2019-02-11,14,3812,5806,3099,9839,10374,1841,75,22224,1055,6263,1474,8792,31,90,121
2019-02-11,15,3764,5807,3053,9906,10484,1879,73,22436,1055,6032,1445,8532,32,87,119
2019-02-11,16,3772,5855,3060,10256,10751,1976,71,23147,984,4947,1232,7163,37,87,124
2019-02-11,17,3904,5964,3119,10952,11288,2172,76,24581,545,2235,650,3430,34,87,121
2019-02-11,18,4237,6230,3276,12016,12311,2527,85,27030,85,196,110,391,36,82,118
2019-02-11,19,4444,6227,3361,13038,13131,2800,92,29155,0,0,0,0,42,75,117
2019-02-11,20,4450,6124,3300,13034,13020,2788,93,29030,0,0,0,0,39,71,110
2019-02-11,21,4368,5921,3198,12632,12749,2683,92,28249,0,0,0,0,39,60,99
2019-02-11,22,4200,5606,3021,11958,12173,2511,90,26826,0,0,0,0,43,50,93
2019-02-11,23,3976,5321,2805,11061,11427,2277,87,24945,0,0,0,0,45,49,94
2019-02-11,24,3804,5140,2623,10260,10631,2088,85,23156,0,0,0,0,51,53,104
2019-02-12,1,3733,5055,2464,9722,9853,1973,84,21726,0,0,0,0,39,84,123
2019-02-12,2,3679,5027,2419,9418,9512,1917,86,21027,0,0,0,0,53,80,133
2019-02-12,3,3660,5041,2417,9287,9344,1885,89,20700,0,0,0,0,60,73,133
2019-02-12,4,3682,5137,2448,9304,9333,1890,93,20714,0,0,0,0,58,68,126
2019-02-12,5,3772,5378,2560,9612,9666,1964,100,21429,0,0,0,0,53,67,120
2019-02-12,6,3967,5767,2816,10372,10474,2171,110,23222,0,0,0,0,47,79,126
2019-02-12,7,4157,6075,3183,11582,11383,2470,121,25649,0,119,1,120,37,91,128
2019-02-12,8,4132,6091,3366,12177,11807,2560,116,26752,164,1422,210,1796,32,92,124
2019-02-12,9,4042,6030,3316,11946,11451,2362,105,25955,537,3577,677,4791,28,82,110
2019-02-12,10,3950,5960,3253,11448,11057,2198,92,24889,805,5028,1057,6890,30,76,106
2019-02-12,11,3881,5878,3166,10987,10685,2010,82,23857,874,5657,1248,7779,29,71,100
2019-02-12,12,3812,5800,3090,10619,10342,1863,74,22991,867,5761,1312,7940,27,66,93
2019-02-12,13,3759,5764,3041,10444,10197,1802,67,22604,849,5651,1283,7783,29,62,91
2019-02-12,14,3725,5735,3001,10401,10316,1825,64,22700,797,5300,1167,7264,33,54,87
2019-02-12,15,3703,5736,2966,10367,10567,1891,61,22981,707,4543,984,6234,41,45,86
2019-02-12,16,3748,5791,2971,10477,10869,2008,61,23511,504,3152,686,4342,45,42,87
2019-02-12,17,3892,5902,3029,10860,11221,2212,64,24452,200,1169,286,1655,41,43,84
2019-02-12,18,4209,6160,3172,11816,12048,2541,71,26571,25,67,36,128,51,47,98
2019-02-12,19,4399,6154,3259,12827,12910,2688,78,28597,0,0,0,0,74,52,126
2019-02-12,20,4389,6060,3210,12828,12820,2671,81,28493,0,0,0,0,110,58,168
2019-02-12,21,4317,5862,3110,12412,12474,2575,82,27636,0,0,0,0,135,71,206
2019-02-12,22,4145,5555,2938,11722,11826,2415,80,26138,0,0,0,0,155,90,245
2019-02-12,23,3927,5273,2725,10813,11059,2192,77,24235,0,0,0,0,183,117,300
2019-02-12,24,3751,5083,2545,10042,10269,2017,74,22497,0,0,0,0,241,159,400
2019-02-13,1,3654,4984,2397,9627,9571,1987,75,21343,0,0,0,0,511,385,896
2019-02-13,2,3582,4958,2352,9276,9186,1920,77,20550,0,0,0,0,683,420,1103
2019-02-13,3,3552,4955,2342,9064,8973,1881,79,20092,0,0,0,0,777,433,1210
2019-02-13,4,3564,5035,2374,9040,8949,1876,81,20041,0,0,0,0,859,430,1289
2019-02-13,5,3648,5246,2485,9270,9134,1929,87,20516,0,0,0,0,923,475,1398
2019-02-13,6,3816,5627,2745,9945,9839,2090,95,22065,0,0,0,0,953,561,1514
2019-02-13,7,4002,5925,3115,11086,10781,2358,103,24423,0,40,1,41,959,655,1614
2019-02-13,8,3978,5958,3302,11708,11303,2451,103,25654,28,570,45,643,932,748,1680
2019-02-13,9,3910,5939,3257,11826,11502,2452,94,25968,111,1531,189,1831,896,816,1712
2019-02-13,10,3840,5896,3192,11823,11549,2453,86,26000,216,2347,380,2943,864,869,1733
2019-02-13,11,3791,5848,3118,11676,11609,2401,79,25853,344,2952,561,3857,832,918,1750
2019-02-13,12,3745,5796,3040,11578,11711,2353,73,25806,445,3242,677,4364,795,961,1756
2019-02-13,13,3716,5788,2992,11565,11585,2368,68,25669,479,3182,712,4373,744,969,1713
2019-02-13,14,3707,5776,2949,11442,11515,2382,65,25487,487,2886,754,4127,690,925,1615
2019-02-13,15,3716,5792,2911,11336,11385,2411,63,25276,433,2441,721,3595,645,859,1504
2019-02-13,16,3771,5842,2916,11502,11436,2420,64,25506,317,1582,544,2443,617,780,1397
2019-02-13,17,3910,5922,2969,11818,11514,2500,70,25982,155,575,258,988,561,708,1269
2019-02-13,18,4189,6162,3113,12707,12155,2700,78,27729,31,60,43,134,538,654,1192
2019-02-13,19,4368,6143,3209,13096,12880,2913,82,29051,0,0,0,0,559,613,1172
2019-02-13,20,4343,6028,3156,12977,12796,2858,81,28792,0,0,0,0,602,578,1180
2019-02-13,21,4260,5831,3063,12466,12411,2710,80,27751,0,0,0,0,648,563,1211
2019-02-13,22,4082,5529,2899,11714,11716,2520,77,26118,0,0,0,0,674,563,1237
2019-02-13,23,3869,5238,2689,10826,10801,2272,74,24061,0,0,0,0,661,565,1226
2019-02-13,24,3686,5037,2516,10000,9943,2061,71,22157,0,0,0,0,679,563,1242
2019-02-14,1,3554,4874,2375,9374,9113,1918,65,20549,0,0,0,0,800,473,1273
2019-02-14,2,3469,4828,2334,8946,8731,1853,65,19680,0,0,0,0,866,461,1327
2019-02-14,3,3420,4823,2330,8736,8500,1803,67,19199,0,0,0,0,921,475,1396
2019-02-14,4,3417,4901,2358,8685,8452,1782,70,19076,0,0,0,0,946,481,1427
2019-02-14,5,3485,5112,2465,8920,8707,1826,74,19613,0,0,0,0,885,469,1354
2019-02-14,6,3655,5487,2727,9623,9405,1976,81,21180,0,0,0,0,823,457,1280
2019-02-14,7,3845,5791,3092,10961,10431,2252,87,23819,1,8,1,10,929,452,1381
2019-02-14,8,3853,5839,3278,11817,11160,2494,87,25643,43,249,40,332,1026,453,1479
2019-02-14,9,3827,5839,3231,11875,11486,2536,82,26067,160,766,186,1112,1083,536,1619
2019-02-14,10,3800,5820,3167,11753,11634,2590,76,26146,323,1134,370,1827,1137,713,1850
2019-02-14,11,3784,5785,3092,11560,11777,2579,71,26081,509,1408,558,2475,1144,898,2042
2019-02-14,12,3759,5735,3002,11395,11849,2543,67,25947,627,1677,673,2977,1137,1117,2254
2019-02-14,13,3754,5725,2948,11309,11838,2531,63,25834,670,1742,697,3109,1136,1379,2515
2019-02-14,14,3770,5715,2901,11248,11730,2499,59,25630,729,1793,739,3261,1065,1643,2708
2019-02-14,15,3801,5725,2861,11117,11563,2481,56,25312,741,1745,735,3221,966,1864,2830
2019-02-14,16,3866,5755,2841,11182,11535,2477,56,25343,728,1341,654,2723,924,1955,2879
2019-02-14,17,3977,5844,2905,11547,11757,2504,57,25959,460,709,413,1582,853,1914,2767
2019-02-14,18,4226,6065,3038,12153,11998,2711,65,27020,91,122,90,303,738,1792,2530
2019-02-14,19,4385,6048,3137,12976,12560,2900,69,28600,0,0,0,0,682,1668,2350
2019-02-14,20,4343,5932,3080,12923,12441,2840,69,28367,0,0,0,0,662,1608,2270
2019-02-14,21,4245,5732,2992,12452,12154,2697,69,27466,0,0,0,0,705,1622,2327
2019-02-14,22,4065,5444,2832,11742,11600,2507,68,26010,0,0,0,0,730,1631,2361
2019-02-14,23,3859,5166,2630,10845,10779,2261,64,24040,0,0,0,0,722,1656,2378
2019-02-14,24,3670,4969,2467,10032,9968,2053,63,22197,0,0,0,0,736,1732,2468
2019-02-15,1,3584,4847,2386,9313,9285,1886,67,20643,0,0,0,0,603,1960,2563
2019-02-15,2,3511,4801,2344,8970,8904,1819,67,19854,0,0,0,0,601,1909,2510
2019-02-15,3,3470,4804,2336,8787,8703,1780,70,19433,0,0,0,0,589,1839,2428
2019-02-15,4,3483,4884,2370,8768,8662,1774,72,19369,0,0,0,0,588,1770,2358
2019-02-15,5,3560,5086,2481,9035,8938,1830,79,19977,0,0,0,0,566,1679,2245
2019-02-15,6,3727,5446,2725,9703,9667,1976,85,21526,0,0,0,0,521,1583,2104
2019-02-15,7,3919,5741,3091,10866,10710,2223,91,23973,1,108,2,111,461,1505,1966
2019-02-15,8,3917,5808,3275,11488,11277,2435,90,25376,94,1140,76,1310,420,1423,1843
2019-02-15,9,3874,5813,3237,11363,11320,2389,84,25247,329,2924,269,3522,404,1344,1748
2019-02-15,10,3831,5800,3167,11283,11235,2325,78,25014,515,4150,500,5165,418,1337,1755
2019-02-15,11,3798,5770,3077,11139,11209,2230,72,24745,598,4664,712,5974,424,1427,1851
2019-02-15,12,3764,5719,2977,10948,11189,2132,66,24429,643,4822,837,6302,502,1578,2080
2019-02-15,13,3736,5698,2911,10828,11124,2095,64,24206,645,4705,835,6185,572,1730,2302
2019-02-15,14,3731,5680,2851,10892,11105,2123,62,24275,592,4316,793,5701,608,1814,2422
2019-02-15,15,3744,5680,2799,10882,11079,2134,60,24249,510,3692,711,4913,603,1816,2419
2019-02-15,16,3784,5694,2795,10907,11087,2198,60,24345,419,2680,515,3614,569,1809,2378
2019-02-15,17,3917,5746,2846,11216,11331,2380,64,25085,241,1112,262,1615,492,1769,2261
2019-02-15,18,4176,5963,2961,11919,11722,2600,72,26407,52,107,52,211,407,1677,2084
2019-02-15,19,4331,5940,3053,12380,12328,2649,76,27528,0,0,0,0,349,1629,1978
2019-02-15,20,4294,5802,2996,12279,12241,2601,75,27290,0,0,0,0,329,1654,1983
2019-02-15,21,4212,5626,2908,11951,11881,2485,75,26485,0,0,0,0,322,1720,2042
2019-02-15,22,4070,5412,2775,11406,11470,2341,73,25384,0,0,0,0,339,1778,2117
2019-02-15,23,3897,5187,2606,10684,10732,2160,69,23740,0,0,0,0,352,1848,2200
2019-02-15,24,3736,5003,2458,10029,10050,2000,68,22240,0,0,0,0,385,1973,2358
2019-02-16,1,3672,4876,2344,9588,9390,1930,68,21071,0,0,0,0,371,2314,2685
2019-02-16,2,3588,4830,2302,9242,8992,1854,69,20252,0,0,0,0,360,2531,2891
2019-02-16,3,3540,4825,2293,9003,8755,1804,71,19728,0,0,0,0,388,2656,3044
2019-02-16,4,3529,4861,2315,8902,8670,1785,73,19525,0,0,0,0,452,2733,3185
2019-02-16,5,3564,4959,2383,8979,8768,1792,77,19711,0,0,0,0,526,2723,3249
2019-02-16,6,3646,5132,2505,9303,9084,1850,82,20414,0,0,0,0,601,2645,3246
2019-02-16,7,3708,5283,2680,9779,9420,1950,89,21331,1,141,2,144,659,2562,3221
2019-02-16,8,3713,5404,2849,10028,9458,1990,91,21661,180,1601,182,1963,665,2495,3160
2019-02-16,9,3752,5485,2964,10133,9465,2017,85,21795,597,3990,618,5205,640,2466,3106
2019-02-16,10,3755,5520,2979,9922,9229,2003,81,21329,911,5492,1008,7411,645,2544,3189
2019-02-16,11,3747,5515,2924,9562,8884,1942,78,20563,971,6011,1192,8174,687,2714,3401
2019-02-16,12,3711,5481,2827,9153,8639,1867,73,19829,937,6075,1248,8260,728,2866,3594
2019-02-16,13,3672,5447,2736,8968,8574,1830,70,19539,895,6038,1195,8128,803,2949,3752
2019-02-16,14,3635,5418,2655,8904,8581,1808,68,19455,841,5935,1065,7841,846,2967,3813
2019-02-16,15,3630,5438,2595,8915,8519,1816,67,19411,812,5536,946,7294,857,2932,3789
2019-02-16,16,3682,5489,2591,9258,8693,1921,66,20035,765,4362,773,5900,854,2819,3673
2019-02-16,17,3823,5594,2632,9901,9228,2126,72,21423,474,2001,431,2906,817,2602,3419
2019-02-16,18,4099,5834,2755,10698,10252,2404,79,23527,102,236,95,433,792,2343,3135
2019-02-16,19,4243,5849,2855,11604,11030,2627,84,25439,0,0,0,0,775,2173,2948
2019-02-16,20,4203,5756,2822,11615,10983,2590,84,25366,0,0,0,0,754,2181,2935
2019-02-16,21,4140,5618,2757,11342,10840,2483,83,24842,0,0,0,0,711,2318,3029
2019-02-16,22,4029,5417,2650,10961,10514,2358,81,24009,0,0,0,0,658,2417,3075
2019-02-16,23,3866,5188,2506,10384,10015,2197,77,22767,0,0,0,0,574,2378,2952
2019-02-16,24,3729,5017,2391,9804,9489,2040,75,21502,0,0,0,0,502,2208,2710
2019-02-17,1,3683,4862,2346,9504,9266,1920,76,20861,0,0,0,0,473,1964,2437
2019-02-17,2,3624,4826,2313,9198,8985,1840,76,20194,0,0,0,0,367,1818,2185
2019-02-17,3,3580,4823,2311,9017,8743,1790,78,19721,0,0,0,0,254,1808,2062
2019-02-17,4,3564,4858,2334,8948,8618,1768,79,19508,0,0,0,0,180,1878,2058
2019-02-17,5,3593,4937,2403,9038,8649,1771,82,19635,0,0,0,0,161,1973,2134
2019-02-17,6,3666,5054,2525,9280,8860,1819,87,20141,0,0,0,0,145,2016,2161
2019-02-17,7,3702,5176,2695,9632,9160,1896,92,20869,1,154,2,157,180,1963,2143
2019-02-17,8,3678,5289,2865,9822,9142,1924,93,21071,104,1587,104,1795,203,1871,2074
2019-02-17,9,3689,5299,3004,9821,9102,1942,90,21049,364,3776,374,4514,155,1772,1927
2019-02-17,10,3716,5280,3016,9722,9015,1915,85,20833,617,4982,689,6288,113,1723,1836
2019-02-17,11,3713,5229,2951,9457,8894,1869,80,20396,758,5283,952,6993,93,1830,1923
2019-02-17,12,3683,5219,2847,9129,8730,1826,76,19856,815,5276,1088,7179,86,2114,2200
2019-02-17,13,3653,5162,2772,8960,8716,1808,73,19651,848,5214,1118,7180,82,2436,2518
2019-02-17,14,3656,5161,2709,8909,8667,1808,72,19551,887,4947,1120,6954,78,2590,2668
2019-02-17,15,3686,5192,2660,8924,8728,1901,72,19720,885,4502,1071,6458,72,2546,2618
2019-02-17,16,3743,5298,2676,9233,9085,2017,75,20505,782,3533,862,5177,67,2435,2502
2019-02-17,17,3885,5420,2729,9835,9444,2143,81,21597,453,1666,472,2591,65,2319,2384
2019-02-17,18,4183,5693,2874,10504,10591,2418,86,23694,96,224,99,419,71,2217,2288
2019-02-17,19,4326,5739,2990,11619,11367,2650,91,25821,0,0,0,0,83,2151,2234
2019-02-17,20,4319,5667,2980,11748,11302,2627,90,25862,0,0,0,0,96,2194,2290
2019-02-17,21,4265,5518,2903,11599,11087,2532,90,25403,0,0,0,0,102,2317,2419
2019-02-17,22,4119,5289,2759,11136,10732,2377,87,24428,0,0,0,0,119,2408,2527
2019-02-17,23,3919,5067,2574,10404,10117,2174,83,22873,0,0,0,0,168,2430,2598
2019-02-17,24,3764,4950,2447,9784,9546,2008,81,21513,0,0,0,0,243,2371,2614
2019-02-18,1,3591,4915,2400,9717,9293,1919,75,21098,0,0,0,0,444,2519,2963
2019-02-18,2,3528,4906,2382,9431,9056,1876,75,20533,0,0,0,0,547,2469,3016
2019-02-18,3,3503,4933,2402,9326,8878,1843,77,20218,0,0,0,0,593,2424,3017
2019-02-18,4,3513,5025,2452,9305,8876,1834,79,20187,0,0,0,0,609,2359,2968
2019-02-18,5,3585,5199,2572,9530,9122,1859,84,20689,0,0,0,0,604,2255,2859
2019-02-18,6,3718,5455,2807,10049,9775,1980,90,21989,0,0,0,0,616,2099,2715
2019-02-18,7,3833,5637,3081,10778,10518,2141,96,23628,2,144,4,150,622,1881,2503
2019-02-18,8,3829,5776,3274,11079,10676,2208,101,24158,266,1540,215,2021,577,1629,2206
2019-02-18,9,3829,5868,3357,11088,10712,2186,97,24173,780,3851,655,5286,519,1412,1931
2019-02-18,10,3844,5891,3324,10765,10564,2104,92,23614,1073,5330,1008,7411,472,1278,1750
2019-02-18,11,3853,5864,3235,10382,10279,2024,87,22864,1126,5873,1215,8214,453,1204,1657
2019-02-18,12,3831,5799,3113,10027,10011,1930,81,22141,1111,5959,1301,8371,484,1179,1663
2019-02-18,13,3781,5749,3010,9817,9965,1876,78,21827,1107,5909,1338,8354,548,1193,1741
2019-02-18,14,3756,5711,2914,9827,9996,1873,75,21865,1146,5810,1354,8310,595,1290,1885
2019-02-18,15,3750,5698,2848,9962,10102,1922,73,22155,1180,5455,1307,7942,603,1427,2030
2019-02-18,16,3803,5766,2836,10407,10222,2066,69,22858,1130,4404,1126,6660,574,1519,2093
2019-02-18,17,3920,5858,2901,11191,10891,2251,75,24500,675,2133,650,3458,509,1592,2101
2019-02-18,18,4223,6129,3069,12468,11944,2589,84,27177,133,293,138,564,446,1684,2130
2019-02-18,19,4437,6142,3214,13581,12853,2858,89,29473,0,0,0,0,410,1735,2145
2019-02-18,20,4414,6040,3181,13528,12751,2832,89,29293,0,0,0,0,423,1689,2112
2019-02-18,21,4340,5858,3096,13084,12437,2717,89,28421,0,0,0,0,460,1551,2011
2019-02-18,22,4171,5550,2939,12413,11899,2538,87,27032,0,0,0,0,501,1351,1852
2019-02-18,23,3964,5266,2727,11417,11141,2299,83,25034,0,0,0,0,529,1148,1677
2019-02-18,24,3776,5102,2564,10578,10424,2116,81,23293,0,0,0,0,553,961,1514
2019-02-19,1,3822,5094,2460,9955,9969,2037,83,22138,0,0,0,0,512,1165,1677
2019-02-19,2,3768,5075,2438,9619,9633,1976,84,21407,0,0,0,0,474,1026,1500
2019-02-19,3,3744,5093,2446,9457,9464,1936,86,21039,0,0,0,0,452,896,1348
2019-02-19,4,3762,5188,2491,9480,9460,1941,89,21066,0,0,0,0,430,758,1188
2019-02-19,5,3849,5424,2618,9804,9779,2011,95,21784,0,0,0,0,400,589,989
2019-02-19,6,4048,5820,2914,10583,10642,2215,104,23640,0,0,0,0,368,417,785
2019-02-19,7,4224,6104,3298,11897,11720,2528,113,26353,3,210,10,223,319,277,596
2019-02-19,8,4208,6120,3478,12377,11928,2588,113,27099,305,2065,325,2695,243,160,403
2019-02-19,9,4136,6065,3409,11909,11565,2445,103,26116,853,4710,888,6451,159,83,242
2019-02-19,10,4066,5992,3289,11226,11081,2262,93,24757,1148,6032,1244,8424,108,54,162
2019-02-19,11,4010,5911,3165,10571,10642,2097,85,23489,1202,6379,1389,8970,93,57,150
2019-02-19,12,3950,5832,3046,10103,10339,1994,80,22610,1175,6379,1437,8991,80,78,158
2019-02-19,13,3899,5797,2965,9804,10130,1933,76,22037,1156,6337,1443,8936,57,117,174
2019-02-19,14,3869,5762,2905,9787,10111,1918,72,21983,1180,6317,1441,8938,34,166,200
2019-02-19,15,3843,5764,2849,9799,10055,1946,72,21967,1202,6099,1411,8712,19,229,248
2019-02-19,16,3897,5811,2850,10193,10273,2065,72,22697,1143,5151,1261,7555,16,322,338
2019-02-19,17,4053,5932,2914,10928,10774,2289,72,24146,678,2623,739,4040,22,403,425
2019-02-19,18,4354,6189,3054,12062,11829,2637,82,26694,132,383,155,670,38,455,493
2019-02-19,19,4565,6221,3185,13181,12765,2911,88,29039,0,0,0,0,59,490,549
2019-02-19,20,4558,6127,3149,13186,12742,2884,89,28995,0,0,0,0,77,509,586
2019-02-19,21,4484,5913,3058,12818,12538,2779,89,28319,0,0,0,0,90,552,642
2019-02-19,22,4308,5600,2887,12123,11983,2609,86,26897,0,0,0,0,102,619,721
2019-02-19,23,4064,5328,2680,11197,11273,2365,82,25012,0,0,0,0,113,704,817
2019-02-19,24,3886,5165,2518,10428,10566,2161,82,23332,0,0,0,0,125,801,926
2019-02-20,1,3816,5089,2459,10021,10212,2094,83,22504,0,0,0,0,359,1435,1794
2019-02-20,2,3760,5076,2423,9696,9929,2024,85,21828,0,0,0,0,369,1531,1900
2019-02-20,3,3734,5083,2423,9530,9729,1980,87,21420,0,0,0,0,372,1642,2014
2019-02-20,4,3754,5170,2459,9525,9689,1981,90,21379,0,0,0,0,369,1740,2109
2019-02-20,5,3841,5399,2579,9826,9992,2043,98,22054,0,0,0,0,323,1762,2085
2019-02-20,6,4042,5788,2843,10588,10762,2230,105,23781,0,0,0,0,253,1695,1948
2019-02-20,7,4218,6073,3213,11789,11751,2518,113,26258,8,215,10,233,206,1610,1816
2019-02-20,8,4188,6083,3385,12320,11887,2595,110,27006,140,1892,215,2247,167,1553,1720
2019-02-20,9,4105,6036,3329,12020,11732,2487,101,26435,414,4217,579,5210,138,1582,1720
2019-02-20,10,4025,5959,3232,11642,11512,2355,92,25695,616,5396,826,6838,135,1726,1861
2019-02-20,11,3966,5875,3138,11270,11270,2243,83,24959,680,5669,934,7283,158,1932,2090
2019-02-20,12,3897,5794,3043,10945,11132,2157,75,24402,694,5599,989,7282,216,2153,2369
2019-02-20,13,3844,5763,2986,10731,11026,2130,69,24050,697,5333,923,6953,243,2309,2552
2019-02-20,14,3817,5741,2941,10603,11034,2130,65,23925,673,4689,779,6141,258,2357,2615
2019-02-20,15,3794,5748,2907,10520,11125,2210,64,24012,629,3974,653,5256,267,2296,2563
2019-02-20,16,3847,5806,2913,10841,11101,2318,66,24419,551,2843,518,3912,278,2142,2420
2019-02-20,17,4011,5902,2965,11374,11482,2507,71,25526,315,1194,295,1804,236,1917,2153
2019-02-20,18,4312,6157,3102,12365,12445,2807,80,27790,67,165,71,303,207,1678,1885
2019-02-20,19,4516,6186,3229,13268,13285,3044,84,29775,0,0,0,0,192,1520,1712
2019-02-20,20,4513,6101,3191,13221,13222,2984,85,29607,0,0,0,0,186,1431,1617
2019-02-20,21,4444,5896,3099,12837,12918,2842,84,28776,0,0,0,0,166,1424,1590
2019-02-20,22,4274,5594,2933,12190,12304,2644,82,27315,0,0,0,0,140,1528,1668
2019-02-20,23,4041,5312,2722,11261,11400,2387,79,25219,0,0,0,0,135,1720,1855
2019-02-20,24,3867,5149,2557,10482,10591,2161,76,23405,0,0,0,0,145,1880,2025
2019-02-21,1,3853,5113,2508,10000,10116,2025,81,22307,0,0,0,0,205,1761,1966
2019-02-21,2,3792,5094,2481,9719,9794,1949,81,21627,0,0,0,0,195,1818,2013
2019-02-21,3,3758,5111,2484,9558,9572,1900,83,21197,0,0,0,0,187,1861,2048
2019-02-21,4,3769,5206,2529,9570,9590,1887,86,21213,0,0,0,0,219,1829,2048
2019-02-21,5,3850,5432,2655,9882,9875,1945,92,21869,0,0,0,0,299,1722,2021
2019-02-21,6,4035,5818,2939,10627,10672,2116,102,23593,0,0,0,0,400,1586,1986
2019-02-21,7,4217,6092,3332,11879,11722,2386,108,26162,7,140,10,157,512,1450,1962
2019-02-21,8,4193,6111,3502,12283,12060,2555,107,27092,215,1225,204,1644,616,1348,1964
2019-02-21,9,4133,6067,3432,11861,11936,2473,100,26458,594,2948,592,4134,738,1344,2082
2019-02-21,10,4073,6004,3327,11299,11609,2396,93,25484,829,4041,881,5751,848,1366,2214
2019-02-21,11,4028,5934,3220,10643,11286,2296,87,24399,890,4469,1003,6362,916,1350,2266
2019-02-21,12,3973,5858,3097,10115,11079,2222,83,23576,898,4597,1064,6559,968,1284,2252
2019-02-21,13,3928,5833,3025,9803,10941,2191,80,23088,932,4551,1087,6570,1007,1206,2213
2019-02-21,14,3908,5812,2965,9728,11022,2192,76,23099,991,4292,1094,6377,1030,1197,2227
2019-02-21,15,3886,5812,2909,9686,11023,2197,75,23066,998,3779,1033,5810,1037,1265,2302
2019-02-21,16,3936,5876,2904,10095,11045,2297,72,23597,921,2847,836,4604,1037,1349,2386
2019-02-21,17,4097,5968,2965,10795,11432,2421,80,24815,550,1362,476,2388,1034,1381,2415
2019-02-21,18,4388,6196,3102,11907,12113,2651,87,26846,115,223,110,448,1056,1332,2388
2019-02-21,19,4587,6227,3252,12994,12977,2888,93,29038,0,0,0,0,1073,1243,2316
2019-02-21,20,4578,6136,3222,13027,13006,2865,93,29075,0,0,0,0,1070,1131,2201
2019-02-21,21,4503,5931,3142,12677,12843,2749,92,28446,0,0,0,0,1041,970,2011
2019-02-21,22,4330,5635,2976,12073,12285,2581,88,27111,0,0,0,0,1008,807,1815
2019-02-21,23,4094,5363,2768,11208,11464,2342,84,25184,0,0,0,0,987,696,1683
2019-02-21,24,3921,5195,2608,10455,10697,2145,83,23465,0,0,0,0,967,613,1580
2019-02-22,1,3916,5110,2554,10061,10096,2046,83,22351,0,0,0,0,1047,822,1869
2019-02-22,2,3860,5085,2525,9740,9800,1983,84,21672,0,0,0,0,1027,768,1795
2019-02-22,3,3820,5096,2533,9568,9618,1941,87,21279,0,0,0,0,991,697,1688
2019-02-22,4,3834,5182,2588,9579,9623,1945,90,21303,0,0,0,0,933,632,1565
2019-02-22,5,3917,5396,2719,9892,9933,2016,96,22003,0,0,0,0,839,591,1430
2019-02-22,6,4084,5762,2988,10633,10735,2213,104,23752,0,0,0,0,699,548,1247
2019-02-22,7,4267,6028,3356,11854,11758,2498,113,26289,12,225,15,252,542,482,1024
2019-02-22,8,4246,6066,3533,12360,11960,2554,108,27047,349,2015,357,2721,409,392,801
2019-02-22,9,4170,6037,3468,11943,11699,2416,100,26221,900,4565,931,6396,296,298,594
2019-02-22,10,4097,5975,3345,11251,11267,2211,89,24883,1189,5914,1299,8402,204,246,450
2019-02-22,11,4027,5902,3221,10654,10756,2033,79,23586,1248,6326,1463,9037,126,237,363
2019-02-22,12,3952,5815,3075,10207,10394,1911,73,22649,1225,6369,1508,9102,76,274,350
2019-02-22,13,3885,5774,2978,9954,10146,1851,70,22090,1209,6330,1496,9035,45,372,417
2019-02-22,14,3843,5741,2896,9964,9991,1827,66,21912,1220,6280,1502,9002,24,543,567
2019-02-22,15,3814,5733,2833,9976,9952,1872,65,21928,1234,6031,1471,8736,17,786,803
2019-02-22,16,3852,5769,2812,10322,10171,1986,63,22605,1179,5105,1310,7594,21,1059,1080
2019-02-22,17,3999,5849,2858,10997,10668,2218,68,24014,770,2713,785,4268,30,1253,1283
2019-02-22,18,4291,6069,2970,12004,11644,2541,76,26330,189,459,177,825,52,1337,1389
2019-02-22,19,4494,6077,3092,12991,12497,2810,84,28446,0,0,0,0,94,1334,1428
2019-02-22,20,4486,5967,3063,12944,12401,2772,86,28267,0,0,0,0,127,1236,1363
2019-02-22,21,4426,5781,2988,12581,12257,2681,87,27670,0,0,0,0,129,1073,1202
2019-02-22,22,4294,5562,2856,12042,11870,2547,85,26608,0,0,0,0,122,890,1012
2019-02-22,23,4102,5337,2681,11292,11212,2361,81,25012,0,0,0,0,116,742,858
2019-02-22,24,3948,5172,2530,10566,10535,2174,80,23421,0,0,0,0,114,637,751
2019-02-23,1,3977,5094,2402,9935,10142,2023,80,22236,0,0,0,0,98,646,744
2019-02-23,2,3889,5056,2360,9598,9749,1954,82,21438,0,0,0,0,102,535,637
2019-02-23,3,3835,5042,2350,9384,9512,1907,84,20942,0,0,0,0,104,441,545
2019-02-23,4,3819,5079,2370,9326,9436,1887,87,20791,0,0,0,0,97,372,469
2019-02-23,5,3852,5176,2439,9446,9538,1926,91,21057,0,0,0,0,90,334,424
2019-02-23,6,3944,5335,2560,9815,9884,2017,99,21871,0,0,0,0,90,296,386
2019-02-23,7,3970,5460,2738,10274,10176,2116,107,22728,17,298,19,334,83,228,311
2019-02-23,8,3948,5587,2881,10492,10173,2145,105,22974,329,2291,372,2992,66,146,212
2019-02-23,9,3974,5685,2993,10345,10031,2096,97,22628,829,4890,928,6647,61,84,145
2019-02-23,10,3969,5682,2993,9938,9681,1974,87,21738,1111,6126,1291,8528,56,60,116
2019-02-23,11,3945,5640,2923,9549,9251,1793,80,20732,1181,6491,1450,9122,54,72,126
2019-02-23,12,3875,5565,2811,9185,9049,1689,73,20054,1152,6511,1494,9157,56,119,175
2019-02-23,13,3800,5504,2715,9085,8884,1642,68,19738,1127,6447,1485,9059,60,237,297
2019-02-23,14,3747,5467,2627,9009,8813,1634,64,19581,1112,6365,1457,8934,62,427,489
2019-02-23,15,3725,5476,2560,9088,8848,1693,62,19752,1056,5972,1349,8377,63,631,694
2019-02-23,16,3772,5517,2567,9314,9186,1814,63,20435,906,4850,1100,6856,69,796,865
2019-02-23,17,3894,5627,2619,9922,9700,2005,67,21753,527,2469,608,3604,73,899,972
2019-02-23,18,4178,5880,2732,10873,10632,2345,74,23984,118,409,128,655,87,928,1015
2019-02-23,19,4364,5938,2857,11928,11626,2672,81,26367,0,0,0,0,107,897,1004
2019-02-23,20,4342,5866,2826,11962,11595,2666,82,26364,0,0,0,0,126,836,962
2019-02-23,21,4293,5726,2747,11688,11450,2577,82,25854,0,0,0,0,127,761,888
2019-02-23,22,4195,5519,2640,11273,11101,2458,81,24967,0,0,0,0,116,685,801
2019-02-23,23,4037,5281,2493,10653,10554,2288,78,23628,0,0,0,0,108,619,727
2019-02-23,24,3880,5084,2364,10040,10002,2117,76,22291,0,0,0,0,105,562,667
2019-02-24,1,3720,4894,2274,9594,9427,1983,74,21113,0,0,0,0,117,350,467
2019-02-24,2,3648,4851,2240,9256,9091,1903,76,20361,0,0,0,0,124,286,410
2019-02-24,3,3602,4837,2227,9046,8920,1848,77,19927,0,0,0,0,130,217,347
2019-02-24,4,3584,4865,2241,8983,8846,1824,80,19768,0,0,0,0,123,163,286
2019-02-24,5,3615,4934,2295,9022,8905,1848,84,19894,0,0,0,0,108,139,247
2019-02-24,6,3684,5056,2400,9252,9148,1923,90,20449,0,0,0,0,102,127,229
2019-02-24,7,3698,5155,2547,9641,9339,1987,98,21101,17,223,24,264,99,108,207
2019-02-24,8,3647,5271,2694,9744,9180,1983,96,21037,348,1772,378,2498,96,89,185
2019-02-24,9,3644,5292,2817,9729,8900,1885,89,20648,877,4081,942,5900,91,67,158
2019-02-24,10,3654,5272,2845,9457,8638,1746,79,19966,1167,5553,1327,8047,87,52,139
2019-02-24,11,3628,5220,2795,9144,8441,1606,72,19308,1232,6157,1493,8882,88,52,140
2019-02-24,12,3581,5214,2719,8903,8221,1531,66,18756,1197,6285,1524,9006,90,68,158
2019-02-24,13,3552,5161,2661,8729,8120,1492,62,18438,1171,6241,1511,8923,94,100,194
2019-02-24,14,3553,5177,2615,8635,8203,1493,60,18426,1162,6198,1502,8862,98,147,245
2019-02-24,15,3576,5217,2565,8717,8449,1547,59,18807,1105,5916,1409,8430,100,221,321
2019-02-24,16,3628,5306,2578,9055,8865,1666,61,19682,955,4922,1139,7016,109,322,431
2019-02-24,17,3751,5430,2623,9732,9307,1882,63,21019,565,2600,629,3794,112,394,506
2019-02-24,18,4012,5679,2750,10680,10177,2225,68,23183,128,442,133,703,118,421,539
2019-02-24,19,4191,5734,2881,11671,11183,2550,72,25510,0,0,0,0,130,439,569
2019-02-24,20,4180,5679,2871,11784,11254,2547,74,25694,0,0,0,0,139,453,592
2019-02-24,21,4132,5524,2795,11524,11062,2460,75,25155,0,0,0,0,146,461,607
2019-02-24,22,3996,5281,2650,11090,10694,2330,73,24220,0,0,0,0,145,474,619
2019-02-24,23,3833,5037,2471,10381,10098,2141,69,22723,0,0,0,0,143,491,634
2019-02-24,24,3671,4880,2340,9716,9585,1981,68,21384,0,0,0,0,137,478,615
2019-02-25,1,3586,4741,2325,9194,9002,1889,65,20185,0,0,0,0,146,685,831
2019-02-25,2,3521,4729,2307,8924,8727,1838,67,19590,0,0,0,0,160,636,796
2019-02-25,3,3489,4746,2314,8818,8602,1808,70,19332,0,0,0,0,172,615,787
2019-02-25,4,3499,4840,2363,8855,8650,1807,73,19420,0,0,0,0,180,593,773
2019-02-25,5,3577,5061,2489,9173,9020,1885,79,20192,0,0,0,0,173,541,714
2019-02-25,6,3767,5460,2758,9920,9839,2068,89,21950,0,0,0,0,178,484,662
2019-02-25,7,3920,5754,3142,11079,10808,2330,97,24347,18,233,23,274,191,423,614
2019-02-25,8,3921,5816,3351,11863,11129,2392,94,25512,310,1669,359,2338,192,326,518
2019-02-25,9,3891,5824,3313,11728,11011,2278,85,25136,798,3758,917,5473,193,221,414
2019-02-25,10,3857,5801,3253,11555,10890,2131,76,24687,1092,5166,1313,7571,219,187,406
2019-02-25,11,3822,5766,3191,11375,10742,1987,70,24209,1155,5835,1480,8470,264,259,523
2019-02-25,12,3780,5724,3107,11158,10516,1893,65,23668,1097,6043,1517,8657,333,433,766
2019-02-25,13,3750,5710,3060,10972,10424,1844,63,23343,1041,6067,1509,8617,407,669,1076
2019-02-25,14,3731,5694,3014,10923,10583,1866,61,23472,1017,6036,1506,8559,467,860,1327
2019-02-25,15,3731,5691,2979,10966,10764,1921,59,23746,979,5770,1444,8193,512,960,1472
2019-02-25,16,3760,5710,2985,11154,10929,2005,60,24182,850,4894,1215,6959,544,963,1507
2019-02-25,17,3855,5785,3037,11588,11187,2165,61,25035,492,2658,688,3838,573,873,1446
2019-02-25,18,4112,6009,3174,12342,11916,2454,67,26812,110,487,149,746,624,780,1404
2019-02-25,19,4347,6018,3320,13050,12866,2738,70,28758,0,0,0,0,676,741,1417
2019-02-25,20,4335,5929,3272,12922,12741,2701,69,28467,0,0,0,0,682,740,1422
2019-02-25,21,4233,5723,3165,12479,12371,2583,68,27534,0,0,0,0,674,739,1413
2019-02-25,22,4052,5404,2990,11748,11728,2406,66,25980,0,0,0,0,674,722,1396
2019-02-25,23,3847,5110,2771,10819,10870,2183,63,23970,0,0,0,0,685,666,1351
2019-02-25,24,3659,4909,2613,10053,10096,2002,62,22247,0,0,0,0,690,580,1270
2019-02-26,1,3526,4771,2598,9433,9408,1906,59,20840,0,0,0,0,695,615,1310
2019-02-26,2,3448,4722,2578,9168,9186,1848,60,20297,0,0,0,0,675,594,1269
2019-02-26,3,3411,4728,2582,8998,9037,1805,63,19936,0,0,0,0,643,586,1229
2019-02-26,4,3415,4806,2624,8987,9028,1801,66,19916,0,0,0,0,623,579,1202
2019-02-26,5,3497,5020,2750,9258,9352,1856,71,20572,0,0,0,0,661,596,1257
2019-02-26,6,3663,5407,3040,9954,10088,2034,80,22190,0,0,0,0,713,572,1285
2019-02-26,7,3829,5682,3429,11089,10984,2311,89,24507,17,322,24,363,742,487,1229
2019-02-26,8,3818,5743,3615,12101,11249,2366,85,25836,212,2080,321,2613,752,387,1139
2019-02-26,9,3790,5741,3550,12071,10922,2243,77,25348,543,4330,826,5699,725,261,986
2019-02-26,10,3754,5722,3442,11760,10592,2105,71,24562,787,5577,1197,7561,671,188,859
2019-02-26,11,3717,5699,3337,11596,10393,2014,66,24103,895,6054,1379,8328,640,223,863
2019-02-26,12,3680,5665,3231,11424,10205,1942,63,23668,899,6118,1436,8453,613,310,923
2019-02-26,13,3668,5666,3164,11328,10105,1940,61,23468,840,5962,1403,8205,615,415,1030
2019-02-26,14,3677,5656,3111,11375,10283,2004,59,23756,763,5564,1289,7616,638,509,1147
2019-02-26,15,3693,5660,3057,11401,10459,2047,58,24000,690,4883,1129,6702,633,564,1197
2019-02-26,16,3741,5683,3082,11412,10677,2116,58,24297,533,3563,874,4970,640,567,1207
2019-02-26,17,3823,5746,3146,11700,10982,2234,60,25010,270,1596,452,2318,649,514,1163
2019-02-26,18,4074,5956,3291,12206,11685,2447,65,26434,59,236,92,387,650,446,1096
2019-02-26,19,4276,5982,3444,12972,12655,2714,69,28442,0,0,0,0,656,417,1073
2019-02-26,20,4251,5892,3402,12855,12548,2685,68,28187,0,0,0,0,670,433,1103
2019-02-26,21,4151,5686,3300,12381,12168,2578,66,27225,0,0,0,0,682,501,1183
2019-02-26,22,3966,5378,3119,11570,11506,2408,63,25579,0,0,0,0,710,632,1342
2019-02-26,23,3761,5092,2896,10659,10634,2185,60,23570,0,0,0,0,749,780,1529
2019-02-26,24,3567,4899,2722,9908,9901,1997,59,21898,0,0,0,0,780,877,1657
2019-02-27,1,3394,4712,2594,9461,9576,1894,56,21020,0,0,0,0,673,921,1594
2019-02-27,2,3306,4669,2563,9135,9233,1836,57,20293,0,0,0,0,586,952,1538
2019-02-27,3,3265,4668,2570,8958,9049,1793,60,19892,0,0,0,0,495,972,1467
2019-02-27,4,3272,4745,2611,8940,9019,1788,62,19841,0,0,0,0,384,954,1338
2019-02-27,5,3345,4966,2738,9199,9302,1842,68,20443,0,0,0,0,366,921,1287
2019-02-27,6,3525,5340,3018,9866,9975,2024,77,21968,0,0,0,0,404,907,1311
2019-02-27,7,3682,5605,3391,11067,10879,2279,85,24335,9,290,12,311,465,894,1359
2019-02-27,8,3681,5664,3550,11686,11071,2339,82,25204,89,1863,104,2056,521,819,1340
2019-02-27,9,3665,5675,3484,11786,10929,2179,74,25002,258,4012,295,4565,547,678,1225
2019-02-27,10,3640,5665,3372,11680,10749,2026,68,24557,406,5271,492,6169,545,566,1111
2019-02-27,11,3615,5654,3269,11617,10592,1907,63,24214,505,5690,635,6830,517,542,1059
2019-02-27,12,3592,5618,3151,11431,10442,1853,60,23821,565,5769,753,7087,454,588,1042
2019-02-27,13,3600,5617,3080,11282,10332,1808,58,23513,601,5779,745,7125,397,653,1050
2019-02-27,14,3626,5607,3029,11201,10454,1820,57,23565,635,5651,647,6933,358,710,1068
2019-02-27,15,3667,5611,2996,11117,10582,1886,56,23674,605,5290,563,6458,316,743,1059
2019-02-27,16,3731,5638,2991,11074,10767,2008,56,23938,483,4371,411,5265,277,757,1034
2019-02-27,17,3800,5687,3057,11299,11047,2220,58,24657,266,2308,224,2798,254,777,1031
2019-02-27,18,4034,5881,3203,12047,11739,2442,62,26322,62,430,57,549,242,835,1077
2019-02-27,19,4225,5915,3358,12820,12801,2698,66,28419,0,5,0,5,247,918,1165
2019-02-27,20,4168,5835,3325,12751,12706,2665,64,28221,0,0,0,0,256,970,1226
2019-02-27,21,4059,5633,3233,12411,12320,2544,62,27372,0,0,0,0,278,961,1239
2019-02-27,22,3872,5331,3063,11638,11648,2373,59,25753,0,0,0,0,300,955,1255
2019-02-27,23,3676,5042,2851,10770,10825,2147,55,23831,0,0,0,0,305,1003,1308
2019-02-27,24,3484,4854,2680,10063,10044,1966,52,22158,0,0,0,0,296,1074,1370
2019-02-28,1,3347,4677,2542,9496,9380,1864,49,20810,0,0,0,0,248,1479,1727
2019-02-28,2,3266,4646,2515,9178,9084,1804,49,20136,0,0,0,0,208,1508,1716
2019-02-28,3,3219,4648,2523,8997,8883,1761,51,19715,0,0,0,0,178,1504,1682
2019-02-28,4,3218,4733,2566,8981,8849,1746,53,19652,0,0,0,0,155,1495,1650
2019-02-28,5,3290,4949,2697,9231,9111,1792,59,20219,0,0,0,0,148,1522,1670
2019-02-28,6,3460,5332,2987,9859,9709,1950,65,21609,0,0,0,0,155,1534,1689
2019-02-28,7,3622,5589,3388,10958,10511,2207,72,23776,19,323,23,365,169,1549,1718
2019-02-28,8,3630,5628,3554,11516,11167,2270,70,25051,238,2017,266,2521,158,1586,1744
2019-02-28,9,3636,5617,3474,11488,10985,2203,65,24768,586,4244,669,5499,142,1612,1754
2019-02-28,10,3622,5580,3345,11034,10793,2122,61,24035,775,5567,999,7341,136,1675,1811
2019-02-28,11,3614,5533,3224,10748,10624,2043,58,23494,815,6114,1213,8142,135,1784,1919
2019-02-28,12,3612,5469,3087,10483,10560,1986,56,23103,808,6242,1299,8349,135,1888,2023
2019-02-28,13,3622,5447,3003,10255,10546,1962,55,22836,782,6232,1279,8293,135,1999,2134
2019-02-28,14,3657,5428,2940,10163,10641,1978,53,22855,731,6142,1205,8078,129,2100,2229
2019-02-28,15,3689,5419,2886,10163,10625,2024,53,22895,665,5756,1091,7512,123,2147,2270
2019-02-28,16,3740,5437,2881,10504,10725,2090,52,23398,569,4717,909,6195,130,2157,2287
2019-02-28,17,3794,5494,2923,11286,10917,2213,53,24495,354,2534,557,3445,128,2106,2234
2019-02-28,18,4022,5696,3074,11986,11487,2427,57,25982,95,500,141,736,121,1993,2114
2019-02-28,19,4201,5751,3252,12567,12447,2692,61,27791,0,5,0,5,131,1881,2012
2019-02-28,20,4147,5692,3246,12606,12384,2659,60,27731,0,0,0,0,156,1837,1993
2019-02-28,21,4009,5496,3163,12126,12102,2537,58,26843,0,0,0,0,169,1853,2022
2019-02-28,22,3829,5208,2996,11551,11517,2362,55,25504,0,0,0,0,179,1901,2080
2019-02-28,23,3643,4941,2787,10732,10676,2140,51,23619,0,0,0,0,182,1940,2122
2019-02-28,24,3459,4769,2628,10037,9907,1959,49,21972,0,0,0,0,183,1901,2084
2019-03-01,1,3314,4685,2551,9547,9387,1856,48,20864,0,0,0,0,124,1936,2060
2019-03-01,2,3231,4653,2521,9230,9022,1780,49,20108,0,0,0,0,124,1935,2059
2019-03-01,3,3191,4667,2529,9077,8805,1730,51,19689,0,0,0,0,117,1939,2056
2019-03-01,4,3188,4752,2574,9049,8740,1715,53,19585,0,0,0,0,111,1928,2039
2019-03-01,5,3259,4966,2706,9280,8922,1771,58,20058,0,0,0,0,104,1901,2005
2019-03-01,6,3444,5314,2971,9959,9554,1926,66,21530,0,0,0,0,94,1843,1937
2019-03-01,7,3577,5546,3332,11013,10271,2151,74,23536,18,230,16,264,75,1782,1857
2019-03-01,8,3616,5607,3490,11543,10669,2228,71,24538,167,1459,144,1770,56,1719,1775
2019-03-01,9,3625,5575,3416,11231,10507,2178,64,24008,426,3141,362,3929,40,1640,1680
2019-03-01,10,3612,5528,3303,10859,10399,2098,59,23447,665,4303,612,5580,30,1560,1590
2019-03-01,11,3599,5474,3186,10553,10366,1999,56,23006,852,4920,856,6628,34,1476,1510
2019-03-01,12,3575,5390,3071,10243,10312,1917,53,22552,919,5106,1002,7027,40,1442,1482
2019-03-01,13,3568,5357,2983,10082,10226,1891,51,22277,887,5046,982,6915,46,1511,1557
2019-03-01,14,3572,5310,2915,10067,10307,1919,50,22371,800,4704,886,6390,52,1643,1695
2019-03-01,15,3593,5280,2863,10106,10397,1957,49,22537,688,4042,770,5500,52,1745,1797
2019-03-01,16,3638,5261,2858,10304,10459,2045,49,22883,504,2950,535,3989,51,1765,1816
2019-03-01,17,3687,5303,2917,10741,10645,2161,51,23624,247,1401,245,1893,44,1688,1732
2019-03-01,18,3864,5478,3004,11338,11075,2366,54,24859,56,242,52,350,35,1561,1596
2019-03-01,19,4051,5559,3112,12278,11943,2580,56,26883,1,0,0,1,28,1446,1474
2019-03-01,20,4007,5465,3077,12279,11916,2553,56,26827,0,0,0,0,24,1354,1378
2019-03-01,21,3912,5295,2987,11930,11676,2446,54,26132,0,0,0,0,26,1288,1314
2019-03-01,22,3798,5093,2848,11409,11238,2324,52,25048,0,0,0,0,37,1254,1291
2019-03-01,23,3663,4891,2685,10781,10621,2149,49,23626,0,0,0,0,65,1254,1319
2019-03-01,24,3496,4732,2537,10081,9964,1985,47,22102,0,0,0,0,106,1265,1371
2019-03-02,1,3324,4698,2487,9387,9522,1900,46,20883,0,0,0,0,107,1184,1291
2019-03-02,2,3230,4660,2454,9028,9105,1813,46,20020,0,0,0,0,131,1179,1310
2019-03-02,3,3182,4663,2455,8773,8816,1742,47,19405,0,0,0,0,175,1187,1362
2019-03-02,4,3159,4705,2484,8630,8591,1713,48,19010,0,0,0,0,242,1181,1423
2019-03-02,5,3187,4810,2560,8646,8571,1739,50,19033,0,0,0,0,285,1189,1474
2019-03-02,6,3270,4963,2713,8922,8845,1800,55,19648,0,0,0,0,297,1215,1512
2019-03-02,7,3276,5056,2890,9284,9074,1874,59,20318,16,146,18,180,299,1233,1532
2019-03-02,8,3281,5178,3031,9594,9401,2069,59,21150,153,1086,208,1447,285,1283,1568
2019-03-02,9,3353,5232,3138,9870,9659,2167,57,21778,396,2489,535,3420,285,1378,1663
2019-03-02,10,3406,5234,3134,10016,9925,2204,55,22220,620,3548,808,4976,289,1492,1781
2019-03-02,11,3423,5203,3064,9984,10020,2203,53,22285,801,4231,1005,6037,248,1612,1860
2019-03-02,12,3399,5141,2960,9936,9929,2182,52,22126,887,4581,1117,6585,183,1710,1893
2019-03-02,13,3376,5096,2853,9860,9828,2153,51,21917,890,4756,1115,6761,124,1799,1923
2019-03-02,14,3365,5062,2754,9709,9836,2130,50,21750,894,4931,1088,6913,83,1886,1969
2019-03-02,15,3377,5041,2696,9574,9807,2112,49,21566,895,4827,1039,6761,57,1966,2023
2019-03-02,16,3443,5091,2692,9558,9937,2140,50,21711,847,4042,899,5788,44,2040,2084
2019-03-02,17,3528,5183,2747,9864,10159,2199,53,22301,566,2240,568,3374,39,2068,2107
2019-03-02,18,3726,5391,2849,10488,10440,2299,56,23309,152,479,145,776,37,2010,2047
2019-03-02,19,3922,5511,2966,11290,11150,2537,59,25062,0,2,0,2,34,1916,1950
2019-03-02,20,3870,5453,2946,11344,11280,2525,58,25233,0,0,0,0,33,1824,1857
2019-03-02,21,3780,5313,2873,11061,11065,2420,56,24629,0,0,0,0,30,1752,1782
2019-03-02,22,3657,5124,2760,10669,10632,2294,54,23675,0,0,0,0,30,1709,1739
2019-03-02,23,3560,4925,2615,10121,10129,2123,51,22451,0,0,0,0,36,1646,1682
2019-03-02,24,3420,4768,2500,9507,9520,1964,50,21069,0,0,0,0,40,1540,1580
2019-03-03,1,3296,4720,2444,9068,8795,1835,49,19775,0,0,0,0,24,1471,1495
2019-03-03,2,3217,4689,2419,8725,8500,1745,49,19046,0,0,0,0,27,1433,1460
2019-03-03,3,3182,4686,2425,8501,8294,1695,50,18566,0,0,0,0,33,1469,1502
2019-03-03,4,3166,4723,2455,8422,8202,1683,52,18386,0,0,0,0,41,1517,1558
2019-03-03,5,3188,4809,2536,8433,8164,1697,56,18377,0,0,0,0,49,1545,1594
2019-03-03,6,3247,4918,2674,8602,8286,1753,62,18732,0,0,0,0,58,1565,1623
2019-03-03,7,3237,4980,2842,8842,8370,1797,65,19105,28,361,28,417,82,1592,1674
2019-03-03,8,3235,5088,2994,9208,8429,1855,63,19585,264,1963,243,2470,98,1644,1742
2019-03-03,9,3285,5085,3115,9339,8373,1880,59,19677,642,3935,583,5160,108,1736,1844
2019-03-03,10,3318,5052,3110,9344,8393,1902,57,19725,862,5173,850,6885,120,1889,2009
2019-03-03,11,3319,4990,3026,9174,8322,1887,54,19468,899,5727,1020,7646,139,2096,2235
2019-03-03,12,3317,4968,2923,9067,8262,1840,51,19251,887,5875,1107,7869,168,2325,2493
2019-03-03,13,3328,4912,2834,9058,8291,1788,50,19216,852,5842,1092,7786,202,2507,2709
2019-03-03,14,3341,4906,2772,8993,8376,1791,49,19236,782,5658,1032,7472,237,2606,2843
2019-03-03,15,3373,4921,2722,8985,8430,1797,48,19286,727,5213,953,6893,279,2639,2918
2019-03-03,16,3433,5003,2724,9190,8643,1874,49,19784,671,4235,791,5697,327,2622,2949
2019-03-03,17,3510,5111,2789,9691,9011,2020,52,20800,458,2335,491,3284,352,2574,2926
2019-03-03,18,3718,5343,2918,10504,9674,2231,55,22492,133,495,132,760,375,2488,2863
2019-03-03,19,3933,5485,3057,11540,10881,2479,58,24986,0,2,0,2,405,2400,2805
2019-03-03,20,3917,5450,3062,11762,11095,2506,58,25447,0,0,0,0,445,2348,2793
2019-03-03,21,3843,5299,2981,11419,10971,2403,56,24875,0,0,0,0,488,2327,2815
2019-03-03,22,3710,5072,2833,10882,10507,2250,53,23718,0,0,0,0,518,2322,2840
2019-03-03,23,3577,4865,2652,10133,9871,2056,50,22137,0,0,0,0,503,2334,2837
2019-03-03,24,3417,4748,2523,9431,9220,1890,49,20618,0,0,0,0,463,2343,2806
2019-03-04,1,3324,4823,2523,8922,8769,1819,49,19586,0,0,0,0,383,2353,2736
2019-03-04,2,3247,4817,2522,8653,8490,1747,50,18966,0,0,0,0,338,2330,2668
2019-03-04,3,3214,4851,2549,8519,8334,1700,52,18632,0,0,0,0,287,2289,2576
2019-03-04,4,3226,4960,2627,8547,8297,1690,54,18615,0,0,0,0,245,2187,2432
2019-03-04,5,3297,5210,2784,8809,8607,1745,60,19249,0,0,0,0,202,1920,2122
2019-03-04,6,3479,5612,3095,9534,9383,1913,68,20925,0,0,0,0,162,1644,1806
2019-03-04,7,3628,5863,3483,10697,10284,2143,76,23231,31,401,25,457,124,1617,1741
2019-03-04,8,3667,5903,3665,11273,10735,2239,75,24351,317,2200,219,2736,105,1546,1651
2019-03-04,9,3680,5861,3590,11024,10723,2206,68,24051,744,4385,530,5659,92,1314,1406
2019-03-04,10,3673,5802,3475,10627,10587,2137,63,23447,1016,5625,800,7441,81,1105,1186
2019-03-04,11,3667,5733,3353,10390,10654,2043,60,23180,1128,6095,1007,8230,67,907,974
2019-03-04,12,3646,5653,3221,10128,10547,1969,57,22731,1120,6190,1117,8427,53,745,798
2019-03-04,13,3629,5621,3134,9995,10398,1926,56,22405,1098,6150,1171,8419,43,666,709
2019-03-04,14,3605,5583,3066,9982,10348,1936,55,22356,1085,6022,1192,8299,34,698,732
2019-03-04,15,3600,5561,3011,10017,10403,1978,54,22482,1001,5656,1104,7761,28,838,866
2019-03-04,16,3623,5581,3011,10234,10477,2085,54,22878,797,4679,911,6387,28,1001,1029
2019-03-04,17,3655,5674,3083,10731,10720,2237,56,23774,431,2600,554,3585,34,1109,1143
2019-03-04,18,3874,5876,3211,11445,11296,2465,59,25293,91,562,136,789,48,1172,1220
2019-03-04,19,4105,5982,3373,12433,12278,2730,62,27534,1,5,0,6,56,1147,1203
2019-03-04,20,4095,5911,3351,12530,12367,2721,61,27709,0,0,0,0,64,1018,1082
2019-03-04,21,3998,5710,3248,12125,11995,2592,59,26798,0,0,0,0,70,838,908
2019-03-04,22,3832,5404,3064,11495,11394,2419,56,25390,0,0,0,0,73,654,727
2019-03-04,23,3648,5138,2842,10667,10589,2182,52,23516,0,0,0,0,68,508,576
2019-03-04,24,3470,4968,2673,9946,9852,1983,50,21858,0,0,0,0,53,397,450
2019-03-05,1,3355,4858,2573,9542,9297,1861,51,20778,0,0,0,0,42,373,415
2019-03-05,2,3279,4835,2554,9218,9041,1799,52,20137,0,0,0,0,32,301,333
2019-03-05,3,3244,4864,2567,9047,8873,1745,54,19748,0,0,0,0,26,220,246
2019-03-05,4,3247,4949,2616,9051,8881,1742,57,19758,0,0,0,0,22,151,173
2019-03-05,5,3316,5182,2751,9327,9198,1812,62,20427,0,0,0,0,22,104,126
2019-03-05,6,3484,5575,3051,10032,9955,1992,72,22078,0,0,0,0,22,84,106
2019-03-05,7,3609,5815,3428,11140,10867,2221,80,24335,12,415,21,448,25,60,85
2019-03-05,8,3643,5825,3588,12039,11370,2272,77,25785,78,2087,152,2317,26,51,77
2019-03-05,9,3641,5753,3497,11957,11050,2152,69,25257,212,3952,352,4516,24,55,79
2019-03-05,10,3637,5675,3378,11819,10815,2022,63,24747,303,4979,529,5811,23,76,99
2019-03-05,11,3633,5592,3246,11567,10782,1915,59,24351,355,5385,646,6386,34,104,138
2019-03-05,12,3626,5506,3129,11452,10681,1830,56,24048,450,5501,752,6703,72,160,232
2019-03-05,13,3615,5471,3044,11291,10607,1817,54,23799,487,5474,736,6697,136,247,383
2019-03-05,14,3618,5438,2983,11215,10676,1858,53,23832,414,5345,615,6374,189,347,536
2019-03-05,15,3637,5415,2936,11164,10764,1920,52,23929,333,4934,522,5789,228,507,735
2019-03-05,16,3684,5436,2939,11149,10900,2028,51,24157,230,3916,356,4502,260,636,896
2019-03-05,17,3740,5513,3006,11336,10960,2170,53,24549,116,2058,169,2343,328,594,922
2019-03-05,18,3936,5719,3120,11894,11338,2402,57,25717,37,405,45,487,423,515,938
2019-03-05,19,4169,5815,3267,12688,12250,2674,61,27700,1,3,0,4,491,513,1004
2019-03-05,20,4138,5757,3242,12780,12260,2666,60,27792,0,0,0,0,507,482,989
2019-03-05,21,4023,5563,3141,12351,11908,2553,58,26896,0,0,0,0,490,460,950
2019-03-05,22,3828,5261,2969,11688,11347,2375,55,25490,0,0,0,0,430,469,899
2019-03-05,23,3630,4989,2751,10753,10556,2141,51,23528,0,0,0,0,375,463,838
2019-03-05,24,3440,4810,2584,10000,9834,1955,48,21864,0,0,0,0,336,463,799
2019-03-06,1,3272,4681,2465,9591,9633,1899,49,21199,0,0,0,0,314,539,853
2019-03-06,2,3191,4645,2434,9233,9279,1822,49,20411,0,0,0,0,352,615,967
2019-03-06,3,3152,4653,2438,9032,9037,1779,51,19926,0,0,0,0,404,823,1227
2019-03-06,4,3148,4728,2480,9014,9030,1764,53,19887,0,0,0,0,421,1051,1472
2019-03-06,5,3211,4943,2602,9250,9275,1816,57,20424,0,0,0,0,405,1157,1562
2019-03-06,6,3376,5317,2877,9891,9989,1982,64,21953,0,0,0,0,387,1160,1547
2019-03-06,7,3497,5557,3246,10958,10889,2228,70,24172,28,314,28,370,380,1091,1471
2019-03-06,8,3539,5596,3393,11659,11423,2334,69,25513,251,1645,277,2173,384,1042,1426
2019-03-06,9,3550,5569,3314,11731,11623,2305,65,25755,627,3184,683,4494,427,1054,1481
2019-03-06,10,3550,5533,3208,11685,11747,2306,61,25831,862,4066,947,5875,480,1124,1604
2019-03-06,11,3559,5494,3097,11670,11827,2315,59,25903,922,4530,1063,6515,492,1273,1765
2019-03-06,12,3562,5438,2992,11609,11813,2298,57,25810,945,4825,1131,6901,488,1469,1957
2019-03-06,13,3573,5431,2916,11644,11693,2288,56,25712,965,4899,1141,7005,532,1695,2227
2019-03-06,14,3595,5418,2863,11664,11598,2289,54,25635,988,4781,1102,6871,583,1852,2435
2019-03-06,15,3635,5417,2824,11624,11421,2273,52,25398,985,4439,1004,6428,601,1874,2475
2019-03-06,16,3683,5446,2830,11709,11465,2323,52,25578,882,3485,774,5141,573,1811,2384
2019-03-06,17,3732,5509,2882,11925,11614,2402,53,26022,563,1809,424,2796,503,1705,2208
2019-03-06,18,3887,5666,2984,12355,12033,2591,56,27062,155,341,99,595,437,1565,2002
2019-03-06,19,4119,5755,3132,13091,12852,2784,60,28813,0,2,0,2,379,1404,1783
2019-03-06,20,4096,5688,3109,13118,12866,2756,60,28826,0,0,0,0,337,1292,1629
2019-03-06,21,3999,5485,3018,12625,12478,2621,58,27809,0,0,0,0,324,1241,1565
2019-03-06,22,3826,5182,2860,11902,11813,2439,55,26236,0,0,0,0,308,1231,1539
2019-03-06,23,3631,4910,2653,11009,10993,2195,52,24275,0,0,0,0,297,1252,1549
2019-03-06,24,3432,4731,2490,10212,10161,1995,50,22444,0,0,0,0,292,1272,1564
2019-03-07,1,3295,4622,2442,9756,9499,1859,51,21191,0,0,0,0,343,1598,1941
2019-03-07,2,3211,4579,2411,9409,9174,1789,51,20446,0,0,0,0,326,1631,1957
2019-03-07,3,3168,4588,2417,9222,8968,1730,53,19996,0,0,0,0,315,1621,1936
2019-03-07,4,3174,4671,2458,9198,8934,1716,55,19928,0,0,0,0,331,1615,1946
2019-03-07,5,3246,4893,2587,9446,9226,1771,61,20527,0,0,0,0,325,1598,1923
2019-03-07,6,3418,5273,2868,10119,9990,1941,69,22143,0,0,0,0,287,1542,1829
2019-03-07,7,3541,5511,3259,11304,10850,2195,77,24450,42,483,48,573,248,1432,1680
2019-03-07,8,3573,5557,3417,12017,11211,2278,74,25604,275,2560,349,3184,216,1271,1487
2019-03-07,9,3582,5535,3331,11969,11083,2239,68,25387,600,4925,784,6309,194,1081,1275
2019-03-07,10,3584,5507,3211,11752,10938,2190,63,24972,757,6138,1042,7937,178,931,1109
2019-03-07,11,3582,5466,3100,11661,10895,2129,60,24774,780,6531,1123,8434,163,886,1049
2019-03-07,12,3578,5403,2990,11572,10794,2060,57,24512,793,6598,1175,8566,152,976,1128
2019-03-07,13,3579,5397,2917,11431,10646,2014,56,24175,758,6520,1130,8408,153,1140,1293
2019-03-07,14,3596,5382,2863,11377,10577,2013,54,24050,662,6332,989,7983,159,1327,1486
2019-03-07,15,3623,5371,2819,11349,10563,2027,53,24021,569,5874,859,7302,176,1484,1660
2019-03-07,16,3660,5392,2796,11487,10556,2081,53,24206,463,4794,716,5973,211,1566,1777
2019-03-07,17,3714,5436,2852,11761,10684,2201,54,24728,291,2664,457,3412,242,1547,1789
2019-03-07,18,3864,5593,2960,12074,11205,2397,57,25760,87,548,125,760,279,1483,1762
2019-03-07,19,4101,5689,3126,12895,12163,2639,61,27785,1,3,0,4,339,1424,1763
2019-03-07,20,4079,5628,3118,13054,12224,2633,60,27998,0,0,0,0,403,1398,1801
2019-03-07,21,3988,5442,3033,12707,11964,2523,59,27279,0,0,0,0,455,1408,1863
2019-03-07,22,3824,5148,2875,12056,11427,2353,57,25919,0,0,0,0,498,1458,1956
2019-03-07,23,3641,4888,2676,11180,10548,2127,53,23934,0,0,0,0,541,1604,2145
2019-03-07,24,3453,4720,2524,10400,9988,1946,52,22413,0,0,0,0,569,1821,2390
2019-03-08,1,3348,4684,2448,9850,9649,1873,58,21443,0,0,0,0,558,1967,2525
2019-03-08,2,3268,4645,2420,9530,9327,1797,59,20727,0,0,0,0,581,2171,2752
2019-03-08,3,3227,4655,2420,9337,9144,1748,61,20303,0,0,0,0,592,2365,2957
2019-03-08,4,3229,4733,2460,9325,9097,1739,63,20227,0,0,0,0,597,2483,3080
2019-03-08,5,3306,4935,2582,9615,9378,1792,68,20857,0,0,0,0,600,2519,3119
2019-03-08,6,3488,5286,2846,10329,10122,1958,75,22487,0,0,0,0,598,2530,3128
2019-03-08,7,3610,5520,3219,11438,10961,2180,82,24685,72,569,52,693,588,2541,3129
2019-03-08,8,3646,5584,3382,11979,11330,2252,79,25663,487,2760,390,3637,537,2602,3139
2019-03-08,9,3655,5570,3313,11693,11214,2203,74,25211,977,5100,862,6939,473,2769,3242
2019-03-08,10,3644,5547,3201,11292,10946,2126,69,24459,1191,6233,1140,8564,420,2934,3354
2019-03-08,11,3640,5515,3091,10983,10869,2041,66,23985,1196,6574,1219,8989,394,3021,3415
2019-03-08,12,3613,5453,2979,10726,10795,1969,63,23577,1126,6615,1235,8976,400,3084,3484
2019-03-08,13,3597,5435,2897,10578,10645,1922,59,23229,1045,6542,1154,8741,428,3120,3548
2019-03-08,14,3594,5413,2834,10548,10547,1902,58,23080,912,6406,969,8287,460,3146,3606
2019-03-08,15,3613,5399,2786,10517,10383,1908,57,22887,814,6074,828,7716,511,3148,3659
2019-03-08,16,3646,5408,2744,10668,10319,2007,57,23076,737,5145,654,6536,549,3115,3664
2019-03-08,17,3732,5454,2806,11093,10549,2158,58,23881,508,3056,394,3958,570,3005,3575
2019-03-08,18,3875,5581,2893,11694,11181,2383,64,25344,150,694,106,950,576,2812,3388
2019-03-08,19,4075,5648,3029,12474,12103,2619,71,27288,0,1,0,1,576,2675,3251
2019-03-08,20,4050,5562,3007,12596,12095,2589,73,27374,0,0,0,0,544,2687,3231
2019-03-08,21,3974,5388,2929,12308,11846,2478,72,26726,0,0,0,0,508,2798,3306
2019-03-08,22,3871,5168,2795,11812,11415,2360,69,25679,0,0,0,0,461,2886,3347
2019-03-08,23,3728,4955,2624,11145,10772,2185,67,24182,0,0,0,0,400,2884,3284
2019-03-08,24,3566,4790,2484,10457,10178,2018,66,22731,0,0,0,0,335,2816,3151
2019-03-09,1,3417,4685,2417,9924,9780,1930,66,21709,0,0,0,0,163,2549,2712
2019-03-09,2,3345,4650,2382,9591,9419,1847,67,20936,0,0,0,0,121,2345,2466
2019-03-09,3,3306,4655,2378,9358,9177,1786,68,20398,0,0,0,0,97,2241,2338
2019-03-09,4,3304,4700,2404,9254,9165,1765,71,20264,0,0,0,0,100,2228,2328
2019-03-09,5,3353,4801,2478,9307,9303,1803,74,20496,0,0,0,0,130,2244,2374
2019-03-09,6,3448,4970,2616,9582,9605,1873,80,21147,0,0,0,0,173,2229,2402
2019-03-09,7,3442,5069,2797,10169,9725,1952,87,21944,82,641,69,792,219,2135,2354
2019-03-09,8,3439,5180,2934,10335,9801,1963,84,22189,490,2998,453,3941,214,1939,2153
2019-03-09,9,3472,5222,3023,10226,9714,1970,77,21992,950,5372,943,7265,197,1630,1827
2019-03-09,10,3482,5225,3010,10107,9478,1946,71,21607,1135,6526,1254,8915,189,1315,1504
2019-03-09,11,3456,5186,2941,9925,9332,1892,66,21223,1149,6915,1399,9463,196,1145,1341
2019-03-09,12,3407,5112,2836,9735,9197,1826,61,20827,1103,6938,1440,9481,227,1176,1403
2019-03-09,13,3352,5050,2738,9632,9082,1787,58,20566,1005,6801,1364,9170,253,1341,1594
2019-03-09,14,3320,5009,2647,9620,8988,1762,58,20434,822,6486,1149,8457,241,1549,1790
2019-03-09,15,3334,4991,2586,9636,8902,1791,57,20392,660,5898,943,7501,193,1710,1903
2019-03-09,16,3375,5051,2582,9846,9042,1898,58,20852,508,4712,708,5928,160,1794,1954
2019-03-09,17,3485,5152,2633,10224,9462,2039,61,21793,285,2592,383,3260,130,1775,1905
2019-03-09,18,3684,5327,2724,10942,10236,2297,65,23545,77,552,95,724,103,1667,1770
2019-03-09,19,3915,5457,2865,11690,11210,2518,69,25494,0,1,0,1,84,1566,1650
2019-03-09,20,3892,5426,2864,11888,11340,2526,70,25829,0,0,0,0,80,1539,1619
2019-03-09,21,3833,5305,2793,11637,11168,2438,70,25319,0,0,0,0,85,1581,1666
2019-03-09,22,3733,5100,2685,11282,10847,2318,68,24521,0,0,0,0,86,1648,1734
2019-03-09,23,3617,4885,2539,10674,10318,2149,65,23214,0,0,0,0,82,1694,1776
2019-03-09,24,3492,4730,2418,10070,9818,1991,64,21948,0,0,0,0,79,1696,1775
2019-03-10,1,3426,4699,2365,9694,9628,1956,62,21346,0,0,0,0,152,1624,1776
2019-03-10,2,3350,4648,2328,9341,9269,1869,61,20546,0,0,0,0,148,1595,1743
2019-03-10,3,3350,4648,2328,9341,9269,1869,61,20546,0,0,0,0,148,1595,1743
2019-03-10,4,3294,4652,2348,9056,8955,1791,63,19873,0,0,0,0,145,1508,1653
2019-03-10,5,3303,4707,2402,9052,8922,1803,65,19849,0,0,0,0,133,1396,1529
2019-03-10,6,3348,4819,2506,9172,9042,1846,69,20136,0,0,0,0,121,1323,1444
2019-03-10,7,3442,4992,2657,9545,9372,1936,76,20941,0,0,0,0,110,1270,1380
2019-03-10,8,3383,5107,2846,9897,9440,1963,78,21385,70,486,58,614,101,1186,1287
2019-03-10,9,3375,5125,2999,9895,9255,1946,76,21178,418,2263,392,3073,86,1056,1142
2019-03-10,10,3400,5117,3044,9711,8953,1890,72,20630,878,4130,858,5866,66,875,941
2019-03-10,11,3408,5073,3005,9460,8661,1848,69,20043,1141,5252,1192,7585,51,724,775
2019-03-10,12,3373,5067,2878,9226,8442,1713,66,19455,1217,5736,1363,8316,41,638,679
2019-03-10,13,3351,5013,2790,8992,8379,1655,62,19095,1208,5791,1418,8417,37,634,671
2019-03-10,14,3341,5018,2708,8841,8317,1640,60,18862,1189,5616,1394,8199,36,684,720
2019-03-10,15,3355,5023,2643,8855,8214,1618,59,18753,1168,5113,1299,7580,43,798,841
2019-03-10,16,3409,5073,2601,9069,8392,1733,60,19264,1112,4462,1163,6737,59,955,1014
2019-03-10,17,3491,5107,2611,9599,8861,1922,61,20451,976,3469,956,5401,78,1106,1184
2019-03-10,18,3562,5111,2658,10291,9546,2165,63,22074,622,1869,584,3075,82,1180,1262
2019-03-10,19,3705,5289,2721,10804,10151,2355,65,23381,171,404,152,727,75,1183,1258
2019-03-10,20,3952,5476,2902,11812,11126,2598,70,25613,0,0,0,0,76,1173,1249
2019-03-10,21,3936,5378,2900,12018,11352,2587,71,26036,0,0,0,0,95,1160,1255
2019-03-10,22,3816,5149,2768,11612,11089,2448,69,25226,0,0,0,0,118,1130,1248
2019-03-10,23,3711,4898,2581,10870,10529,2236,66,23708,0,0,0,0,147,1059,1206
2019-03-10,24,3540,4724,2425,10112,9927,2040,63,22148,0,0,0,0,159,942,1101
2019-03-11,1,3439,4639,2269,9396,9399,1889,61,20753,0,0,0,0,134,683,817
2019-03-11,2,3357,4621,2246,9107,9115,1816,60,20107,0,0,0,0,142,580,722
2019-03-11,3,3319,4640,2265,8946,8949,1772,62,19737,0,0,0,0,141,409,550
2019-03-11,4,3325,4742,2316,8978,8969,1764,65,19784,0,0,0,0,130,238,368
2019-03-11,5,3387,4966,2445,9289,9299,1822,69,20486,0,0,0,0,122,151,273
2019-03-11,6,3559,5356,2722,9952,10054,1989,77,22080,0,0,0,0,114,156,270
2019-03-11,7,3821,5727,3112,11196,11183,2279,87,24757,0,0,0,0,111,193,304
2019-03-11,8,3818,5768,3337,12049,11629,2471,88,26246,101,565,73,739,117,230,347
2019-03-11,9,3793,5749,3299,11579,11482,2431,83,25585,556,2537,452,3545,123,279,402
2019-03-11,10,3763,5710,3219,10923,11206,2304,76,24519,1055,4525,941,6521,133,385,518
2019-03-11,11,3734,5658,3122,10389,10848,2215,72,23528,1258,5481,1241,7980,142,524,666
2019-03-11,12,3692,5589,2994,10050,10553,2115,68,22793,1292,5645,1384,8321,141,650,791
2019-03-11,13,3651,5558,2907,9748,10291,2024,64,22134,1279,5583,1437,8299,121,704,825
2019-03-11,14,3612,5516,2827,9625,10171,1973,61,21838,1276,5295,1429,8000,87,686,773
2019-03-11,15,3594,5475,2750,9624,10164,1935,60,21789,1276,4694,1371,7341,65,659,724
2019-03-11,16,3600,5461,2699,9837,10299,2018,59,22220,1259,4071,1280,6610,57,619,676
2019-03-11,17,3637,5457,2686,10460,10526,2115,60,23167,1223,3142,1123,5488,57,553,610
2019-03-11,18,3701,5437,2734,10976,10949,2278,62,24276,918,1703,753,3374,56,494,550
2019-03-11,19,3884,5588,2790,11480,11427,2413,63,25392,295,397,220,912,75,617,692
2019-03-11,20,4148,5749,2941,12340,12249,2652,67,27319,0,0,0,0,130,861,991
2019-03-11,21,4105,5607,2947,12458,12322,2621,67,27480,0,0,0,0,179,1055,1234
2019-03-11,22,3954,5304,2791,11954,11872,2465,66,26369,0,0,0,0,215,1182,1397
2019-03-11,23,3800,5009,2579,11165,11060,2229,63,24529,0,0,0,0,242,1288,1530
2019-03-11,24,3612,4802,2393,10412,10307,2032,60,22821,0,0,0,0,263,1367,1630
2019-03-12,1,3444,4694,2301,9895,9695,1919,58,21579,0,0,0,0,334,1178,1512
2019-03-12,2,3352,4657,2256,9552,9326,1833,57,20782,0,0,0,0,367,1139,1506
2019-03-12,3,3311,4664,2248,9361,9123,1779,58,20335,0,0,0,0,374,1171,1545
2019-03-12,4,3303,4751,2271,9339,9073,1770,60,20255,0,0,0,0,363,1273,1636
2019-03-12,5,3360,4958,2363,9581,9320,1827,63,20800,0,0,0,0,360,1339,1699
2019-03-12,6,3518,5341,2607,10225,9993,1983,70,22278,0,0,0,0,403,1332,1735
2019-03-12,7,3745,5685,2950,11404,11075,2261,77,24825,0,0,0,0,486,1291,1777
2019-03-12,8,3732,5709,3156,12267,11544,2348,81,26249,107,424,100,631,568,1220,1788
2019-03-12,9,3704,5666,3127,11896,11316,2275,77,25575,544,2152,575,3271,602,1150,1752
2019-03-12,10,3690,5606,3080,11475,11043,2162,74,24762,965,4117,1114,6196,570,1125,1695
2019-03-12,11,3682,5545,3007,11070,10846,2064,71,24058,1111,5220,1382,7713,536,1255,1791
2019-03-12,12,3660,5465,2926,10674,10623,1969,68,23341,1138,5759,1490,8387,526,1514,2040
2019-03-12,13,3635,5433,2875,10301,10493,1913,66,22780,1127,5974,1519,8620,548,1793,2341
2019-03-12,14,3635,5393,2816,10130,10522,1904,65,22628,1106,5995,1509,8610,572,2101,2673
2019-03-12,15,3652,5355,2762,10007,10576,1931,63,22585,1052,6001,1496,8549,511,2412,2923
2019-03-12,16,3695,5340,2720,10053,10688,2002,62,22811,993,5829,1451,8273,420,2682,3102
2019-03-12,17,3744,5326,2730,10403,10867,2112,62,23449,877,5149,1233,7259,354,2870,3224
2019-03-12,18,3841,5322,2761,10823,11095,2269,63,24263,554,3208,743,4505,292,2956,3248
2019-03-12,19,3950,5476,2810,11558,11365,2420,65,25417,153,785,193,1131,282,2973,3255
2019-03-12,20,4157,5648,2949,12561,12221,2658,69,27516,0,1,0,1,367,2971,3338
2019-03-12,21,4107,5516,2934,12659,12290,2628,69,27653,0,0,0,0,481,2942,3423
2019-03-12,22,3945,5223,2780,12131,11846,2467,66,26519,0,0,0,0,615,2877,3492
2019-03-12,23,3785,4940,2571,11280,11061,2226,61,24637,0,0,0,0,747,2808,3555
2019-03-12,24,3582,4746,2386,10481,10296,2019,58,22861,0,0,0,0,822,2748,3570
2019-03-13,1,3412,4644,2244,9862,9765,1887,56,21577,0,0,0,0,811,2839,3650
2019-03-13,2,3312,4617,2202,9506,9367,1803,56,20740,0,0,0,0,844,2699,3543
2019-03-13,3,3264,4620,2194,9300,9136,1745,57,20245,0,0,0,0,865,2604,3469
2019-03-13,4,3254,4706,2227,9281,9078,1729,58,20153,0,0,0,0,874,2572,3446
2019-03-13,5,3311,4917,2334,9533,9313,1777,62,20693,0,0,0,0,891,2554,3445
2019-03-13,6,3472,5295,2595,10178,9997,1931,70,22182,0,0,0,0,904,2531,3435
2019-03-13,7,3707,5631,2971,11352,11135,2206,78,24777,0,0,0,0,911,2502,3413
2019-03-13,8,3704,5664,3198,12165,11536,2301,82,26089,144,863,117,1124,927,2388,3315
2019-03-13,9,3675,5624,3153,11658,11149,2231,78,25126,696,3528,621,4845,919,2078,2997
2019-03-13,10,3662,5585,3078,10859,10806,2129,73,23875,1199,5942,1163,8304,906,1651,2557
2019-03-13,11,3668,5553,2985,10226,10598,2039,70,22938,1347,6909,1419,9675,895,1210,2105
2019-03-13,12,3649,5490,2866,9714,10335,1954,68,22078,1369,7182,1526,10077,859,856,1715
2019-03-13,13,3630,5479,2782,9326,10186,1905,65,21488,1355,7197,1575,10127,807,718,1525
2019-03-13,14,3632,5437,2710,9167,10166,1903,61,21313,1346,7163,1566,10075,734,758,1492
2019-03-13,15,3653,5415,2649,9037,10195,1932,60,21238,1351,7141,1561,10053,652,868,1520
2019-03-13,16,3701,5410,2606,9181,10347,1986,59,21581,1354,6916,1518,9788,578,975,1553
2019-03-13,17,3745,5398,2587,9779,10750,2093,59,22685,1317,6124,1355,8796,518,1045,1563
2019-03-13,18,3784,5375,2634,10608,11155,2233,60,24062,981,3770,936,5687,436,1068,1504
2019-03-13,19,3924,5522,2702,11398,11472,2391,62,25329,313,878,288,1479,360,1074,1434
2019-03-13,20,4162,5677,2860,12278,12391,2640,67,27381,0,4,0,4,315,997,1312
2019-03-13,21,4129,5532,2876,12496,12410,2604,68,27583,0,0,0,0,291,812,1103
2019-03-13,22,3976,5238,2734,12028,11941,2450,66,26492,0,0,0,0,290,551,841
2019-03-13,23,3816,4951,2536,11248,11158,2221,63,24697,0,0,0,0,305,345,650
2019-03-13,24,3617,4765,2365,10490,10405,2029,61,22991,0,0,0,0,316,285,601
2019-03-14,1,3434,4720,2255,9941,9800,1886,62,21699,0,0,0,0,475,288,763
2019-03-14,2,3350,4689,2223,9538,9287,1817,63,20713,0,0,0,0,479,256,735
2019-03-14,3,3312,4699,2222,9251,9009,1758,65,20093,0,0,0,0,458,250,708
2019-03-14,4,3319,4784,2258,9161,8840,1741,67,19821,0,0,0,0,416,261,677
2019-03-14,5,3392,4994,2366,9277,8969,1796,72,20125,0,0,0,0,360,284,644
2019-03-14,6,3561,5376,2633,9837,9535,1961,80,21422,0,0,0,0,313,294,607
2019-03-14,7,3801,5711,3005,11024,10661,2254,89,24035,0,0,0,0,287,296,583
2019-03-14,8,3791,5734,3220,12310,11677,2324,92,26410,150,971,128,1249,288,304,592
2019-03-14,9,3734,5687,3166,11840,11093,2071,85,25096,699,3745,668,5112,277,321,598
2019-03-14,10,3687,5616,3080,10891,10657,1902,78,23532,1192,6066,1205,8463,267,384,651
2019-03-14,11,3644,5538,2982,10215,10400,1768,73,22463,1345,6968,1446,9759,285,463,748
2019-03-14,12,3596,5443,2853,9754,10086,1639,70,21554,1366,7223,1548,10137,264,521,785
2019-03-14,13,3560,5411,2763,9376,9877,1597,66,20923,1344,7236,1571,10151,203,530,733
2019-03-14,14,3551,5367,2681,9290,9924,1623,63,20907,1333,7211,1568,10112,144,496,640
2019-03-14,15,3553,5341,2606,9321,9986,1680,60,21056,1333,7180,1554,10067,100,447,547
2019-03-14,16,3584,5338,2547,9570,10157,1755,59,21546,1323,6937,1512,9772,70,408,478
2019-03-14,17,3646,5326,2519,10142,10558,1945,60,22711,1249,6132,1336,8717,50,371,421
2019-03-14,18,3687,5311,2552,10861,11057,2231,61,24215,886,3736,853,5475,41,340,381
2019-03-14,19,3829,5469,2614,11405,11503,2356,63,25330,275,855,237,1367,39,327,366
2019-03-14,20,4074,5646,2767,12272,12383,2602,68,27330,0,6,0,6,42,316,358
2019-03-14,21,4056,5523,2793,12456,12408,2576,70,27516,0,0,0,0,45,319,364
2019-03-14,22,3918,5252,2668,11990,11945,2434,69,26445,0,0,0,0,46,330,376
2019-03-14,23,3779,4981,2476,11217,11165,2216,66,24668,0,0,0,0,46,343,389
2019-03-14,24,3590,4806,2311,10487,10389,2032,64,22978,0,0,0,0,44,365,409
2019-03-15,1,3450,4791,2175,9771,9636,1888,60,21384,0,0,0,0,50,494,544
2019-03-15,2,3375,4755,2135,9419,9299,1806,62,20616,0,0,0,0,51,533,584
2019-03-15,3,3340,4763,2130,9246,9055,1763,64,20155,0,0,0,0,48,546,594
2019-03-15,4,3341,4847,2158,9232,8995,1752,66,20061,0,0,0,0,43,531,574
2019-03-15,5,3411,5051,2256,9492,9235,1810,71,20615,0,0,0,0,59,494,553
2019-03-15,6,3579,5408,2495,10129,9974,1966,79,22154,0,0,0,0,111,456,567
2019-03-15,7,3819,5722,2845,11303,11085,2304,90,24787,0,2,0,2,182,442,624
2019-03-15,8,3792,5758,3056,12043,11397,2361,89,25896,146,872,123,1141,226,454,680
2019-03-15,9,3739,5717,3017,10964,10436,2207,81,23697,681,3374,630,4685,194,502,696
2019-03-15,10,3681,5646,2938,10172,9865,1958,72,22073,1179,5695,1162,8036,115,615,730
2019-03-15,11,3627,5564,2836,9543,9509,1806,65,20930,1342,6808,1434,9584,68,769,837
2019-03-15,12,3566,5458,2715,9056,9278,1639,60,20039,1364,7181,1547,10092,55,862,917
2019-03-15,13,3517,5403,2618,8600,9141,1517,56,19320,1351,7232,1582,10165,46,880,926
2019-03-15,14,3483,5352,2535,8415,9190,1503,54,19168,1349,7156,1579,10084,34,838,872
2019-03-15,15,3468,5306,2458,8336,9192,1542,52,19129,1354,6956,1575,9885,24,755,779
2019-03-15,16,3483,5272,2390,8477,9364,1615,52,19515,1342,6559,1541,9442,21,666,687
2019-03-15,17,3541,5231,2351,9043,9708,1799,53,20610,1299,5628,1393,8320,23,560,583
2019-03-15,18,3565,5226,2374,9786,10207,2048,55,22103,975,3411,944,5330,27,435,462
2019-03-15,19,3680,5353,2410,10651,10656,2246,56,23617,319,804,281,1404,32,325,357
2019-03-15,20,3922,5505,2545,11473,11421,2481,60,25442,0,5,0,5,38,267,305
2019-03-15,21,3918,5415,2577,11713,11521,2461,61,25765,0,0,0,0,47,264,311
2019-03-15,22,3837,5215,2479,11453,11341,2369,60,25230,0,0,0,0,62,288,350
2019-03-15,23,3752,4990,2337,10882,10769,2199,58,23917,0,0,0,0,82,329,411
2019-03-15,24,3587,4802,2190,10243,10118,2021,57,22464,0,0,0,0,90,364,454
2019-03-16,1,3475,4633,2085,9590,9405,1894,55,20950,0,0,0,0,90,354,444
2019-03-16,2,3381,4585,2038,9202,9002,1813,56,20078,0,0,0,0,92,367,459
2019-03-16,3,3323,4581,2026,8950,8734,1753,58,19501,0,0,0,0,86,374,460
2019-03-16,4,3295,4616,2041,8802,8457,1723,60,19048,0,0,0,0,70,371,441
2019-03-16,5,3316,4699,2089,8764,8433,1745,62,19011,0,0,0,0,55,355,410
2019-03-16,6,3390,4841,2201,8917,8563,1801,67,19354,0,0,0,0,43,345,388
2019-03-16,7,3491,5026,2369,9375,9049,1924,74,20429,0,2,0,2,44,344,388
2019-03-16,8,3449,5150,2557,10181,9576,1935,75,21773,159,992,141,1292,51,350,401
2019-03-16,9,3493,5196,2679,9975,9434,1828,71,21316,708,3786,694,5188,53,372,425
2019-03-16,10,3524,5180,2688,9260,9103,1633,66,20069,1197,6127,1226,8550,42,445,487
2019-03-16,11,3497,5127,2614,8875,8898,1509,59,19348,1347,7076,1475,9898,28,563,591
2019-03-16,12,3429,5041,2508,8537,8743,1415,57,18759,1370,7355,1571,10296,20,658,678
2019-03-16,13,3359,4965,2398,8189,8691,1359,57,18302,1361,7402,1596,10359,16,699,715
2019-03-16,14,3345,4902,2292,8025,8743,1345,56,18175,1356,7382,1607,10345,12,686,698
2019-03-16,15,3359,4860,2215,8051,8819,1393,55,18324,1359,7344,1598,10301,10,639,649
2019-03-16,16,3400,4852,2173,8275,9045,1491,55,18873,1354,7087,1567,10008,8,564,572
2019-03-16,17,3476,4860,2146,8895,9577,1706,55,20245,1315,6252,1425,8992,9,471,480
2019-03-16,18,3547,4883,2181,9599,9910,2010,57,21586,999,3985,989,5973,12,371,383
2019-03-16,19,3648,5065,2238,10164,10286,2202,58,22717,332,1051,295,1678,19,298,317
2019-03-16,20,3847,5258,2372,10941,11152,2441,63,24604,0,16,0,16,32,271,303
2019-03-16,21,3825,5197,2398,11271,11105,2402,62,24847,0,0,0,0,43,255,298
2019-03-16,22,3705,5016,2325,10993,10741,2297,60,24097,0,0,0,0,55,255,310
2019-03-16,23,3660,4804,2202,10449,10185,2130,57,22826,0,0,0,0,69,266,335
2019-03-16,24,3507,4620,2073,9814,9559,1965,53,21398,0,0,0,0,76,282,358
2019-03-17,1,3355,4514,1947,9292,9319,1827,51,20496,0,0,0,0,50,286,336
2019-03-17,2,3262,4469,1908,8899,8923,1748,51,19627,0,0,0,0,40,292,332
2019-03-17,3,3215,4455,1904,8693,8681,1696,51,19127,0,0,0,0,30,288,318
2019-03-17,4,3184,4486,1922,8609,8508,1669,53,18844,0,0,0,0,25,276,301
2019-03-17,5,3184,4542,1968,8611,8461,1669,55,18801,0,0,0,0,23,267,290
2019-03-17,6,3222,4642,2061,8746,8571,1729,59,19111,0,0,0,0,23,267,290
2019-03-17,7,3289,4797,2199,9064,8870,1804,67,19810,0,3,0,3,25,271,296
2019-03-17,8,3243,4906,2389,9290,8777,1857,67,19998,163,1020,149,1332,28,271,299
2019-03-17,9,3286,4909,2513,8736,8103,1823,66,18735,711,3790,704,5205,29,268,297
2019-03-17,10,3333,4886,2530,8337,7994,1696,61,18096,1190,6141,1215,8546,26,276,302
2019-03-17,11,3340,4828,2454,7802,7910,1591,57,17368,1336,7053,1471,9860,24,298,322
2019-03-17,12,3337,4805,2350,7430,7964,1525,56,16981,1359,7332,1577,10268,24,309,333
2019-03-17,13,3342,4745,2262,7295,8117,1492,54,16965,1350,7378,1594,10322,23,289,312
2019-03-17,14,3359,4730,2176,7238,8371,1509,53,17180,1340,7365,1597,10302,18,247,265
2019-03-17,15,3410,4726,2105,7353,8656,1555,52,17623,1337,7329,1591,10257,14,204,218
2019-03-17,16,3488,4767,2063,7840,9045,1657,51,18600,1310,7075,1553,9938,11,162,173
2019-03-17,17,3567,4801,2048,8645,9509,1814,51,20026,1220,6257,1398,8875,11,122,133
2019-03-17,18,3647,4818,2105,9410,9999,2041,53,21510,884,4013,951,5848,13,94,107
2019-03-17,19,3738,5002,2184,10159,10418,2271,55,22914,285,1073,276,1634,15,83,98
2019-03-17,20,3942,5203,2350,11046,11336,2404,60,24853,0,18,0,18,17,92,109
2019-03-17,21,3897,5118,2397,11289,11347,2358,58,25059,0,0,0,0,17,109,126
2019-03-17,22,3733,4894,2295,10861,11003,2240,55,24166,0,0,0,0,18,122,140
2019-03-17,23,3560,4663,2134,10163,10343,2060,51,22623,0,0,0,0,23,130,153
2019-03-17,24,3382,4505,1992,9508,9731,1880,48,21172,0,0,0,0,29,132,161
2019-03-18,1,3222,4393,1891,9341,9231,1826,46,20451,0,0,0,0,32,179,211
2019-03-18,2,3132,4378,1867,9026,8866,1748,46,19692,0,0,0,0,31,159,190
2019-03-18,3,3092,4402,1874,8847,8665,1695,46,19260,0,0,0,0,32,124,156
2019-03-18,4,3092,4504,1916,8833,8650,1677,48,19213,0,0,0,0,34,90,124
2019-03-18,5,3149,4724,2031,9080,8931,1723,51,19791,0,0,0,0,42,76,118
2019-03-18,6,3306,5113,2288,9718,9500,1863,58,21145,0,0,0,0,55,79,134
2019-03-18,7,3539,5456,2661,10880,10492,2117,67,23562,0,5,0,5,67,87,154
2019-03-18,8,3548,5505,2892,11347,10759,2207,68,24388,155,1085,149,1389,79,90,169
2019-03-18,9,3554,5472,2857,11195,10820,2174,65,24261,683,3934,694,5311,79,81,160
2019-03-18,10,3562,5427,2787,10792,10719,2009,62,23589,1167,6262,1198,8627,55,72,127
2019-03-18,11,3576,5369,2698,10399,10782,1895,60,23142,1331,7191,1456,9978,35,81,116
2019-03-18,12,3571,5284,2591,10105,10932,1821,58,22923,1355,7460,1578,10393,28,96,124
2019-03-18,13,3599,5246,2520,9937,10941,1777,57,22719,1343,7493,1593,10429,21,108,129
2019-03-18,14,3632,5192,2445,9984,11078,1780,57,22906,1334,7453,1594,10381,20,108,128
2019-03-18,15,3677,5141,2366,10151,11215,1804,56,23235,1324,7309,1527,10160,21,100,121
2019-03-18,16,3724,5110,2302,10424,11434,1897,57,23819,1296,6936,1428,9660,22,102,124
2019-03-18,17,3780,5077,2281,10958,11659,2049,58,24730,1192,6004,1273,8469,24,131,155
2019-03-18,18,3809,5092,2311,11611,11843,2247,58,25765,831,3758,865,5454,24,198,222
2019-03-18,19,3898,5226,2373,12513,12059,2382,57,27018,260,1032,247,1539,32,302,334
2019-03-18,20,4096,5399,2516,13031,12534,2597,61,28230,0,18,0,18,42,398,440
2019-03-18,21,4035,5274,2550,12931,12642,2538,59,28177,0,0,0,0,58,420,478
2019-03-18,22,3844,4986,2429,12134,12129,2386,55,26710,0,0,0,0,69,372,441
2019-03-18,23,3594,4711,2251,11207,11243,2154,51,24661,0,0,0,0,73,308,381
2019-03-18,24,3384,4529,2088,10365,10393,1962,47,22773,0,0,0,0,74,253,327
2019-03-19,1,3207,4465,1975,9643,9746,1875,45,21314,0,0,0,0,220,195,415
2019-03-19,2,3111,4436,1937,9277,9355,1794,45,20475,0,0,0,0,269,174,443
2019-03-19,3,3061,4447,1930,9066,9113,1735,45,19964,0,0,0,0,257,158,415
2019-03-19,4,3050,4536,1958,9020,9030,1717,47,19818,0,0,0,0,214,149,363
2019-03-19,5,3103,4754,2052,9214,9181,1761,50,20211,0,0,0,0,194,135,329
2019-03-19,6,3245,5145,2299,9813,9827,1915,56,21616,0,0,0,0,176,113,289
2019-03-19,7,3465,5470,2660,10904,10742,2182,64,23896,0,8,0,8,138,87,225
2019-03-19,8,3486,5498,2879,11639,10975,2285,67,24973,113,962,113,1188,102,71,173
2019-03-19,9,3498,5438,2830,11503,11022,2207,64,24803,518,3473,550,4541,82,75,157
2019-03-19,10,3514,5378,2749,11078,10968,2013,61,24126,916,5591,1019,7526,65,99,164
2019-03-19,11,3540,5316,2641,10519,10772,1850,58,23207,1085,6602,1311,8998,51,147,198
2019-03-19,12,3565,5230,2549,10092,10604,1725,57,22484,1139,6965,1427,9531,34,201,235
2019-03-19,13,3597,5196,2479,10047,10506,1650,56,22265,1137,6978,1441,9556,24,248,272
2019-03-19,14,3650,5145,2410,9982,10459,1689,55,22190,1111,6829,1390,9330,33,285,318
2019-03-19,15,3709,5103,2344,10003,10516,1743,55,22322,1053,6491,1249,8793,60,333,393
2019-03-19,16,3769,5084,2295,10163,10673,1828,56,22723,949,5937,1067,7953,113,511,624
2019-03-19,17,3815,5041,2277,10478,10810,1988,55,23333,765,4924,804,6493,191,811,1002
2019-03-19,18,3873,5057,2298,10943,11093,2197,55,24290,441,2972,436,3849,290,1069,1359
2019-03-19,19,3926,5194,2346,11533,11508,2433,56,25534,117,767,108,992,363,1260,1623
2019-03-19,20,4112,5381,2454,12266,12366,2634,59,27329,1,12,0,13,447,1389,1836
2019-03-19,21,4070,5259,2495,12304,12313,2583,58,27262,0,0,0,0,501,1465,1966
2019-03-19,22,3873,4980,2380,11760,11841,2421,54,26080,0,0,0,0,574,1474,2048
2019-03-19,23,3582,4707,2203,10897,11103,2186,50,24240,0,0,0,0,547,1418,1965
2019-03-19,24,3355,4523,2045,10162,10340,1988,46,22541,0,0,0,0,395,1385,1780
2019-03-20,1,3181,4437,1952,9788,9781,1874,47,21493,0,0,0,0,141,1317,1458
2019-03-20,2,3082,4409,1911,9416,9393,1792,46,20650,0,0,0,0,159,1274,1433
2019-03-20,3,3032,4425,1898,9195,9141,1737,47,20122,0,0,0,0,218,1268,1486
2019-03-20,4,3020,4513,1920,9120,9053,1720,48,19946,0,0,0,0,296,1265,1561
2019-03-20,5,3072,4729,2011,9332,9256,1763,51,20407,0,0,0,0,346,1242,1588
2019-03-20,6,3211,5108,2258,9906,9895,1916,57,21778,0,0,0,0,353,1175,1528
2019-03-20,7,3433,5428,2613,10952,10954,2190,64,24165,0,11,0,11,350,1112,1462
2019-03-20,8,3459,5454,2824,11853,11419,2319,68,25662,135,673,105,913,369,1069,1438
2019-03-20,9,3463,5398,2783,11880,11623,2319,67,25893,572,2581,519,3672,370,1020,1390
2019-03-20,10,3484,5338,2711,11771,11566,2259,64,25665,999,4323,982,6304,333,969,1302
2019-03-20,11,3504,5276,2621,11507,11438,2177,61,25189,1172,5243,1233,7648,302,977,1279
2019-03-20,12,3506,5185,2536,11244,11259,2094,59,24661,1178,5579,1301,8058,311,1051,1362
2019-03-20,13,3504,5147,2472,10966,11003,2036,57,24067,1133,5628,1312,8073,355,1154,1509
2019-03-20,14,3534,5098,2407,10799,10792,2012,55,23663,1075,5612,1253,7940,427,1290,1717
2019-03-20,15,3594,5053,2345,10667,10699,2006,53,23430,1000,5388,1121,7509,449,1476,1925
2019-03-20,16,3618,5036,2295,10650,10769,2012,52,23488,907,4983,986,6876,437,1683,2120
2019-03-20,17,3625,5004,2273,10856,10887,2102,53,23903,802,4118,830,5750,416,1845,2261
2019-03-20,18,3647,5006,2289,11178,11095,2237,54,24565,572,2473,570,3615,365,1937,2302
2019-03-20,19,3727,5124,2335,11522,11474,2358,55,25412,189,647,175,1011,298,2031,2329
2019-03-20,20,3932,5314,2452,12234,12421,2605,59,27324,0,2,0,2,256,2109,2365
2019-03-20,21,3912,5206,2493,12398,12409,2563,59,27432,0,0,0,0,237,2150,2387
2019-03-20,22,3762,4939,2379,11879,11913,2415,56,26267,0,0,0,0,225,2208,2433
2019-03-20,23,3625,4665,2196,11025,11108,2182,52,24372,0,0,0,0,213,2296,2509
2019-03-20,24,3416,4479,2035,10259,10355,1983,50,22651,0,0,0,0,204,2362,2566
2019-03-21,1,3249,4361,1915,9730,9799,1890,51,21470,0,0,0,0,178,2267,2445
2019-03-21,2,3152,4325,1875,9347,9417,1816,50,20630,0,0,0,0,165,2300,2465
2019-03-21,3,3095,4335,1862,9160,9183,1766,51,20161,0,0,0,0,150,2302,2452
2019-03-21,4,3096,4420,1883,9137,9117,1746,53,20053,0,0,0,0,132,2255,2387
2019-03-21,5,3159,4630,1974,9383,9365,1801,57,20606,0,0,0,0,120,2197,2317
2019-03-21,6,3324,5006,2219,10035,10015,1955,64,22072,0,0,0,0,115,2123,2238
2019-03-21,7,3541,5320,2574,11203,11105,2191,73,24576,0,13,0,13,112,2049,2161
2019-03-21,8,3565,5355,2773,11920,11480,2296,74,25774,170,986,116,1272,106,2015,2121
2019-03-21,9,3565,5318,2736,11563,11373,2294,71,25306,700,3604,557,4861,91,2039,2130
2019-03-21,10,3569,5273,2675,10955,11097,2235,68,24360,1199,5856,1055,8110,72,2142,2214
2019-03-21,11,3573,5223,2587,10500,11061,2168,64,23799,1403,6857,1330,9590,60,2285,2345
2019-03-21,12,3553,5144,2496,10092,10919,2092,62,23171,1433,7112,1398,9943,54,2424,2478
2019-03-21,13,3535,5121,2430,9794,10722,2025,60,22609,1416,7087,1392,9895,59,2557,2616
2019-03-21,14,3545,5078,2364,9679,10555,2006,59,22306,1374,6967,1318,9659,71,2667,2738
2019-03-21,15,3569,5037,2300,9651,10371,1977,57,22063,1297,6648,1182,9127,93,2750,2843
2019-03-21,16,3602,5013,2243,9816,10378,1993,57,22250,1213,6207,1055,8475,127,2822,2949
2019-03-21,17,3644,4953,2216,10198,10561,2073,57,22893,1104,5323,911,7338,173,2863,3036
2019-03-21,18,3646,4957,2225,10671,10836,2272,58,23842,774,3290,630,4694,221,2834,3055
2019-03-21,19,3738,5079,2277,11183,11254,2475,59,24974,241,849,190,1280,258,2725,2983
2019-03-21,20,3968,5268,2387,11996,12216,2594,63,26872,0,6,0,6,295,2599,2894
2019-03-21,21,3950,5152,2433,12234,12283,2561,63,27142,0,0,0,0,340,2521,2861
2019-03-21,22,3806,4885,2321,11763,11858,2417,60,26099,0,0,0,0,375,2487,2862
2019-03-21,23,3669,4619,2145,11018,11093,2197,57,24367,0,0,0,0,393,2486,2879
2019-03-21,24,3473,4436,1999,10318,10332,2002,55,22708,0,0,0,0,388,2539,2927
2019-03-22,1,3340,4366,1901,9402,9645,1884,54,20988,0,0,0,0,391,2782,3173
2019-03-22,2,3259,4332,1860,9069,9305,1807,53,20239,0,0,0,0,323,2744,3067
2019-03-22,3,3216,4340,1846,8889,9105,1756,55,19805,0,0,0,0,254,2648,2902
2019-03-22,4,3218,4415,1866,8861,9040,1739,57,19698,0,0,0,0,191,2490,2681
2019-03-22,5,3287,4609,1956,9105,9307,1790,61,20263,0,0,0,0,132,2325,2457
2019-03-22,6,3460,4958,2187,9820,9931,1947,68,21767,0,0,0,0,85,2197,2282
2019-03-22,7,3666,5269,2509,11115,10989,2200,76,24382,0,17,0,17,65,2069,2134
2019-03-22,8,3660,5317,2715,11898,11285,2290,78,25553,137,1193,131,1461,57,1896,1953
2019-03-22,9,3637,5295,2700,11646,11103,2229,72,25052,540,3945,597,5082,66,1699,1765
2019-03-22,10,3604,5241,2637,11282,10687,2094,66,24130,934,6098,1085,8117,78,1526,1604
2019-03-22,11,3575,5182,2544,10804,10441,1906,61,23214,1131,7042,1360,9533,91,1400,1491
2019-03-22,12,3530,5089,2447,10471,10169,1755,58,22456,1192,7336,1476,10004,103,1336,1439
2019-03-22,13,3504,5055,2368,10197,9921,1677,56,21854,1201,7360,1503,10064,112,1372,1484
2019-03-22,14,3489,5007,2305,10057,9931,1632,55,21679,1167,7311,1455,9933,115,1528,1643
2019-03-22,15,3494,4960,2241,10001,9972,1642,54,21674,1074,7137,1332,9543,116,1791,1907
2019-03-22,16,3519,4910,2187,10065,10156,1717,54,21996,940,6597,1176,8713,120,2073,2193
2019-03-22,17,3562,4863,2152,10366,10394,1858,54,22676,735,5461,957,7153,127,2271,2398
2019-03-22,18,3635,4835,2150,10695,10572,2059,55,23386,405,3277,568,4250,116,2337,2453
2019-03-22,19,3691,4943,2188,11069,10847,2300,56,24275,102,828,149,1079,110,2302,2412
2019-03-22,20,3889,5105,2284,11756,11711,2494,60,26025,0,12,0,12,135,2240,2375
2019-03-22,21,3874,5023,2319,11968,11807,2483,59,26322,0,0,0,0,129,2167,2296
2019-03-22,22,3745,4833,2230,11622,11527,2382,57,25590,0,0,0,0,117,2091,2208
2019-03-22,23,3656,4606,2097,10954,10901,2203,54,24114,0,0,0,0,114,2040,2154
2019-03-22,24,3488,4416,1962,10221,10189,2023,51,22488,0,0,0,0,134,2022,2156
2019-03-23,1,3345,4397,1896,9383,9352,1914,47,20701,0,0,0,0,129,1816,1945
2019-03-23,2,3243,4351,1852,9133,8937,1817,47,19939,0,0,0,0,172,1801,1973
2019-03-23,3,3180,4345,1834,8832,8608,1752,49,19246,0,0,0,0,147,1833,1980
2019-03-23,4,3152,4376,1841,8727,8433,1727,51,18945,0,0,0,0,129,1887,2016
2019-03-23,5,3174,4462,1890,8778,8426,1755,54,19017,0,0,0,0,141,1920,2061
2019-03-23,6,3241,4612,2001,9054,8738,1800,57,19650,0,0,0,0,177,1898,2075
2019-03-23,7,3310,4774,2142,9637,9205,1911,63,20817,0,13,0,13,208,1822,2030
2019-03-23,8,3286,4895,2325,10192,9440,1949,67,21651,41,1136,71,1248,230,1716,1946
2019-03-23,9,3356,4955,2453,10264,9361,1974,64,21667,246,3846,309,4401,237,1673,1910
2019-03-23,10,3405,4945,2461,9878,9190,1930,59,21060,554,5990,572,7116,228,1770,1998
2019-03-23,11,3419,4904,2398,9427,8956,1830,56,20272,823,6887,726,8436,221,2002,2223
2019-03-23,12,3407,4824,2313,9000,8653,1738,54,19449,1018,7106,827,8951,216,2313,2529
2019-03-23,13,3397,4764,2215,8663,8461,1678,52,18859,1104,7065,930,9099,220,2616,2836
2019-03-23,14,3425,4714,2124,8327,8388,1662,51,18438,1158,6939,1012,9109,243,2851,3094
2019-03-23,15,3460,4687,2062,8068,8412,1689,50,18227,1242,6653,1056,8951,274,2997,3271
2019-03-23,16,3547,4687,2026,8136,8621,1773,50,18580,1266,6170,1042,8478,304,3064,3368
2019-03-23,17,3590,4719,2006,8611,8897,1895,52,19459,1219,5270,945,7434,333,3077,3410
2019-03-23,18,3646,4746,2025,9358,9277,2061,53,20753,922,3308,683,4913,352,3044,3396
2019-03-23,19,3704,4881,2061,9890,9692,2213,54,21853,312,884,219,1415,356,2962,3318
2019-03-23,20,3890,5074,2171,10682,10618,2472,57,23833,1,14,0,15,361,2870,3231
2019-03-23,21,3850,5019,2226,11089,10813,2454,57,24416,0,0,0,0,349,2809,3158
2019-03-23,22,3708,4840,2165,10855,10584,2348,55,23847,0,0,0,0,326,2769,3095
2019-03-23,23,3595,4624,2042,10405,10216,2175,52,22852,0,0,0,0,299,2755,3054
2019-03-23,24,3452,4433,1931,9815,9620,1998,50,21488,0,0,0,0,263,2764,3027
2019-03-24,1,3305,4341,1869,9252,9023,1835,49,20160,0,0,0,0,227,2623,2850
2019-03-24,2,3211,4293,1831,8895,8735,1744,49,19425,0,0,0,0,155,2462,2617
2019-03-24,3,3162,4276,1828,8711,8537,1692,50,18991,0,0,0,0,106,2332,2438
2019-03-24,4,3138,4300,1847,8646,8425,1668,51,18795,0,0,0,0,80,2227,2307
2019-03-24,5,3143,4354,1903,8687,8423,1678,54,18845,0,0,0,0,67,1966,2033
2019-03-24,6,3188,4450,2002,8874,8551,1721,58,19210,0,0,0,0,61,1559,1620
2019-03-24,7,3229,4587,2146,9198,8598,1776,66,19637,0,26,0,26,50,1132,1182
2019-03-24,8,3200,4704,2322,9343,8519,1784,68,19714,238,1317,185,1740,39,654,693
2019-03-24,9,3254,4740,2452,9138,8415,1767,66,19388,832,4265,733,5830,27,276,303
2019-03-24,10,3297,4744,2457,8702,8321,1705,61,18794,1259,6441,1218,8918,21,110,131
2019-03-24,11,3315,4715,2363,8211,8176,1601,57,18051,1402,7276,1460,10138,19,74,93
2019-03-24,12,3316,4729,2251,7769,7978,1507,55,17316,1423,7525,1565,10513,14,81,95
2019-03-24,13,3330,4702,2163,7528,7916,1450,54,16954,1407,7539,1588,10534,14,76,90
2019-03-24,14,3361,4705,2073,7449,8016,1465,53,16989,1394,7497,1580,10471,21,61,82
2019-03-24,15,3409,4718,2017,7631,8258,1503,53,17447,1356,7417,1572,10345,29,50,79
2019-03-24,16,3472,4763,1994,8029,8612,1603,53,18300,1268,7109,1529,9906,36,53,89
2019-03-24,17,3552,4776,2004,8647,9036,1779,54,19521,1128,6299,1360,8787,44,80,124
2019-03-24,18,3618,4781,2060,9452,9495,1982,55,20989,763,4123,916,5802,48,136,184
2019-03-24,19,3681,4921,2131,10184,9976,2165,57,22385,237,1149,269,1655,58,209,267
2019-03-24,20,3895,5118,2251,11022,10762,2441,60,24289,1,23,0,24,65,253,318
2019-03-24,21,3880,5033,2318,11355,10823,2432,59,24674,0,0,0,0,60,233,293
2019-03-24,22,3709,4814,2219,10974,10511,2297,56,23845,0,0,0,0,63,174,237
2019-03-24,23,3536,4578,2055,10265,9910,2101,52,22331,0,0,0,0,83,128,211
2019-03-24,24,3354,4420,1916,9588,9326,1918,49,20882,0,0,0,0,99,111,210
2019-03-25,1,3208,4314,1823,9232,8899,1804,46,19991,0,0,0,0,116,69,185
2019-03-25,2,3122,4301,1798,8907,8547,1727,46,19242,0,0,0,0,109,73,182
2019-03-25,3,3082,4327,1800,8748,8396,1677,48,18890,0,0,0,0,84,75,159
2019-03-25,4,3089,4428,1837,8747,8361,1667,51,18856,0,0,0,0,68,75,143
2019-03-25,5,3152,4655,1948,9047,8587,1718,55,19438,0,0,0,0,59,69,128
2019-03-25,6,3322,5045,2202,9707,9225,1868,62,20885,0,0,0,0,58,65,123
2019-03-25,7,3530,5372,2549,10869,10288,2114,71,23356,0,38,0,38,74,79,153
2019-03-25,8,3551,5432,2767,11588,10798,2194,74,24659,207,1409,189,1805,90,90,180
2019-03-25,9,3562,5403,2752,11377,10731,2112,68,24293,744,4327,720,5791,104,86,190
2019-03-25,10,3560,5359,2691,11011,10526,1990,63,23596,1188,6384,1200,8772,105,83,188
2019-03-25,11,3566,5296,2612,10604,10464,1871,60,23004,1373,7197,1457,10027,122,83,205
2019-03-25,12,3559,5211,2528,10262,10403,1780,57,22512,1409,7462,1569,10440,137,80,217
2019-03-25,13,3584,5178,2470,10091,10432,1740,56,22329,1401,7508,1595,10504,162,77,239
2019-03-25,14,3613,5135,2421,10050,10551,1759,56,22423,1388,7474,1595,10457,231,90,321
2019-03-25,15,3663,5099,2363,10102,10761,1802,55,22727,1369,7385,1588,10342,282,137,419
2019-03-25,16,3717,5083,2312,10301,11004,1898,54,23262,1309,7065,1547,9921,327,239,566
2019-03-25,17,3752,5058,2288,10660,11191,2058,55,23967,1198,6262,1391,8851,339,374,713
2019-03-25,18,3809,5069,2335,11199,11464,2232,56,24951,846,4041,946,5833,356,488,844
2019-03-25,19,3869,5156,2399,11722,11875,2365,57,26021,276,1096,283,1655,374,585,959
2019-03-25,20,4070,5312,2496,12316,12397,2577,60,27350,2,26,0,28,372,682,1054
2019-03-25,21,4020,5191,2524,12394,12174,2532,58,27160,0,0,0,0,342,781,1123
2019-03-25,22,3813,4912,2391,11824,11661,2383,55,25924,0,0,0,0,258,887,1145
2019-03-25,23,3590,4630,2206,10940,10844,2154,50,23998,0,0,0,0,191,970,1161
2019-03-25,24,3379,4439,2047,10174,10021,1963,47,22215,0,0,0,0,146,995,1141
2019-03-26,1,3233,4376,1936,9242,9338,1863,49,20507,0,0,0,0,69,849,918
2019-03-26,2,3130,4340,1899,8912,8966,1780,49,19722,0,0,0,0,59,792,851
2019-03-26,3,3076,4348,1891,8750,8706,1739,50,19260,0,0,0,0,47,793,840
2019-03-26,4,3066,4431,1916,8758,8636,1727,52,19189,0,0,0,0,36,841,877
2019-03-26,5,3119,4646,2019,9057,8853,1774,56,19754,0,0,0,0,28,891,919
2019-03-26,6,3268,5034,2273,9713,9625,1935,63,21350,0,0,0,0,24,918,942
2019-03-26,7,3463,5329,2642,10898,10808,2184,72,23976,0,37,0,37,21,874,895
2019-03-26,8,3485,5371,2872,11653,11064,2289,72,25095,158,1103,157,1418,19,723,742
2019-03-26,9,3507,5343,2828,11792,10871,2208,69,24988,608,3515,661,4784,16,516,532
2019-03-26,10,3525,5303,2739,11603,10626,2076,66,24410,1017,5510,1158,7685,15,347,362
2019-03-26,11,3557,5259,2629,11222,10437,1963,64,23706,1201,6479,1435,9115,19,292,311
2019-03-26,12,3598,5194,2532,10805,10308,1852,62,23043,1253,6890,1552,9695,30,378,408
2019-03-26,13,3657,5189,2461,10526,10296,1781,62,22683,1253,6997,1573,9823,48,562,610
2019-03-26,14,3717,5168,2393,10407,10446,1810,61,22742,1235,6913,1557,9705,82,783,865
2019-03-26,15,3771,5148,2326,10280,10597,1871,60,22832,1193,6667,1489,9349,118,1002,1120
2019-03-26,16,3839,5140,2271,10251,10828,1948,60,23110,1109,6169,1366,8644,143,1181,1324
2019-03-26,17,3908,5127,2256,10409,11031,2069,61,23585,971,5189,1154,7314,155,1292,1447
2019-03-26,18,3907,5181,2285,10904,11302,2224,61,24505,660,3139,735,4534,151,1311,1462
2019-03-26,19,3950,5192,2347,11404,11586,2448,62,25515,217,787,217,1221,123,1244,1367
2019-03-26,20,4124,5331,2458,12066,12163,2572,65,26880,1,11,0,12,97,1168,1265
2019-03-26,21,4078,5195,2505,12249,12074,2533,64,26935,0,0,0,0,86,1127,1213
2019-03-26,22,3875,4908,2382,11731,11637,2385,59,25827,0,0,0,0,86,1124,1210
2019-03-26,23,3590,4624,2200,10921,10829,2161,55,23981,0,0,0,0,95,1144,1239
2019-03-26,24,3363,4424,2050,10160,10060,1968,51,22253,0,0,0,0,109,1161,1270
2019-03-27,1,3207,4301,1981,9223,9465,1878,46,20628,0,0,0,0,62,1314,1376
2019-03-27,2,3099,4260,1942,8866,9020,1797,45,19745,0,0,0,0,67,1400,1467
2019-03-27,3,3037,4260,1931,8706,8797,1739,46,19305,0,0,0,0,76,1462,1538
2019-03-27,4,3025,4337,1954,8713,8732,1722,48,19230,0,0,0,0,91,1481,1572
2019-03-27,5,3074,4546,2052,9005,8975,1766,51,19814,0,0,0,0,136,1485,1621
2019-03-27,6,3212,4919,2299,9720,9631,1915,58,21341,0,0,0,0,185,1505,1690
2019-03-27,7,3409,5229,2640,10816,10585,2159,67,23644,0,26,0,26,229,1514,1743
2019-03-27,8,3438,5278,2848,11618,11032,2240,67,24974,82,823,114,1019,263,1508,1771
2019-03-27,9,3462,5273,2815,11856,11189,2189,64,25316,361,2738,470,3569,289,1475,1764
2019-03-27,10,3495,5251,2741,11776,11042,2098,62,24997,693,4445,835,5973,323,1408,1731
2019-03-27,11,3545,5221,2658,11409,10877,2004,59,24368,915,5405,1048,7368,366,1334,1700
2019-03-27,12,3585,5167,2577,11083,10742,1933,57,23830,1024,5832,1132,7988,379,1303,1682
2019-03-27,13,3644,5170,2515,10792,10693,1903,56,23459,1056,6011,1169,8236,416,1369,1785
2019-03-27,14,3701,5156,2456,10621,10687,1926,55,23304,1060,6043,1164,8267,471,1492,1963
2019-03-27,15,3760,5163,2405,10469,10610,1981,54,23128,1090,5870,1148,8108,523,1619,2142
2019-03-27,16,3824,5177,2354,10460,10685,2035,53,23250,1119,5533,1143,7795,602,1753,2355
2019-03-27,17,3888,5193,2328,10741,10774,2142,54,23729,1097,4855,1043,6995,640,1864,2504
2019-03-27,18,3880,5135,2372,11129,11022,2266,54,24486,847,3112,720,4679,604,1869,2473
2019-03-27,19,3914,5183,2417,11517,11298,2397,56,25284,310,852,228,1390,493,1778,2271
2019-03-27,20,4107,5297,2499,12123,11919,2606,59,26722,5,11,0,16,380,1689,2069
2019-03-27,21,4069,5162,2534,12339,11895,2574,58,26883,0,0,0,0,293,1679,1972
2019-03-27,22,3866,4878,2415,11824,11452,2425,54,25771,0,0,0,0,235,1746,1981
2019-03-27,23,3596,4587,2229,10997,10735,2195,50,23992,0,0,0,0,182,1871,2053
2019-03-27,24,3374,4377,2074,10230,9976,1996,47,22264,0,0,0,0,149,2027,2176
2019-03-28,1,3200,4260,1948,9450,9258,1863,47,20636,0,0,0,0,130,2291,2421
2019-03-28,2,3096,4218,1909,9077,8910,1787,46,19837,0,0,0,0,126,2303,2429
2019-03-28,3,3031,4216,1897,8874,8738,1726,46,19401,0,0,0,0,119,2282,2401
2019-03-28,4,3023,4291,1919,8833,8726,1706,47,19330,0,0,0,0,105,2252,2357
2019-03-28,5,3081,4494,2020,8992,8960,1748,51,19769,0,0,0,0,91,2187,2278
2019-03-28,6,3231,4864,2273,9739,9598,1894,58,21306,0,0,0,0,87,2076,2163
2019-03-28,7,3427,5171,2625,11092,10431,2136,65,23742,0,60,0,60,99,1969,2068
2019-03-28,8,3467,5243,2818,11744,10813,2209,68,24851,209,1304,160,1673,106,1910,2016
2019-03-28,9,3492,5247,2780,11538,10689,2158,65,24469,748,3946,638,5332,106,1904,2010
2019-03-28,10,3513,5240,2701,10843,10622,2063,63,23611,1209,6018,1112,8339,115,1950,2065
2019-03-28,11,3541,5228,2602,10171,10422,1964,60,22636,1394,6917,1401,9712,148,2064,2212
2019-03-28,12,3558,5177,2499,9742,10333,1884,59,22040,1421,7281,1545,10247,203,2206,2409
2019-03-28,13,3603,5181,2428,9499,10198,1834,58,21612,1416,7412,1580,10408,277,2342,2619
2019-03-28,14,3658,5150,2366,9434,10230,1830,57,21572,1393,7422,1589,10404,372,2479,2851
2019-03-28,15,3707,5129,2306,9601,10243,1867,56,21786,1343,7293,1602,10238,432,2618,3050
2019-03-28,16,3758,5122,2259,9825,10283,1922,55,22103,1275,6953,1582,9810,455,2718,3173
2019-03-28,17,3807,5073,2227,10074,10433,2022,55,22601,1128,6152,1433,8713,444,2726,3170
2019-03-28,18,3825,5067,2259,10616,10583,2147,56,23420,754,3964,993,5711,394,2629,3023
2019-03-28,19,3862,5141,2318,11211,10933,2287,57,24505,256,1104,315,1675,328,2479,2807
2019-03-28,20,4051,5311,2409,12001,11744,2525,60,26348,9,23,1,33,271,2383,2654
2019-03-28,21,4010,5184,2466,12245,11818,2515,59,26655,0,0,0,0,239,2439,2678
2019-03-28,22,3812,4912,2356,11744,11386,2375,56,25578,0,0,0,0,213,2615,2828
2019-03-28,23,3607,4643,2181,10936,10683,2159,52,23847,0,0,0,0,191,2765,2956
2019-03-28,24,3396,4454,2035,10202,9949,1968,49,22187,0,0,0,0,166,2818,2984
2019-03-29,1,3241,4383,1958,9489,9315,1858,47,20727,0,0,0,0,133,2800,2933
2019-03-29,2,3153,4346,1916,9133,8969,1776,47,19943,0,0,0,0,120,2783,2903
2019-03-29,3,3104,4356,1904,8945,8770,1731,49,19512,0,0,0,0,108,2683,2791
2019-03-29,4,3097,4435,1927,8912,8698,1718,51,19397,0,0,0,0,103,2511,2614
2019-03-29,5,3159,4635,2022,9139,8925,1762,54,19899,0,0,0,0,101,2296,2397
2019-03-29,6,3321,4987,2256,9803,9582,1911,61,21375,0,0,0,0,102,2108,2210
2019-03-29,7,3519,5278,2596,10838,10565,2164,69,23656,0,77,0,77,105,2003,2108
2019-03-29,8,3537,5351,2781,11278,11023,2219,71,24610,272,1522,198,1992,102,1939,2041
2019-03-29,9,3550,5329,2769,10921,10777,2125,66,23908,876,4430,716,6022,90,1928,2018
2019-03-29,10,3546,5281,2692,10349,10285,1943,62,22657,1277,6506,1176,8959,73,1951,2024
2019-03-29,11,3541,5226,2599,9856,9873,1761,58,21567,1401,7281,1417,10099,66,1902,1968
2019-03-29,12,3534,5141,2494,9310,9695,1656,56,20736,1423,7516,1530,10469,60,1750,1810
2019-03-29,13,3535,5114,2413,8964,9603,1620,54,20260,1421,7554,1572,10547,56,1582,1638
2019-03-29,14,3541,5068,2345,8867,9673,1571,54,20184,1414,7519,1593,10526,58,1512,1570
2019-03-29,15,3566,5038,2275,8924,9788,1599,53,20384,1408,7415,1607,10430,67,1603,1670
2019-03-29,16,3606,5002,2217,9024,9842,1688,53,20625,1394,7091,1586,10071,80,1874,1954
2019-03-29,17,3628,4946,2190,9429,10144,1841,53,21486,1357,6327,1453,9137,96,2194,2290
2019-03-29,18,3701,4912,2202,10124,10527,2032,54,22756,1061,4162,1029,6252,109,2409,2518
2019-03-29,19,3704,4990,2219,10836,10980,2297,55,24185,401,1180,346,1927,144,2508,2652
2019-03-29,20,3895,5155,2293,11466,11588,2446,58,25575,13,25,3,41,193,2561,2754
2019-03-29,21,3876,5079,2347,11752,11577,2435,57,25839,0,0,0,0,223,2565,2788
2019-03-29,22,3738,4884,2270,11395,11201,2348,55,25016,0,0,0,0,221,2493,2714
2019-03-29,23,3630,4660,2140,10781,10577,2181,52,23609,0,0,0,0,193,2394,2587
2019-03-29,24,3451,4478,2011,10131,9941,2005,49,22143,0,0,0,0,168,2294,2462
2019-03-30,1,3311,4450,1895,9585,9373,1869,48,20893,0,0,0,0,148,2201,2349
2019-03-30,2,3214,4408,1851,9205,8977,1785,48,20033,0,0,0,0,147,2130,2277
2019-03-30,3,3154,4408,1839,9003,8716,1725,49,19512,0,0,0,0,132,2052,2184
2019-03-30,4,3130,4448,1851,8877,8569,1700,52,19216,0,0,0,0,112,1953,2065
2019-03-30,5,3155,4532,1907,8936,8651,1713,54,19373,0,0,0,0,102,1764,1866
2019-03-30,6,3231,4682,2022,9194,8921,1774,58,19965,0,0,0,0,107,1361,1468
2019-03-30,7,3286,4823,2174,9715,9254,1854,65,20906,0,93,0,93,114,848,962
2019-03-30,8,3270,4948,2353,9948,9274,1888,67,21195,298,1660,233,2191,122,458,580
2019-03-30,9,3336,4996,2471,9891,9189,1857,64,21019,930,4655,809,6394,118,285,403
2019-03-30,10,3378,4973,2453,9471,8930,1744,59,20225,1325,6622,1272,9219,117,293,410
2019-03-30,11,3383,4920,2369,9075,8647,1622,55,19423,1435,7336,1495,10266,125,352,477
2019-03-30,12,3350,4838,2252,8704,8476,1535,54,18791,1453,7550,1586,10589,117,379,496
2019-03-30,13,3330,4777,2143,8412,8464,1487,53,18437,1447,7579,1618,10644,101,343,444
2019-03-30,14,3332,4729,2055,8253,8560,1482,52,18369,1437,7554,1622,10613,90,272,362
2019-03-30,15,3358,4706,2005,8267,8855,1536,52,18733,1434,7464,1619,10517,84,214,298
2019-03-30,16,3414,4720,1980,8529,9231,1660,52,19493,1421,7167,1587,10175,92,187,279
2019-03-30,17,3476,4737,1976,8999,9677,1825,54,20574,1381,6423,1446,9250,107,192,299
2019-03-30,18,3535,4764,2000,9541,10112,2022,54,21748,1099,4351,1024,6474,116,257,373
2019-03-30,19,3571,4882,2040,10054,10526,2232,55,22886,441,1303,348,2092,135,407,542
2019-03-30,20,3760,5079,2103,10731,11059,2424,59,24292,20,30,4,54,184,599,783
2019-03-30,21,3760,5029,2162,11104,11046,2395,58,24621,0,0,0,0,248,718,966
2019-03-30,22,3628,4859,2107,10868,10700,2282,56,23926,0,0,0,0,285,702,987
2019-03-30,23,3560,4646,2001,10322,10121,2117,53,22631,0,0,0,0,306,621,927
2019-03-30,24,3402,4467,1895,9753,9626,1953,50,21399,0,0,0,0,291,554,845
2019-03-31,1,3240,4377,1832,9342,9236,1837,48,20482,0,0,0,0,342,827,1169
2019-03-31,2,3147,4338,1795,8980,8874,1746,48,19665,0,0,0,0,286,920,1206
2019-03-31,3,3096,4334,1787,8772,8670,1693,48,19201,0,0,0,0,223,925,1148
2019-03-31,4,3071,4365,1803,8679,8512,1666,50,18924,0,0,0,0,183,795,978
2019-03-31,5,3078,4429,1856,8688,8464,1662,52,18884,0,0,0,0,160,587,747
2019-03-31,6,3124,4532,1947,8866,8589,1693,56,19221,0,0,0,0,140,378,518
2019-03-31,7,3146,4646,2077,9170,8616,1741,61,19606,1,107,1,109,125,255,380
2019-03-31,8,3117,4761,2230,9180,8518,1721,64,19500,299,1732,261,2292,115,266,381
2019-03-31,9,3174,4762,2355,9064,8440,1693,62,19278,897,4747,860,6504,99,370,469
2019-03-31,10,3224,4730,2351,8708,8286,1632,59,18705,1244,6655,1305,9204,78,516,594
2019-03-31,11,3250,4666,2271,8266,8228,1560,56,18130,1336,7333,1509,10178,59,630,689
2019-03-31,12,3266,4640,2171,8004,8293,1522,54,17893,1354,7549,1595,10498,41,648,689
2019-03-31,13,3283,4583,2105,7856,8449,1504,53,17882,1354,7579,1620,10553,28,552,580
2019-03-31,14,3316,4572,2051,7864,8686,1561,52,18181,1347,7557,1627,10531,21,410,431
2019-03-31,15,3374,4588,2009,8056,9015,1626,51,18768,1338,7478,1622,10438,19,290,309
2019-03-31,16,3445,4644,1986,8500,9454,1747,51,19772,1316,7126,1567,10009,22,211,233
2019-03-31,17,3464,4674,2001,9114,9916,1939,52,21040,1240,6225,1383,8848,30,164,194
2019-03-31,18,3573,4708,2047,9917,10403,2153,54,22543,931,4076,937,5944,51,136,187
2019-03-31,19,3601,4832,2099,10628,10932,2337,55,23969,353,1172,302,1827,95,129,224
2019-03-31,20,3790,5040,2175,11279,11514,2536,59,25406,10,22,3,35,163,146,309
2019-03-31,21,3777,4969,2214,11614,11505,2496,58,25690,0,0,0,0,235,176,411
2019-03-31,22,3608,4752,2119,11122,11061,2332,54,24588,0,0,0,0,284,217,501
2019-03-31,23,3475,4521,1960,10376,10402,2111,51,22957,0,0,0,0,309,263,572
2019-03-31,24,3297,4369,1826,9653,9687,1916,47,21320,0,0,0,0,314,281,595
2019-04-01,1,3169,4292,1709,9101,9300,1823,45,20296,0,0,0,0,340,282,622
2019-04-01,2,3079,4277,1676,8772,8932,1753,44,19545,0,0,0,0,338,231,569
2019-04-01,3,3025,4295,1674,8605,8798,1704,45,19196,0,0,0,0,324,175,499
2019-04-01,4,3018,4385,1703,8607,8750,1683,46,19131,0,0,0,0,296,138,434
2019-04-01,5,3074,4605,1804,8856,9010,1724,50,19686,0,0,0,0,248,113,361
2019-04-01,6,3239,4974,2042,9512,9692,1861,56,21166,0,0,0,0,188,103,291
2019-04-01,7,3427,5237,2378,10574,10656,2086,64,23425,0,89,1,90,144,103,247
2019-04-01,8,3441,5318,2588,11243,11058,2161,64,24575,168,1293,186,1647,101,97,198
2019-04-01,9,3459,5323,2574,11268,11082,2118,62,24552,583,3715,682,4980,66,88,154
2019-04-01,10,3470,5292,2531,11078,11092,2053,61,24311,925,5599,1128,7652,38,87,125
2019-04-01,11,3481,5247,2459,10827,11164,2004,60,24082,1058,6513,1372,8943,31,92,123
2019-04-01,12,3486,5181,2400,10590,11283,1984,60,23943,1066,6964,1460,9490,38,86,124
2019-04-01,13,3503,5153,2357,10451,11366,1998,60,23902,1036,7051,1457,9544,47,78,125
2019-04-01,14,3574,5101,2305,10487,11710,2030,60,24313,996,6929,1410,9335,52,91,143
2019-04-01,15,3645,5058,2254,10572,12006,2098,60,24762,927,6612,1289,8828,55,151,206
2019-04-01,16,3718,5046,2217,10780,12223,2192,60,25282,835,6039,1134,8008,50,294,344
2019-04-01,17,3807,5044,2205,11084,12413,2302,61,25884,711,4934,935,6580,47,508,555
2019-04-01,18,3842,5014,2219,11471,12515,2399,62,26472,492,2923,591,4006,61,682,743
2019-04-01,19,3835,5070,2259,11842,12511,2467,61,26905,186,769,188,1143,95,761,856
2019-04-01,20,4013,5265,2337,12340,13098,2646,62,28171,10,8,3,21,115,808,923
2019-04-01,21,4009,5176,2393,12499,13095,2601,62,28282,0,0,0,0,148,863,1011
2019-04-01,22,3814,4892,2276,11865,12394,2423,58,26764,0,0,0,0,210,949,1159
2019-04-01,23,3576,4604,2090,10929,11404,2175,52,24585,0,0,0,0,261,1088,1349
2019-04-01,24,3352,4409,1914,10170,10453,1979,48,22676,0,0,0,0,284,1277,1561
2019-04-02,1,3196,4309,1782,9369,9396,1885,44,20758,0,0,0,0,315,1294,1609
2019-04-02,2,3090,4266,1734,9015,9013,1806,43,19941,0,0,0,0,346,1414,1760
2019-04-02,3,3032,4264,1716,8782,8739,1751,43,19379,0,0,0,0,354,1484,1838
2019-04-02,4,3013,4340,1730,8656,8715,1727,44,19206,0,0,0,0,365,1530,1895
2019-04-02,5,3051,4538,1814,8868,8909,1766,47,19653,0,0,0,0,351,1570,1921
2019-04-02,6,3176,4906,2050,9517,9518,1901,51,21053,0,0,0,0,308,1563,1871
2019-04-02,7,3341,5153,2389,10620,10551,2126,57,23419,0,104,1,105,250,1523,1773
2019-04-02,8,3380,5219,2591,11438,10965,2196,59,24706,196,1568,217,1981,205,1489,1694
2019-04-02,9,3423,5234,2571,11446,10984,2181,60,24726,635,4356,719,5710,207,1494,1701
2019-04-02,10,3478,5210,2522,11250,10866,2119,58,24354,1015,6309,1156,8480,287,1577,1864
2019-04-02,11,3544,5188,2436,10994,10687,2028,57,23833,1174,7029,1391,9594,389,1722,2111
2019-04-02,12,3580,5149,2376,10734,10494,1944,56,23294,1181,7262,1453,9896,468,1894,2362
2019-04-02,13,3599,5147,2336,10541,10444,1862,56,22969,1149,7248,1446,9843,513,2079,2592
2019-04-02,14,3649,5101,2282,10459,10454,1812,56,22847,1078,7092,1447,9617,564,2269,2833
2019-04-02,15,3703,5072,2228,10422,10464,1827,56,22835,968,6676,1440,9084,608,2484,3092
2019-04-02,16,3788,5069,2191,10525,10560,1877,55,23084,887,6193,1412,8492,659,2663,3322
2019-04-02,17,3851,5055,2182,10744,10719,2039,55,23622,795,5478,1278,7551,689,2758,3447
2019-04-02,18,3843,5030,2190,11069,11065,2179,55,24432,560,3580,886,5026,660,2794,3454
2019-04-02,19,3830,5084,2229,11433,11482,2289,55,25322,215,1033,306,1554,583,2767,3350
2019-04-02,20,3997,5294,2310,11973,12128,2530,58,26753,15,22,9,46,476,2675,3151
2019-04-02,21,3971,5191,2376,12261,12136,2538,57,27056,0,0,0,0,395,2539,2934
2019-04-02,22,3783,4904,2265,11768,11588,2385,53,25859,0,0,0,0,354,2370,2724
2019-04-02,23,3557,4614,2083,10924,10830,2156,49,24024,0,0,0,0,319,2214,2533
2019-04-02,24,3329,4417,1916,10148,10091,1963,46,22313,0,0,0,0,280,2109,2389
2019-04-03,1,3174,4290,1807,9438,9463,1868,45,20877,0,0,0,0,269,1942,2211
2019-04-03,2,3061,4245,1757,9056,9122,1789,44,20075,0,0,0,0,242,2135,2377
2019-04-03,3,3002,4244,1736,8838,8875,1738,44,19560,0,0,0,0,217,2327,2544
2019-04-03,4,2985,4321,1751,8806,8794,1716,45,19426,0,0,0,0,196,2434,2630
2019-04-03,5,3035,4522,1836,9002,9050,1756,48,19921,0,0,0,0,177,2484,2661
2019-04-03,6,3176,4879,2075,9572,9664,1898,53,21251,0,0,0,0,158,2501,2659
2019-04-03,7,3354,5122,2414,10718,10621,2129,59,23591,1,137,0,138,137,2433,2570
2019-04-03,8,3370,5189,2611,11509,10947,2219,62,24800,154,1640,129,1923,113,2196,2309
2019-04-03,9,3395,5206,2591,11356,10927,2208,60,24615,503,4350,495,5348,92,1798,1890
2019-04-03,10,3409,5175,2534,10929,10683,2145,59,23880,824,6168,858,7850,80,1354,1434
2019-04-03,11,3440,5146,2451,10451,10567,2048,58,23193,985,6898,1112,8995,74,1011,1085
2019-04-03,12,3452,5094,2383,10101,10461,1971,56,22660,1024,7203,1289,9516,73,851,924
2019-04-03,13,3516,5082,2347,9858,10369,1875,56,22224,1007,7265,1360,9632,71,846,917
2019-04-03,14,3594,5036,2306,9809,10364,1821,56,22115,964,7169,1362,9495,74,934,1008
2019-04-03,15,3677,5008,2267,9915,10388,1790,56,22213,913,6956,1332,9201,78,1087,1165
2019-04-03,16,3772,4999,2233,10121,10430,1801,56,22472,830,6434,1244,8508,84,1266,1350
2019-04-03,17,3854,4985,2222,10445,10592,1953,56,23110,700,5336,1029,7065,95,1426,1521
2019-04-03,18,3911,4944,2230,10830,10738,2137,56,23825,463,3257,628,4348,116,1503,1619
2019-04-03,19,3893,4993,2262,11300,11082,2350,56,24852,163,868,190,1221,147,1492,1639
2019-04-03,20,4062,5220,2323,11888,11824,2559,58,26394,8,12,4,24,196,1430,1626
2019-04-03,21,4045,5139,2396,12046,11953,2568,58,26690,0,0,0,0,235,1338,1573
2019-04-03,22,3846,4863,2295,11583,11540,2414,54,25654,0,0,0,0,265,1247,1512
2019-04-03,23,3582,4577,2110,10752,10794,2184,49,23843,0,0,0,0,285,1176,1461
2019-04-03,24,3352,4388,1941,9989,10014,1983,46,22095,0,0,0,0,288,1126,1414
2019-04-04,1,3171,4285,1814,9598,9588,1864,45,21159,0,0,0,0,265,1023,1288
2019-04-04,2,3067,4242,1768,9221,9129,1789,44,20247,0,0,0,0,262,928,1190
2019-04-04,3,3006,4252,1748,9019,8913,1738,44,19778,0,0,0,0,268,837,1105
2019-04-04,4,2992,4335,1765,8954,8802,1715,45,19580,0,0,0,0,282,765,1047
2019-04-04,5,3042,4530,1851,9175,9038,1754,48,20081,0,0,0,0,287,730,1017
2019-04-04,6,3186,4887,2086,9782,9577,1891,54,21368,0,0,0,0,260,754,1014
2019-04-04,7,3334,5119,2432,10831,10469,2118,60,23540,3,108,3,114,219,831,1050
2019-04-04,8,3378,5183,2626,11375,10815,2193,62,24509,156,1238,157,1551,186,901,1087
2019-04-04,9,3414,5197,2597,11287,10785,2164,61,24363,451,3527,508,4486,167,925,1092
2019-04-04,10,3449,5169,2543,11055,10624,2088,59,23893,723,5390,845,6958,164,932,1096
2019-04-04,11,3509,5128,2459,10783,10513,1985,58,23406,852,6331,990,8173,178,968,1146
2019-04-04,12,3540,5067,2384,10642,10447,1895,57,23107,844,6795,986,8625,204,1079,1283
2019-04-04,13,3582,5061,2332,10436,10374,1839,56,22769,845,6903,1030,8778,224,1254,1478
2019-04-04,14,3638,5032,2288,10191,10422,1851,56,22584,818,6754,990,8562,239,1434,1673
2019-04-04,15,3693,5011,2241,10127,10542,1885,55,22675,771,6448,846,8065,282,1620,1902
2019-04-04,16,3776,5006,2203,10235,10601,1941,55,22896,703,5930,729,7362,304,1851,2155
2019-04-04,17,3841,4997,2191,10524,10713,2042,55,23398,576,4869,594,6039,342,2082,2424
2019-04-04,18,3847,4937,2193,10972,10918,2155,55,24164,408,2791,412,3611,322,2182,2504
2019-04-04,19,3825,4984,2227,11502,11301,2271,55,25193,168,693,159,1020,276,2144,2420
2019-04-04,20,3996,5182,2292,12089,12039,2516,57,26766,12,11,7,30,236,2042,2278
2019-04-04,21,3996,5086,2365,12169,12193,2538,57,27023,0,0,0,0,211,1995,2206
2019-04-04,22,3812,4823,2261,11656,11687,2390,54,25851,0,0,0,0,205,2052,2257
2019-04-04,23,3554,4541,2082,10851,10913,2169,50,24048,0,0,0,0,212,2167,2379
2019-04-04,24,3332,4347,1919,10105,10135,1976,46,22327,0,0,0,0,207,2276,2483
2019-04-05,1,3174,4224,1794,9558,9615,1863,45,21137,0,0,0,0,179,1974,2153
2019-04-05,2,3070,4172,1744,9216,9209,1779,45,20307,0,0,0,0,159,2201,2360
2019-04-05,3,3006,4170,1722,9026,8944,1727,45,19801,0,0,0,0,157,2374,2531
2019-04-05,4,2987,4235,1732,8977,8839,1706,46,19633,0,0,0,0,179,2462,2641
2019-04-05,5,3026,4417,1808,9206,9065,1745,49,20134,0,0,0,0,201,2482,2683
2019-04-05,6,3152,4738,2024,9813,9718,1879,54,21531,0,0,0,0,214,2410,2624
2019-04-05,7,3322,4966,2331,10779,10732,2108,61,23743,8,117,3,128,220,2262,2482
2019-04-05,8,3377,5067,2517,11479,11065,2177,62,24841,244,1459,208,1911,223,2101,2324
2019-04-05,9,3421,5105,2522,11616,11129,2150,60,25008,677,4087,682,5446,218,2003,2221
2019-04-05,10,3464,5089,2485,11526,11032,2060,58,24734,992,6114,1095,8201,238,2030,2268
2019-04-05,11,3493,5058,2414,11402,10914,1949,56,24378,1051,6979,1258,9288,302,2150,2452
2019-04-05,12,3491,5004,2352,11277,10790,1857,54,24040,911,7187,1186,9284,319,2334,2653
2019-04-05,13,3523,4989,2303,11118,10606,1799,53,23636,813,7108,1139,9060,301,2587,2888
2019-04-05,14,3574,4949,2258,10957,10539,1782,53,23390,751,6865,1025,8641,287,2837,3124
2019-04-05,15,3625,4914,2207,10887,10484,1803,52,23311,649,6271,791,7711,260,3006,3266
2019-04-05,16,3681,4881,2168,10910,10518,1843,51,23379,552,5475,643,6670,240,3097,3337
2019-04-05,17,3766,4831,2172,10895,10680,1934,53,23618,512,4372,538,5422,215,3102,3317
2019-04-05,18,3730,4765,2169,10999,10808,2059,54,23967,435,2606,398,3439,196,3059,3255
2019-04-05,19,3732,4795,2184,11161,10985,2173,54,24419,195,719,163,1077,165,2981,3146
2019-04-05,20,3904,4975,2249,11685,11764,2401,55,25952,16,10,9,35,148,2847,2995
2019-04-05,21,3900,4917,2306,11985,11985,2419,55,26497,0,0,0,0,126,2750,2876
2019-04-05,22,3770,4731,2224,11595,11559,2312,52,25571,0,0,0,0,110,2727,2837
2019-04-05,23,3591,4493,2079,10931,10897,2140,49,24077,0,0,0,0,108,2718,2826
2019-04-05,24,3401,4295,1928,10235,10173,1970,46,22492,0,0,0,0,109,2743,2852
2019-04-06,1,3252,4160,1811,9455,9241,1855,46,20653,0,0,0,0,128,2931,3059
2019-04-06,2,3137,4104,1760,9039,8877,1770,46,19795,0,0,0,0,153,2999,3152
2019-04-06,3,3069,4095,1740,8809,8654,1714,47,19295,0,0,0,0,161,3004,3165
2019-04-06,4,3036,4123,1747,8669,8541,1685,48,19010,0,0,0,0,150,2947,3097
2019-04-06,5,3045,4206,1787,8697,8636,1694,50,19135,0,0,0,0,148,2844,2992
2019-04-06,6,3103,4342,1888,8955,8864,1746,54,19672,0,0,0,0,156,2673,2829
2019-04-06,7,3142,4424,2028,9356,9321,1828,60,20612,2,161,4,167,174,2422,2596
2019-04-06,8,3152,4572,2190,9626,9327,1895,61,20984,199,1699,190,2088,189,2156,2345
2019-04-06,9,3226,4667,2312,9723,9254,1930,58,21034,643,4430,660,5733,181,1903,2084
2019-04-06,10,3281,4681,2329,9532,9120,1882,56,20646,1012,6361,1102,8475,170,1777,1947
2019-04-06,11,3311,4665,2261,9222,8896,1821,54,20052,1209,7140,1357,9706,154,1852,2006
2019-04-06,12,3316,4618,2178,8919,8734,1690,53,19456,1321,7370,1488,10179,145,2089,2234
2019-04-06,13,3355,4570,2091,8696,8584,1558,52,18950,1340,7366,1539,10245,139,2392,2531
2019-04-06,14,3402,4520,2015,8551,8543,1504,52,18709,1309,7313,1543,10165,153,2647,2800
2019-04-06,15,3477,4499,1965,8560,8434,1493,53,18599,1260,7148,1517,9925,171,2842,3013
2019-04-06,16,3555,4519,1945,8795,8671,1583,53,19159,1192,6732,1464,9388,191,2980,3171
2019-04-06,17,3648,4553,1952,9172,8998,1765,54,20047,1082,5928,1312,8322,209,3065,3274
2019-04-06,18,3745,4550,1963,9700,9387,2006,56,21206,795,4015,911,5721,220,3052,3272
2019-04-06,19,3739,4610,1996,10199,10001,2186,55,22499,325,1278,323,1926,215,2890,3105
2019-04-06,20,3887,4826,2063,10779,10648,2352,57,23894,29,35,15,79,199,2666,2865
2019-04-06,21,3897,4808,2140,11090,10816,2359,57,24380,0,0,0,0,188,2544,2732
2019-04-06,22,3757,4643,2076,10759,10510,2255,54,23636,0,0,0,0,193,2590,2783
2019-04-06,23,3543,4430,1947,10253,9970,2116,50,22447,0,0,0,0,208,2683,2891
2019-04-06,24,3371,4249,1813,9653,9406,1948,47,21111,0,0,0,0,211,2708,2919
2019-04-07,1,3266,4135,1694,9213,9136,1822,44,20262,0,0,0,0,227,2558,2785
2019-04-07,2,3155,4082,1643,8839,8730,1733,43,19391,0,0,0,0,190,2439,2629
2019-04-07,3,3079,4070,1624,8615,8445,1671,43,18821,0,0,0,0,169,2299,2468
2019-04-07,4,3037,4097,1624,8485,8302,1644,43,18521,0,0,0,0,157,2142,2299
2019-04-07,5,3029,4142,1658,8498,8295,1654,45,18539,0,0,0,0,154,1978,2132
2019-04-07,6,3052,4218,1736,8660,8369,1697,48,18826,0,0,0,0,153,1872,2025
2019-04-07,7,3043,4267,1837,9090,8610,1737,52,19550,11,217,8,236,154,1802,1956
2019-04-07,8,3065,4390,1977,9388,8519,1730,53,19746,260,1822,237,2319,157,1696,1853
2019-04-07,9,3163,4443,2104,9510,8471,1695,53,19808,769,4427,744,5940,143,1473,1616
2019-04-07,10,3297,4444,2147,9286,8376,1630,53,19431,1191,6104,1191,8486,131,1121,1252
2019-04-07,11,3392,4404,2105,8813,8412,1540,52,18891,1393,6812,1463,9668,133,776,909
2019-04-07,12,3458,4409,2059,8462,8489,1479,51,18549,1452,7078,1595,10125,144,605,749
2019-04-07,13,3539,4381,2032,8388,8635,1458,52,18609,1454,7159,1620,10233,156,672,828
2019-04-07,14,3639,4378,1995,8414,8923,1497,53,18966,1445,7206,1625,10276,178,957,1135
2019-04-07,15,3765,4394,1961,8568,9262,1562,54,19532,1420,7129,1630,10179,205,1357,1562
2019-04-07,16,3906,4463,1946,8957,9632,1680,55,20400,1357,6799,1549,9705,239,1745,1984
2019-04-07,17,4030,4501,1960,9462,10187,1870,57,21655,1221,5976,1335,8532,273,2039,2312
2019-04-07,18,4130,4540,1999,10105,10657,2081,60,22955,862,3971,908,5741,301,2223,2524
2019-04-07,19,4091,4584,2042,10661,11100,2244,59,24111,329,1222,323,1874,316,2311,2627
2019-04-07,20,4202,4809,2107,11239,11685,2453,59,25483,25,30,18,73,352,2372,2724
2019-04-07,21,4201,4746,2173,11617,11835,2459,58,26015,0,0,0,0,382,2406,2788
2019-04-07,22,4024,4510,2076,11206,11326,2301,53,24933,0,0,0,0,390,2362,2752
2019-04-07,23,3735,4265,1900,10411,10599,2084,48,23189,0,0,0,0,369,2285,2654
2019-04-07,24,3471,4112,1742,9647,9838,1895,44,21471,0,0,0,0,329,2205,2534
2019-04-08,1,3246,4132,1631,9048,9236,1812,42,20210,0,0,0,0,310,2102,2412
2019-04-08,2,3121,4103,1586,8704,8894,1744,41,19460,0,0,0,0,295,1962,2257
2019-04-08,3,3025,4117,1571,8535,8681,1700,41,19039,0,0,0,0,288,1893,2181
2019-04-08,4,3003,4198,1591,8527,8634,1684,42,18968,0,0,0,0,292,1892,2184
2019-04-08,5,3049,4405,1679,8766,8854,1727,45,19484,0,0,0,0,306,1896,2202
2019-04-08,6,3217,4776,1905,9383,9491,1869,51,20884,0,0,0,0,331,1793,2124
2019-04-08,7,3332,5038,2233,10499,10466,2076,56,23180,9,203,7,219,357,1536,1893
2019-04-08,8,3452,5127,2439,11201,10895,2150,59,24398,210,1622,201,2033,371,1194,1565
2019-04-08,9,3578,5176,2456,11244,11125,2113,60,24614,625,3991,661,5277,377,825,1202
2019-04-08,10,3701,5185,2435,11055,11230,2045,59,24460,957,5707,1099,7763,380,513,893
2019-04-08,11,3813,5175,2393,10874,11481,2005,59,24488,1115,6545,1363,9023,391,344,735
2019-04-08,12,3910,5151,2354,10718,11742,1990,61,24578,1186,6898,1512,9596,394,337,731
2019-04-08,13,4017,5162,2333,10658,12023,2014,63,24826,1191,6983,1556,9730,405,485,890
2019-04-08,14,4132,5173,2305,10602,12404,2070,65,25210,1185,6906,1546,9637,449,813,1262
2019-04-08,15,4249,5210,2265,10646,12748,2125,68,25655,1165,6686,1525,9376,498,1308,1806
2019-04-08,16,4379,5236,2232,10817,13070,2237,69,26261,1084,6151,1439,8674,553,1906,2459
2019-04-08,17,4472,5263,2218,11018,13333,2363,70,26851,966,5104,1253,7323,603,2410,3013
2019-04-08,18,4487,5169,2234,11429,13484,2481,71,27532,690,3208,864,4762,608,2682,3290
2019-04-08,19,4416,5156,2268,12039,13413,2543,69,28129,269,952,315,1536,581,2820,3401
2019-04-08,20,4505,5276,2330,12568,13757,2689,68,29147,24,26,20,70,557,2900,3457
2019-04-08,21,4480,5102,2395,12710,13685,2659,65,29182,0,0,0,0,573,2928,3501
2019-04-08,22,4244,4803,2280,12059,12935,2471,60,27578,0,0,0,0,614,2927,3541
2019-04-08,23,3944,4509,2097,11084,11833,2216,53,25242,0,0,0,0,664,2912,3576
2019-04-08,24,3673,4307,1923,10196,10828,2002,49,23138,0,0,0,0,703,2913,3616
2019-04-09,1,3427,4209,1843,9513,9876,1906,45,21409,0,0,0,0,759,2932,3691
2019-04-09,2,3282,4149,1794,9084,9372,1821,44,20397,0,0,0,0,739,2930,3669
2019-04-09,3,3200,4137,1771,8871,9095,1761,44,19850,0,0,0,0,712,2926,3638
2019-04-09,4,3173,4198,1782,8803,8917,1740,44,19588,0,0,0,0,684,2923,3607
2019-04-09,5,3203,4392,1865,8996,9095,1778,46,20009,0,0,0,0,670,2906,3576
2019-04-09,6,3359,4750,2099,9564,9690,1914,51,21301,0,0,0,0,649,2887,3536
2019-04-09,7,3494,4995,2441,10621,10520,2138,56,23404,20,226,6,252,617,2861,3478
2019-04-09,8,3563,5091,2636,11280,11041,2213,58,24685,373,1770,162,2305,553,2866,3419
2019-04-09,9,3660,5146,2631,11276,11148,2183,60,24782,969,4381,540,5890,414,2934,3348
2019-04-09,10,3754,5161,2589,10851,11066,2103,60,24204,1334,6193,942,8469,292,3039,3331
2019-04-09,11,3838,5168,2525,10490,11099,2008,60,23784,1446,6963,1253,9662,244,3135,3379
2019-04-09,12,3905,5152,2479,10157,11101,1926,60,23379,1467,7292,1470,10229,252,3197,3449
2019-04-09,13,3935,5166,2448,9920,11095,1875,60,23062,1468,7395,1553,10416,279,3232,3511
2019-04-09,14,3973,5144,2403,9845,11202,1874,59,23081,1464,7365,1586,10415,318,3258,3576
2019-04-09,15,4009,5131,2346,9819,11229,1896,57,23092,1459,7211,1622,10292,386,3273,3659
2019-04-09,16,4049,5141,2311,9979,11295,1953,56,23384,1444,6857,1604,9905,453,3267,3720
2019-04-09,17,4083,5124,2312,10407,11360,2077,54,23988,1412,6137,1460,9009,502,3248,3750
2019-04-09,18,4035,5091,2331,10906,11433,2201,54,24658,1174,4294,1065,6533,484,3224,3708
2019-04-09,19,3970,5112,2368,11365,11599,2316,54,25389,546,1433,410,2389,425,3203,3628
2019-04-09,20,4091,5305,2435,11827,12201,2451,57,26590,64,59,28,151,411,3186,3597
2019-04-09,21,4070,5201,2505,12119,12275,2474,58,26980,0,0,0,0,433,3150,3583
2019-04-09,22,3876,4910,2391,11630,11715,2333,55,25787,0,0,0,0,485,3096,3581
2019-04-09,23,3587,4625,2204,10790,10899,2118,52,23916,0,0,0,0,567,3035,3602
2019-04-09,24,3362,4433,2029,10006,10118,1937,48,22172,0,0,0,0,637,2975,3612
2019-04-10,1,3171,4329,1916,9227,9533,1867,46,20732,0,0,0,0,700,3007,3707
2019-04-10,2,3063,4280,1868,8847,9081,1786,45,19831,0,0,0,0,732,2893,3625
2019-04-10,3,3001,4277,1849,8669,8805,1734,46,19331,0,0,0,0,741,2747,3488
2019-04-10,4,2986,4352,1871,8637,8675,1714,48,19148,0,0,0,0,724,2608,3332
2019-04-10,5,3042,4564,1967,8890,8888,1757,52,19653,0,0,0,0,697,2488,3185
2019-04-10,6,3180,4926,2210,9534,9419,1900,58,20970,0,0,0,0,676,2387,3063
2019-04-10,7,3330,5165,2544,10493,10192,2139,64,22948,38,321,28,387,665,2267,2932
2019-04-10,8,3368,5247,2726,11294,10696,2196,67,24349,450,2293,390,3133,674,2126,2800
2019-04-10,9,3395,5267,2705,10988,10633,2091,63,23891,1036,5171,1004,7211,706,2010,2716
2019-04-10,10,3400,5268,2641,10454,10551,1943,60,23129,1301,6820,1410,9531,739,1956,2695
2019-04-10,11,3412,5258,2568,10034,10466,1827,57,22513,1362,7407,1606,10375,759,1993,2752
2019-04-10,12,3387,5219,2496,9672,10358,1785,55,21990,1377,7581,1674,10632,757,2100,2857
2019-04-10,13,3402,5213,2448,9456,10355,1739,53,21719,1377,7599,1680,10656,743,2247,2990
2019-04-10,14,3456,5180,2397,9436,10502,1738,53,21828,1376,7582,1681,10639,710,2405,3115
2019-04-10,15,3528,5164,2349,9559,10690,1793,52,22183,1374,7494,1679,10547,666,2548,3214
2019-04-10,16,3601,5170,2306,9862,10824,1901,53,22715,1363,7207,1648,10218,613,2661,3274
2019-04-10,17,3652,5167,2284,10249,10894,2071,53,23329,1334,6546,1516,9396,541,2740,3281
2019-04-10,18,3735,5135,2310,10691,11089,2300,54,24188,1145,4695,1148,6988,426,2793,3219
2019-04-10,19,3738,5156,2358,11087,11315,2507,53,25018,559,1688,466,2713,317,2821,3138
2019-04-10,20,3890,5341,2419,11583,11930,2665,55,26290,68,99,34,201,289,2842,3131
2019-04-10,21,3912,5260,2493,11888,12046,2614,55,26657,0,0,0,0,328,2836,3164
2019-04-10,22,3742,4971,2386,11512,11575,2457,52,25651,0,0,0,0,366,2762,3128
2019-04-10,23,3600,4680,2193,10708,10812,2231,48,23854,0,0,0,0,394,2610,3004
2019-04-10,24,3386,4494,2014,9960,10053,2018,45,22131,0,0,0,0,403,2396,2799
2019-04-11,1,3200,4420,1874,9329,9327,1858,46,20627,0,0,0,0,344,2304,2648
2019-04-11,2,3098,4380,1824,8989,9057,1780,47,19940,0,0,0,0,364,2090,2454
2019-04-11,3,3044,4384,1802,8790,8837,1726,48,19467,0,0,0,0,371,1833,2204
2019-04-11,4,3034,4459,1817,8717,8770,1703,50,19306,0,0,0,0,359,1592,1951
2019-04-11,5,3093,4670,1902,8872,9033,1748,54,19772,0,0,0,0,330,1389,1719
2019-04-11,6,3258,5042,2136,9449,9711,1899,61,21186,0,0,0,0,275,1259,1534
2019-04-11,7,3385,5285,2466,10718,10699,2101,66,23650,37,347,24,408,239,1225,1464
2019-04-11,8,3415,5331,2652,11388,10861,2149,67,24530,354,2279,341,2974,252,1239,1491
2019-04-11,9,3437,5325,2623,11101,10351,2082,64,23695,802,4948,898,6648,282,1268,1550
2019-04-11,10,3441,5284,2573,10716,10149,1980,61,23005,1052,6368,1288,8708,326,1339,1665
2019-04-11,11,3443,5234,2509,10382,10045,1901,58,22487,1139,6838,1506,9483,364,1485,1849
2019-04-11,12,3431,5168,2443,10097,9990,1837,57,22103,1131,6851,1577,9559,388,1757,2145
2019-04-11,13,3423,5151,2406,9910,10011,1803,56,21837,1093,6679,1559,9331,419,2159,2578
2019-04-11,14,3459,5118,2357,9874,10198,1829,56,22011,1018,6436,1459,8913,454,2546,3000
2019-04-11,15,3510,5100,2309,9867,10322,1879,55,22178,881,5898,1245,8024,481,2825,3306
2019-04-11,16,3575,5108,2266,9896,10439,1961,55,22404,761,5201,1031,6993,479,2994,3473
2019-04-11,17,3641,5096,2247,9966,10576,2085,56,22737,686,4187,799,5672,472,3089,3561
2019-04-11,18,3704,5073,2248,10371,10661,2230,56,23376,545,2583,488,3616,435,3122,3557
2019-04-11,19,3694,5087,2294,10945,10907,2343,56,24318,259,823,180,1262,401,3110,3511
2019-04-11,20,3864,5310,2356,11657,11630,2524,58,25935,37,41,14,92,408,3090,3498
2019-04-11,21,3890,5234,2435,11992,11940,2530,58,26585,0,0,0,0,436,3070,3506
2019-04-11,22,3730,4959,2338,11612,11511,2387,55,25629,0,0,0,0,450,3051,3501
2019-04-11,23,3600,4682,2154,10829,10698,2180,51,23823,0,0,0,0,453,3031,3484
2019-04-11,24,3402,4501,1983,10090,9907,1977,47,22087,0,0,0,0,445,3021,3466
2019-04-12,1,3221,4433,1871,9433,9372,1859,47,20776,0,0,0,0,412,2959,3371
2019-04-12,2,3119,4398,1820,9062,8953,1771,47,19899,0,0,0,0,399,2920,3319
2019-04-12,3,3069,4401,1801,8856,8710,1717,48,19399,0,0,0,0,387,2857,3244
2019-04-12,4,3054,4468,1821,8797,8682,1698,49,19293,0,0,0,0,376,2764,3140
2019-04-12,5,3100,4657,1908,8971,8930,1737,52,19756,0,0,0,0,374,2651,3025
2019-04-12,6,3250,4995,2135,9568,9551,1875,57,21117,0,0,0,0,368,2537,2905
2019-04-12,7,3381,5232,2448,10615,10580,2077,63,23400,48,230,22,300,363,2366,2729
2019-04-12,8,3417,5297,2618,11191,10790,2145,63,24256,483,1754,354,2591,349,2085,2434
2019-04-12,9,3448,5303,2604,10866,10811,2098,61,23903,1094,4264,953,6311,351,1740,2091
2019-04-12,10,3470,5264,2548,10327,10760,1988,59,23201,1358,5926,1381,8665,403,1398,1801
2019-04-12,11,3476,5213,2472,9706,10514,1895,57,22249,1415,6617,1625,9657,480,1149,1629
2019-04-12,12,3456,5137,2392,9322,10596,1798,55,21839,1438,6868,1746,10052,535,1010,1545
2019-04-12,13,3439,5105,2332,8999,10593,1728,54,21441,1437,6842,1769,10048,568,929,1497
2019-04-12,14,3454,5061,2274,8893,10693,1690,53,21398,1436,6708,1769,9913,573,910,1483
2019-04-12,15,3483,5028,2221,8878,10707,1690,53,21395,1431,6458,1774,9663,549,993,1542
2019-04-12,16,3523,5007,2181,9025,10629,1742,53,21517,1406,6117,1700,9223,502,1176,1678
2019-04-12,17,3565,4973,2168,9398,10737,1879,54,22134,1356,5445,1503,8304,422,1408,1830
2019-04-12,18,3598,4921,2170,10052,10901,2048,55,23122,1107,3823,1088,6018,313,1631,1944
2019-04-12,19,3605,4943,2177,10867,11226,2226,55,24439,523,1422,437,2382,225,1825,2050
2019-04-12,20,3761,5134,2203,11551,11650,2349,56,25672,71,97,34,202,216,1923,2139
2019-04-12,21,3798,5103,2290,11865,11821,2375,56,26182,0,0,0,0,258,1817,2075
2019-04-12,22,3677,4907,2228,11483,11360,2278,53,25240,0,0,0,0,285,1510,1795
2019-04-12,23,3586,4675,2089,10829,10612,2114,50,23671,0,0,0,0,298,1102,1400
2019-04-12,24,3414,4487,1941,10160,9856,1951,47,22080,0,0,0,0,295,756,1051
2019-04-13,1,3294,4370,1845,9482,9276,1865,46,20737,0,0,0,0,306,724,1030
2019-04-13,2,3194,4324,1791,9063,8878,1778,45,19832,0,0,0,0,305,490,795
2019-04-13,3,3131,4323,1770,8824,8657,1722,47,19318,0,0,0,0,268,322,590
2019-04-13,4,3102,4360,1778,8706,8533,1691,48,19046,0,0,0,0,231,212,443
2019-04-13,5,3114,4431,1829,8766,8602,1700,51,19188,0,0,0,0,186,154,340
2019-04-13,6,3182,4558,1929,9033,8919,1754,56,19830,0,0,0,0,144,137,281
2019-04-13,7,3179,4636,2062,9375,9277,1819,59,20598,58,389,37,484,105,147,252
2019-04-13,8,3183,4778,2208,9610,9230,1809,60,20777,504,2461,433,3398,80,162,242
2019-04-13,9,3257,4859,2319,9545,9240,1767,57,20676,1105,5275,1084,7464,55,176,231
2019-04-13,10,3309,4853,2330,9263,9171,1710,55,20267,1362,6778,1510,9650,36,191,227
2019-04-13,11,3318,4812,2271,8860,9059,1611,53,19651,1419,7325,1726,10470,27,184,211
2019-04-13,12,3293,4737,2191,8501,8972,1524,52,19116,1435,7519,1811,10765,19,149,168
2019-04-13,13,3277,4671,2118,8290,8975,1463,51,18847,1424,7533,1811,10768,19,113,132
2019-04-13,14,3305,4622,2062,8222,9071,1437,51,18848,1409,7528,1797,10734,32,109,141
2019-04-13,15,3372,4593,2018,8302,9272,1465,51,19146,1378,7408,1767,10553,52,167,219
2019-04-13,16,3446,4618,2000,8606,9562,1554,52,19834,1304,7015,1635,9954,72,330,402
2019-04-13,17,3539,4644,2004,9156,9859,1725,53,20859,1168,6191,1392,8751,94,586,680
2019-04-13,18,3634,4649,2019,9806,10278,1913,54,22118,861,4325,961,6147,133,840,973
2019-04-13,19,3644,4710,2041,10552,10650,2112,54,23433,368,1594,371,2333,200,1007,1207
2019-04-13,20,3749,4932,2079,11221,11161,2334,56,24838,44,126,30,200,308,1139,1447
2019-04-13,21,3778,4929,2158,11624,11300,2374,56,25419,0,0,0,0,415,1262,1677
2019-04-13,22,3665,4751,2098,11233,10958,2273,53,24582,0,0,0,0,482,1361,1843
2019-04-13,23,3532,4531,1976,10551,10377,2112,49,23155,0,0,0,0,519,1521,2040
2019-04-13,24,3365,4348,1847,9836,9725,1956,46,21631,0,0,0,0,549,1753,2302
2019-04-14,1,3274,4206,1775,9234,9052,1846,44,20244,0,0,0,0,617,2008,2625
2019-04-14,2,3169,4164,1732,8848,8747,1752,43,19458,0,0,0,0,633,2034,2667
2019-04-14,3,3094,4133,1712,8568,8482,1695,43,18856,0,0,0,0,634,1977,2611
2019-04-14,4,3058,4148,1719,8430,8322,1664,44,18528,0,0,0,0,620,1902,2522
2019-04-14,5,3053,4195,1759,8436,8314,1660,45,18523,0,0,0,0,598,1828,2426
2019-04-14,6,3080,4266,1837,8554,8446,1695,48,18810,0,0,0,0,577,1706,2283
2019-04-14,7,3032,4316,1947,8873,8495,1729,52,19217,19,189,16,224,543,1575,2118
2019-04-14,8,3056,4450,2095,8911,8431,1731,52,19193,521,2228,385,3134,528,1369,1897
2019-04-14,9,3146,4506,2221,8851,8383,1703,53,19056,1228,4818,1049,7095,519,1229,1748
2019-04-14,10,3244,4517,2267,8744,8310,1650,52,18823,1428,6074,1495,8997,482,1161,1643
2019-04-14,11,3331,4487,2254,8446,8393,1565,51,18523,1467,6629,1684,9780,447,1113,1560
2019-04-14,12,3404,4502,2214,8179,8404,1503,51,18206,1480,6817,1786,10083,488,1242,1730
2019-04-14,13,3473,4464,2177,7933,8596,1471,53,18120,1471,6755,1810,10036,562,1505,2067
2019-04-14,14,3565,4467,2137,7795,8719,1508,54,18143,1454,6684,1803,9941,634,1795,2429
2019-04-14,15,3687,4487,2094,7802,8958,1543,55,18426,1440,6578,1791,9809,696,2088,2784
2019-04-14,16,3827,4561,2071,8049,9362,1648,57,19182,1411,6033,1690,9134,758,2310,3068
2019-04-14,17,3943,4598,2066,8466,9890,1809,59,20290,1359,5422,1554,8335,812,2489,3301
2019-04-14,18,4030,4596,2114,9280,10368,1991,59,21763,1188,3913,1131,6232,850,2442,3292
2019-04-14,19,4017,4647,2160,10150,10721,2156,58,23150,497,1230,421,2148,867,2351,3218
2019-04-14,20,4112,4868,2228,11067,11258,2347,58,24795,22,59,18,99,896,2247,3143
2019-04-14,21,4131,4837,2315,11539,11454,2373,57,25489,0,0,0,0,876,2300,3176
2019-04-14,22,3964,4615,2221,11084,11009,2241,53,24453,0,0,0,0,844,2329,3173
2019-04-14,23,3740,4365,2050,10271,10293,2059,48,22738,0,0,0,0,805,2362,3167
2019-04-14,24,3483,4205,1893,9536,9582,1888,44,21116,0,0,0,0,771,2403,3174
2019-04-15,1,3279,4143,1791,9141,9030,1816,42,20096,0,0,0,0,746,2135,2881
2019-04-15,2,3150,4121,1762,8831,8768,1747,41,19454,0,0,0,0,727,2137,2864
2019-04-15,3,3073,4132,1763,8673,8619,1700,41,19101,0,0,0,0,705,2122,2827
2019-04-15,4,3044,4213,1802,8680,8633,1683,42,19107,0,0,0,0,688,2108,2796
2019-04-15,5,3088,4419,1914,8940,8910,1724,45,19687,0,0,0,0,675,2115,2790
2019-04-15,6,3253,4779,2171,9583,9536,1862,50,21100,0,0,0,0,665,2068,2733
2019-04-15,7,3370,5041,2528,10554,10324,2061,55,23061,18,185,17,220,631,1975,2606
2019-04-15,8,3432,5144,2716,11188,10680,2141,57,24131,464,2126,344,2934,600,1872,2472
2019-04-15,9,3555,5182,2690,11192,10732,2104,56,24152,1099,4608,956,6663,591,1918,2509
2019-04-15,10,3654,5196,2621,10997,10720,2011,55,23850,1279,5777,1379,8435,571,1959,2530
2019-04-15,11,3733,5189,2552,10668,10667,1909,55,23366,1344,6358,1621,9323,539,1991,2530
2019-04-15,12,3801,5155,2468,10342,10522,1841,55,22829,1337,6592,1733,9662,450,2182,2632
2019-04-15,13,3847,5150,2418,10133,10500,1772,56,22529,1282,6594,1765,9641,397,2411,2808
2019-04-15,14,3906,5116,2368,10077,10607,1745,58,22555,1195,6536,1736,9467,347,2609,2956
2019-04-15,15,3963,5086,2310,10099,10755,1756,59,22736,1065,6364,1626,9055,295,2736,3031
2019-04-15,16,4030,5071,2278,10228,10878,1814,60,23046,846,5865,1437,8148,255,2820,3075
2019-04-15,17,4062,5049,2275,10494,11040,1934,60,23594,708,5190,1184,7082,250,2898,3148
2019-04-15,18,4071,5033,2306,10918,11235,2074,59,24353,415,3736,754,4905,225,2891,3116
2019-04-15,19,4064,5034,2367,11332,11468,2268,57,25192,167,1145,259,1571,198,2828,3026
2019-04-15,20,4186,5207,2415,11798,12056,2473,58,26452,9,46,10,65,182,2725,2907
2019-04-15,21,4211,5140,2494,12199,12215,2504,58,27042,0,0,0,0,184,2749,2933
2019-04-15,22,4014,4848,2380,11764,11703,2357,54,25943,0,0,0,0,187,2812,2999
2019-04-15,23,3735,4557,2186,10926,10896,2139,49,24076,0,0,0,0,237,2851,3088
2019-04-15,24,3485,4358,2012,10160,10121,1946,46,22339,0,0,0,0,283,2808,3091
2019-04-16,1,3255,4293,1885,9249,9625,1853,47,20840,0,0,0,0,233,2818,3051
2019-04-16,2,3133,4249,1840,8901,9242,1777,46,20032,0,0,0,0,285,2775,3060
2019-04-16,3,3060,4238,1826,8699,9077,1730,45,19619,0,0,0,0,324,2654,2978
2019-04-16,4,3039,4305,1846,8651,9008,1711,46,19483,0,0,0,0,365,2560,2925
2019-04-16,5,3085,4504,1938,8866,9230,1750,47,19961,0,0,0,0,400,2421,2821
2019-04-16,6,3209,4858,2183,9515,9885,1901,52,21421,0,0,0,0,395,2390,2785
2019-04-16,7,3309,5106,2523,10571,10658,2108,56,23460,11,165,10,186,393,2262,2655
2019-04-16,8,3383,5195,2683,11209,10990,2210,58,24534,294,1743,216,2253,382,2281,2663
2019-04-16,9,3431,5223,2642,11137,10907,2183,60,24354,735,3617,554,4906,288,2466,2754
2019-04-16,10,3458,5221,2571,10829,10675,2175,61,23807,1119,4812,921,6852,221,2627,2848
2019-04-16,11,3471,5217,2490,10434,10485,2160,60,23205,1249,5422,1118,7789,189,2749,2938
2019-04-16,12,3452,5194,2421,10237,10492,2145,58,22999,1325,5976,1230,8531,174,2922,3096
2019-04-16,13,3433,5201,2378,10069,10454,2105,58,22752,1441,6205,1347,8993,167,3078,3245
2019-04-16,14,3449,5183,2329,10064,10526,2063,58,22777,1444,6267,1388,9099,162,3196,3358
2019-04-16,15,3482,5169,2281,9955,10529,2012,58,22622,1444,6212,1419,9075,168,3297,3465
2019-04-16,16,3529,5178,2245,9950,10557,2017,58,22649,1419,5995,1419,8833,198,3386,3584
2019-04-16,17,3551,5164,2240,10155,10693,2101,59,23075,1379,5372,1320,8071,255,3343,3598
2019-04-16,18,3552,5139,2265,10679,10910,2231,60,23947,1197,3974,1000,6171,269,3385,3654
2019-04-16,19,3585,5150,2298,11242,11297,2339,60,25003,508,1358,413,2279,293,3353,3646
2019-04-16,20,3767,5321,2332,11755,12019,2524,62,26425,24,86,23,133,308,3300,3608
2019-04-16,21,3846,5239,2407,12145,12255,2533,61,27060,0,0,0,0,315,3276,3591
2019-04-16,22,3723,4955,2315,11629,11767,2384,58,25903,0,0,0,0,309,3179,3488
2019-04-16,23,3606,4663,2122,10762,10958,2166,54,24005,0,0,0,0,307,2935,3242
2019-04-16,24,3393,4468,1952,9964,10170,1970,50,22221,0,0,0,0,290,2716,3006
2019-04-17,1,3172,4312,1836,9261,9459,1825,47,20658,0,0,0,0,324,2425,2749
2019-04-17,2,3065,4271,1782,8905,9117,1745,46,19880,0,0,0,0,312,2266,2578
2019-04-17,3,3008,4272,1758,8699,8912,1699,47,19425,0,0,0,0,297,2060,2357
2019-04-17,4,2994,4356,1774,8678,8848,1690,48,19332,0,0,0,0,269,1850,2119
2019-04-17,5,3051,4571,1861,8909,9065,1733,51,19825,0,0,0,0,247,1580,1827
2019-04-17,6,3205,4913,2099,9546,9684,1896,57,21249,0,0,0,0,224,1192,1416
2019-04-17,7,3308,5158,2428,10525,10475,2088,64,23219,25,302,29,356,196,786,982
2019-04-17,8,3343,5222,2592,11076,10796,2132,64,24137,595,2874,502,3971,175,488,663
2019-04-17,9,3369,5219,2557,10729,10830,2037,62,23725,1294,5853,1215,8362,137,347,484
2019-04-17,10,3377,5192,2497,10170,10743,1876,60,22918,1438,6946,1606,9990,105,342,447
2019-04-17,11,3389,5155,2432,9634,10700,1759,59,22219,1474,7425,1787,10686,90,359,449
2019-04-17,12,3388,5096,2382,9237,10637,1677,58,21677,1488,7535,1826,10849,85,337,422
2019-04-17,13,3424,5077,2362,8949,10652,1648,58,21375,1494,7549,1836,10879,86,305,391
2019-04-17,14,3507,5049,2334,8895,10760,1669,58,21450,1489,7557,1834,10880,95,273,368
2019-04-17,15,3608,5026,2307,8985,10881,1710,58,21701,1484,7531,1809,10824,92,308,400
2019-04-17,16,3724,5029,2289,9196,11088,1791,58,22200,1475,7261,1807,10543,97,473,570
2019-04-17,17,3819,5014,2302,9596,11295,1936,58,22952,1437,6628,1631,9696,124,702,826
2019-04-17,18,3903,5000,2321,10291,11508,2123,58,24047,1268,5119,1226,7613,156,871,1027
2019-04-17,19,3898,5018,2324,10999,11693,2311,58,25126,553,1740,480,2773,201,1031,1232
2019-04-17,20,4001,5198,2325,11656,12240,2514,60,26535,29,118,25,172,266,1230,1496
2019-04-17,21,4004,5147,2369,11984,12479,2500,60,27088,0,0,0,0,308,1238,1546
2019-04-17,22,3820,4876,2257,11527,11933,2364,56,25945,0,0,0,0,365,1199,1564
2019-04-17,23,3554,4589,2061,10653,11072,2144,51,23986,0,0,0,0,426,1117,1543
2019-04-17,24,3336,4395,1895,9911,10237,1952,48,22215,0,0,0,0,412,866,1278
2019-04-18,1,3230,4283,1783,9706,9738,1861,45,21417,0,0,0,0,353,546,899
2019-04-18,2,3124,4245,1731,9373,9349,1785,45,20619,0,0,0,0,351,429,780
2019-04-18,3,3052,4248,1702,9193,9101,1730,45,20136,0,0,0,0,301,329,630
2019-04-18,4,3025,4327,1708,9139,9012,1708,46,19973,0,0,0,0,248,251,499
2019-04-18,5,3066,4527,1785,9337,9223,1746,48,20423,0,0,0,0,189,213,402
2019-04-18,6,3188,4878,2013,9912,9850,1882,53,21763,0,0,0,0,141,196,337
2019-04-18,7,3278,5121,2324,10840,10604,2064,58,23631,29,295,30,354,112,212,324
2019-04-18,8,3362,5186,2497,11313,10941,2132,59,24513,583,2773,506,3862,103,233,336
2019-04-18,9,3466,5183,2466,11103,10928,2091,60,24246,1287,5648,1212,8147,82,264,346
2019-04-18,10,3569,5164,2426,10758,10996,2022,58,23900,1432,6673,1585,9690,57,350,407
2019-04-18,11,3654,5130,2395,10457,11141,1966,58,23689,1473,7179,1787,10439,42,429,471
2019-04-18,12,3732,5070,2361,10265,11338,1936,58,23663,1492,7294,1814,10600,29,422,451
2019-04-18,13,3825,5064,2357,10189,11582,1936,60,23834,1492,7268,1823,10583,21,392,413
2019-04-18,14,3932,5047,2353,10403,11953,1989,62,24475,1488,7231,1815,10534,15,349,364
2019-04-18,15,4042,5032,2351,10718,12249,2074,62,25172,1480,7186,1784,10450,15,270,285
2019-04-18,16,4165,5031,2351,11254,12582,2164,63,26131,1468,6663,1742,9873,19,221,240
2019-04-18,17,4267,5021,2366,11889,12863,2284,64,27170,1428,6013,1537,8978,27,169,196
2019-04-18,18,4317,4970,2384,12354,12963,2404,64,27852,1264,4519,1105,6888,37,145,182
2019-04-18,19,4305,4981,2367,12777,12853,2472,63,28233,544,1514,438,2496,52,180,232
2019-04-18,20,4375,5152,2369,13124,13110,2604,63,28968,34,67,25,126,100,337,437
2019-04-18,21,4352,5092,2395,13242,13208,2609,62,29187,0,0,0,0,163,478,641
2019-04-18,22,4124,4824,2245,12557,12565,2442,57,27687,0,0,0,0,253,556,809
2019-04-18,23,3795,4540,2032,11555,11586,2201,52,25460,0,0,0,0,337,658,995
2019-04-18,24,3529,4361,1843,10692,10654,1989,48,23450,0,0,0,0,326,572,898
2019-04-19,1,3380,4245,1697,10149,10268,1878,47,22408,0,0,0,0,248,309,557
2019-04-19,2,3226,4209,1639,9673,9833,1787,46,21405,0,0,0,0,257,313,570
2019-04-19,3,3113,4201,1594,9394,9515,1740,46,20761,0,0,0,0,244,288,532
2019-04-19,4,3059,4261,1588,9323,9365,1715,46,20515,0,0,0,0,224,242,466
2019-04-19,5,3078,4427,1654,9399,9422,1745,47,20679,0,0,0,0,207,193,400
2019-04-19,6,3175,4709,1872,9806,9982,1861,52,21767,0,0,0,0,193,151,344
2019-04-19,7,3242,4902,2158,10530,10707,2027,55,23385,63,465,48,576,172,117,289
2019-04-19,8,3335,5032,2282,10901,11064,2084,57,24171,402,2405,386,3193,148,96,244
2019-04-19,9,3509,5071,2252,10864,11044,2038,57,24069,832,4788,910,6530,113,86,199
2019-04-19,10,3660,5057,2235,10651,11086,1974,57,23834,1069,6162,1282,8513,79,88,167
2019-04-19,11,3793,5027,2217,10470,11242,1923,59,23759,1166,6729,1501,9396,67,105,172
2019-04-19,12,3946,4976,2170,10336,11386,1886,62,23735,1193,6918,1603,9714,73,115,188
2019-04-19,13,4088,4967,2139,10298,11592,1876,65,23897,1178,6904,1607,9689,99,106,205
2019-04-19,14,4212,4970,2121,10485,11907,1913,68,24438,1163,6825,1588,9576,150,94,244
2019-04-19,15,4368,5003,2098,10743,12110,1949,69,24937,1144,6624,1530,9298,227,131,358
2019-04-19,16,4490,5037,2086,11160,12278,2029,70,25604,1091,6237,1429,8757,321,293,614
2019-04-19,17,4604,5055,2063,11643,12534,2172,72,26488,976,5474,1242,7692,423,629,1052
2019-04-19,18,4658,5012,2040,12125,12706,2310,72,27278,716,3785,860,5361,525,1015,1540
2019-04-19,19,4563,4943,2012,12521,12639,2390,71,27686,330,1411,355,2096,617,1305,1922
2019-04-19,20,4597,5056,1992,12780,12827,2522,69,28264,56,123,43,222,710,1509,2219
2019-04-19,21,4539,4977,2065,12984,12888,2498,67,28502,0,0,0,0,785,1679,2464
2019-04-19,22,4352,4732,2001,12503,12271,2375,61,27276,0,0,0,0,831,1823,2654
2019-04-19,23,4101,4478,1852,11760,11408,2207,56,25497,0,0,0,0,869,1918,2787
2019-04-19,24,3809,4264,1715,10918,10528,2023,51,23586,0,0,0,0,904,1957,2861
2019-04-20,1,3567,4176,1632,9698,9899,1884,46,21591,0,0,0,0,988,1717,2705
2019-04-20,2,3401,4110,1575,9264,9373,1783,43,20529,0,0,0,0,1006,1742,2748
2019-04-20,3,3300,4077,1532,8960,9059,1721,42,19849,0,0,0,0,1006,1873,2879
2019-04-20,4,3240,4087,1523,8782,8882,1694,43,19466,0,0,0,0,984,2057,3041
2019-04-20,5,3227,4148,1550,8768,8899,1701,44,19479,0,0,0,0,951,2183,3134
2019-04-20,6,3294,4247,1641,8932,9186,1754,47,19984,0,0,0,0,925,2222,3147
2019-04-20,7,3256,4343,1769,9258,9304,1807,49,20484,63,523,54,640,904,2200,3104
2019-04-20,8,3315,4497,1909,9442,9331,1847,51,20735,370,2633,398,3401,880,2098,2978
2019-04-20,9,3510,4630,2023,9530,9465,1860,52,20975,749,5165,918,6832,847,2003,2850
2019-04-20,10,3704,4681,2059,9383,9483,1859,55,20845,966,6542,1308,8816,816,1968,2784
2019-04-20,11,3848,4687,2047,9157,9435,1762,56,20476,1064,7081,1516,9661,799,2007,2806
2019-04-20,12,3940,4664,2014,8916,9364,1628,58,20030,1103,7276,1580,9959,794,2167,2961
2019-04-20,13,3994,4670,1973,8693,9262,1521,59,19600,1121,7279,1575,9975,812,2405,3217
2019-04-20,14,4036,4690,1921,8602,9310,1450,60,19488,1161,7235,1601,9997,855,2643,3498
2019-04-20,15,4101,4741,1880,8624,9420,1480,60,19651,1212,7048,1663,9923,903,2824,3727
2019-04-20,16,4123,4823,1857,8816,9676,1584,60,20202,1210,6655,1634,9499,938,2938,3876
2019-04-20,17,4132,4802,1858,9190,10018,1773,61,21108,1155,5935,1459,8549,954,2979,3933
2019-04-20,18,4114,4770,1860,9811,10334,1990,60,22260,943,4204,1060,6207,934,2958,3892
2019-04-20,19,4073,4759,1876,10370,10697,2168,57,23357,478,1609,456,2543,866,2868,3734
2019-04-20,20,4136,4899,1901,10844,11159,2347,55,24470,87,137,59,283,763,2732,3495
2019-04-20,21,4161,4854,1986,11247,11437,2359,55,25163,0,0,0,0,648,2632,3280
2019-04-20,22,4013,4638,1944,10949,11061,2280,54,24407,0,0,0,0,537,2599,3136
2019-04-20,23,3801,4399,1823,10345,10451,2130,50,23041,0,0,0,0,448,2621,3069
2019-04-20,24,3605,4195,1701,9682,9834,1960,47,21589,0,0,0,0,386,2631,3017
2019-04-21,1,3313,4053,1615,9246,9301,1847,47,20506,0,0,0,0,425,2520,2945
2019-04-21,2,3157,3993,1563,8835,8908,1755,45,19609,0,0,0,0,349,2509,2858
2019-04-21,3,3062,3962,1544,8587,8648,1681,44,19027,0,0,0,0,287,2507,2794
2019-04-21,4,2993,3970,1560,8458,8441,1649,43,18658,0,0,0,0,253,2497,2750
2019-04-21,5,2972,4012,1611,8459,8480,1659,45,18709,0,0,0,0,244,2485,2729
2019-04-21,6,3013,4078,1713,8642,8659,1715,46,19127,0,0,0,0,236,2483,2719
2019-04-21,7,2900,4161,1834,8975,8702,1761,49,19553,87,566,68,721,219,2470,2689
2019-04-21,8,2972,4322,1995,9105,8717,1814,51,19752,516,2723,493,3732,191,2432,2623
2019-04-21,9,3126,4405,2110,8966,8741,1843,55,19667,1023,5240,1104,7367,174,2437,2611
2019-04-21,10,3256,4429,2128,8634,8686,1775,55,19213,1261,6603,1493,9357,208,2489,2697
2019-04-21,11,3349,4409,2080,8295,8595,1674,54,18681,1343,7145,1685,10173,253,2497,2750
2019-04-21,12,3412,4417,2027,7994,8493,1507,52,18107,1377,7353,1767,10497,257,2467,2724
2019-04-21,13,3489,4368,1986,7854,8404,1385,51,17756,1382,7356,1773,10511,242,2488,2730
2019-04-21,14,3567,4349,1926,7881,8529,1320,52,17843,1391,7327,1776,10494,231,2602,2833
2019-04-21,15,3624,4356,1880,8026,8750,1353,52,18245,1398,7180,1780,10358,251,2797,3048
2019-04-21,16,3675,4391,1845,8365,9044,1420,53,18948,1380,6796,1720,9896,299,3002,3301
2019-04-21,17,3676,4355,1852,8968,9359,1568,55,20016,1339,6071,1567,8977,360,3136,3496
2019-04-21,18,3731,4349,1886,9675,9752,1750,55,21297,1133,4344,1187,6664,431,3201,3632
2019-04-21,19,3697,4449,1928,10380,10167,1935,54,22603,592,1693,529,2814,505,3221,3726
2019-04-21,20,3799,4724,1976,11060,10804,2178,55,24163,106,151,72,329,577,3215,3792
2019-04-21,21,3879,4772,2077,11451,11186,2274,56,25033,0,1,0,1,620,3200,3820
2019-04-21,22,3762,4589,2003,11077,10899,2183,54,24278,0,0,0,0,611,3160,3771
2019-04-21,23,3529,4356,1837,10375,10308,2020,50,22819,0,0,0,0,563,3074,3637
2019-04-21,24,3323,4211,1714,9660,9674,1863,47,21309,0,0,0,0,502,2928,3430
2019-04-22,1,3122,4072,1640,9150,9056,1777,44,20093,0,0,0,0,357,2694,3051
2019-04-22,2,3015,4050,1610,8806,8831,1711,43,19457,0,0,0,0,281,2417,2698
2019-04-22,3,2955,4064,1604,8630,8668,1670,43,19078,0,0,0,0,247,2108,2355
2019-04-22,4,2939,4151,1636,8636,8662,1660,44,19068,0,0,0,0,265,1826,2091
2019-04-22,5,2993,4362,1739,8900,8968,1709,46,19690,0,0,0,0,309,1573,1882
2019-04-22,6,3122,4728,1984,9537,9682,1853,51,21191,0,0,0,0,350,1289,1639
2019-04-22,7,3216,4979,2307,10437,10389,2051,56,23000,108,561,79,748,376,981,1357
2019-04-22,8,3305,5077,2484,11016,10743,2115,58,23997,612,2718,544,3874,386,688,1074
2019-04-22,9,3393,5088,2450,10915,10774,2065,59,23879,1168,5246,1202,7616,388,450,838
2019-04-22,10,3472,5073,2392,10534,10747,1954,58,23361,1377,6616,1585,9578,406,333,739
2019-04-22,11,3548,5030,2346,10302,10667,1857,59,22952,1423,7151,1751,10325,437,375,812
2019-04-22,12,3607,4960,2303,10149,10655,1788,59,22718,1441,7308,1820,10569,457,479,936
2019-04-22,13,3678,4936,2286,10120,10709,1776,60,22732,1443,7254,1823,10520,473,572,1045
2019-04-22,14,3788,4893,2268,10331,10840,1801,60,23101,1443,7106,1819,10368,483,704,1187
2019-04-22,15,3897,4860,2249,10618,11043,1853,61,23643,1438,6790,1809,10037,473,931,1404
2019-04-22,16,4007,4853,2238,11178,11346,1950,61,24603,1411,6322,1743,9476,447,1221,1668
2019-04-22,17,4097,4845,2245,11734,11590,2068,61,25521,1365,5585,1586,8536,387,1476,1863
2019-04-22,18,4107,4842,2271,12374,11824,2212,62,26539,1155,3941,1208,6304,304,1638,1942
2019-04-22,19,4110,4863,2282,12880,12040,2307,62,27355,606,1469,542,2617,245,1719,1964
2019-04-22,20,4177,5022,2280,13237,12690,2453,63,28508,112,128,76,316,237,1739,1976
2019-04-22,21,4189,4967,2307,13457,12710,2492,63,28788,0,1,0,1,256,1639,1895
2019-04-22,22,3986,4691,2179,12806,12120,2357,59,27408,0,0,0,0,291,1431,1722
2019-04-22,23,3706,4411,1982,11781,11281,2142,53,25322,0,0,0,0,331,1236,1567
2019-04-22,24,3443,4234,1805,10860,10468,1952,49,23397,0,0,0,0,343,1078,1421
2019-04-23,1,3373,4190,1724,9399,9870,1856,45,21235,0,0,0,0,418,849,1267
2019-04-23,2,3232,4153,1670,9003,9381,1777,44,20270,0,0,0,0,371,713,1084
2019-04-23,3,3136,4152,1640,8799,9117,1727,43,19753,0,0,0,0,333,649,982
2019-04-23,4,3098,4227,1645,8689,9039,1710,44,19546,0,0,0,0,312,647,959
2019-04-23,5,3130,4436,1718,8813,9258,1749,46,19930,0,0,0,0,298,664,962
2019-04-23,6,3259,4783,1932,9351,9898,1885,51,21248,0,0,0,0,281,615,896
2019-04-23,7,3349,5028,2240,10294,10513,2062,56,22990,115,611,87,813,256,474,730
2019-04-23,8,3470,5112,2401,11098,10903,2132,58,24256,623,2862,561,4046,220,313,533
2019-04-23,9,3620,5110,2368,11206,11090,2091,58,24511,1170,5396,1217,7783,188,247,435
2019-04-23,10,3746,5096,2350,11036,11126,2013,57,24298,1373,6692,1592,9657,172,283,455
2019-04-23,11,3870,5070,2321,10881,11374,1951,58,24331,1419,7187,1754,10360,160,337,497
2019-04-23,12,3997,5031,2300,10865,11652,1914,59,24556,1437,7352,1823,10612,146,360,506
2019-04-23,13,4126,5033,2307,10979,11978,1908,61,24994,1436,7342,1825,10603,127,332,459
2019-04-23,14,4267,5014,2306,11421,12352,1954,63,25859,1431,7289,1820,10540,100,299,399
2019-04-23,15,4412,5021,2298,11768,12731,2024,64,26657,1421,7113,1814,10348,74,318,392
2019-04-23,16,4571,5077,2295,12323,13066,2117,65,27639,1395,6726,1746,9867,54,422,476
2019-04-23,17,4663,5100,2278,12738,13316,2243,67,28430,1346,6003,1581,8930,41,631,672
2019-04-23,18,4731,5027,2278,13325,13460,2383,67,29303,1132,4342,1199,6673,36,915,951
2019-04-23,19,4712,5018,2288,13698,13469,2468,66,29768,598,1724,545,2867,50,1230,1280
2019-04-23,20,4740,5136,2284,13935,13692,2593,65,30352,106,188,79,373,97,1555,1652
2019-04-23,21,4681,5058,2308,14059,13723,2601,63,30512,0,1,0,1,160,1765,1925
2019-04-23,22,4429,4782,2178,13332,13049,2441,58,28943,0,0,0,0,209,1799,2008
2019-04-23,23,4069,4485,1985,12293,11988,2189,53,26588,0,0,0,0,242,1740,1982
2019-04-23,24,3755,4278,1806,11374,10964,1983,49,24435,0,0,0,0,269,1663,1932
2019-04-24,1,3540,4180,1718,10142,10050,1873,48,22178,0,0,0,0,411,1888,2299
2019-04-24,2,3362,4138,1665,9657,9546,1790,46,21101,0,0,0,0,418,1768,2186
2019-04-24,3,3253,4128,1631,9358,9275,1736,45,20479,0,0,0,0,373,1619,1992
2019-04-24,4,3183,4195,1637,9234,9146,1717,46,20209,0,0,0,0,306,1427,1733
2019-04-24,5,3195,4392,1712,9383,9264,1754,48,20514,0,0,0,0,256,1208,1464
2019-04-24,6,3294,4723,1932,9878,9866,1893,52,21744,0,0,0,0,222,1021,1243
2019-04-24,7,3415,4976,2244,10618,10514,2064,56,23317,117,643,89,849,192,832,1024
2019-04-24,8,3548,5063,2409,11162,10912,2142,58,24332,620,2942,557,4119,162,615,777
2019-04-24,9,3723,5081,2386,11193,11210,2118,59,24645,1167,5494,1214,7875,128,427,555
2019-04-24,10,3881,5084,2358,11072,11314,2062,59,24570,1372,6792,1584,9748,99,305,404
2019-04-24,11,4060,5077,2337,11069,11538,2011,62,24744,1414,7289,1753,10456,76,255,331
2019-04-24,12,4239,5043,2309,11238,11830,1975,64,25173,1426,7478,1819,10723,51,262,313
2019-04-24,13,4400,5070,2296,11445,12100,1973,67,25651,1422,7494,1820,10736,31,326,357
2019-04-24,14,4566,5092,2280,11880,12541,2016,71,26574,1419,7471,1817,10707,22,467,489
2019-04-24,15,4745,5143,2270,12388,12977,2084,73,27588,1414,7324,1810,10548,21,744,765
2019-04-24,16,4915,5185,2262,12990,13289,2160,75,28579,1389,6952,1743,10084,30,1172,1202
2019-04-24,17,4996,5187,2271,13654,13537,2276,77,29609,1327,6229,1584,9140,53,1609,1662
2019-04-24,18,5037,5099,2273,14194,13589,2396,75,30319,1097,4530,1192,6819,96,1881,1977
2019-04-24,19,4985,5072,2280,14642,13451,2466,74,30697,574,1815,535,2924,161,1932,2093
2019-04-24,20,5002,5158,2271,14672,13530,2586,71,30925,110,201,78,389,241,1858,2099
2019-04-24,21,4919,5078,2296,14633,13526,2590,68,30881,0,1,0,1,320,1822,2142
2019-04-24,22,4657,4779,2192,13781,12826,2429,62,29161,0,0,0,0,384,1868,2252
2019-04-24,23,4287,4483,1996,12502,11769,2197,56,26586,0,0,0,0,431,1955,2386
2019-04-24,24,3957,4276,1827,11417,10761,1993,51,24287,0,0,0,0,461,2019,2480
2019-04-25,1,3690,4189,1723,10395,9894,1894,49,22295,0,0,0,0,575,2202,2777
2019-04-25,2,3501,4142,1676,9821,9385,1811,47,21130,0,0,0,0,598,2164,2762
2019-04-25,3,3371,4131,1649,9495,9149,1754,46,20510,0,0,0,0,625,2096,2721
2019-04-25,4,3305,4196,1661,9350,9034,1731,46,20228,0,0,0,0,642,2027,2669
2019-04-25,5,3303,4389,1743,9461,9235,1767,48,20576,0,0,0,0,633,1936,2569
2019-04-25,6,3401,4719,1976,10030,9749,1901,52,21796,0,0,0,0,583,1816,2399
2019-04-25,7,3538,4957,2291,10843,10373,2070,56,23407,117,654,93,864,498,1667,2165
2019-04-25,8,3699,5067,2451,11339,10750,2151,58,24363,614,2946,561,4121,382,1415,1797
2019-04-25,9,3903,5099,2410,11258,10989,2142,61,24505,1148,5424,1175,7747,266,1110,1376
2019-04-25,10,4096,5118,2367,11035,11121,2089,64,24366,1348,6664,1541,9553,190,834,1024
2019-04-25,11,4320,5116,2335,10993,11350,2037,67,24505,1390,7145,1716,10251,151,627,778
2019-04-25,12,4558,5080,2295,11068,11573,1999,70,24768,1401,7324,1794,10519,142,535,677
2019-04-25,13,4756,5094,2281,11261,11765,1992,74,25149,1393,7325,1800,10518,170,553,723
2019-04-25,14,4979,5121,2268,11688,12108,2030,78,25960,1375,7254,1784,10413,233,690,923
2019-04-25,15,5172,5167,2255,12159,12445,2092,80,26831,1333,7067,1735,10135,328,970,1298
2019-04-25,16,5340,5200,2247,12648,12839,2167,81,27796,1277,6622,1637,9536,444,1327,1771
2019-04-25,17,5398,5200,2235,13057,13257,2277,83,28741,1189,5774,1472,8435,555,1645,2200
2019-04-25,18,5412,5129,2240,13586,13419,2398,81,29550,943,4102,1096,6141,652,1824,2476
2019-04-25,19,5330,5105,2248,13875,13309,2467,78,29796,486,1679,498,2663,741,1844,2585
2019-04-25,20,5289,5192,2242,13985,13380,2574,76,30081,100,187,77,364,836,1784,2620
2019-04-25,21,5179,5117,2271,13959,13401,2581,72,30079,0,1,0,1,912,1771,2683
2019-04-25,22,4879,4812,2162,13156,12626,2428,66,28342,0,0,0,0,935,1880,2815
2019-04-25,23,4511,4521,1974,12034,11564,2198,59,25919,0,0,0,0,919,2023,2942
2019-04-25,24,4164,4310,1802,11080,10529,2001,54,23728,0,0,0,0,885,2103,2988
2019-04-26,1,3847,4198,1717,10521,10190,1894,53,22721,0,0,0,0,812,2054,2866
2019-04-26,2,3643,4138,1664,10012,9728,1804,51,21656,0,0,0,0,743,2004,2747
2019-04-26,3,3510,4118,1635,9697,9482,1746,49,21030,0,0,0,0,694,1941,2635
2019-04-26,4,3423,4167,1638,9558,9370,1725,49,20768,0,0,0,0,655,1894,2549
2019-04-26,5,3428,4341,1709,9689,9560,1759,50,21124,0,0,0,0,606,1858,2464
2019-04-26,6,3531,4626,1896,10215,10153,1894,53,22380,0,0,0,0,526,1828,2354
2019-04-26,7,3613,4870,2175,11227,10677,2062,56,24086,132,664,96,892,423,1773,2196
2019-04-26,8,3781,4995,2329,11564,10844,2200,59,24733,646,2946,569,4161,306,1633,1939
2019-04-26,9,3998,5058,2325,11538,10926,2176,62,24767,1169,5386,1201,7756,206,1487,1693
2019-04-26,10,4211,5080,2309,11296,10960,2040,64,24426,1364,6621,1574,9559,141,1429,1570
2019-04-26,11,4429,5077,2288,11232,11125,1895,68,24384,1410,7113,1744,10267,98,1473,1571
2019-04-26,12,4645,5052,2250,11080,11306,1827,71,24350,1429,7303,1816,10548,72,1624,1696
2019-04-26,13,4852,5088,2223,11187,11523,1813,74,24658,1427,7326,1816,10569,58,1862,1920
2019-04-26,14,5056,5128,2200,11523,11891,1838,77,25384,1418,7292,1806,10516,54,2109,2163
2019-04-26,15,5251,5150,2166,12033,12219,1888,79,26273,1395,7105,1774,10274,62,2340,2402
2019-04-26,16,5423,5119,2144,12521,12488,1980,80,27126,1332,6670,1648,9650,92,2556,2648
2019-04-26,17,5437,5031,2136,13108,12699,2122,81,28067,1258,5871,1450,8579,153,2713,2866
2019-04-26,18,5411,4911,2122,13556,12794,2289,80,28775,1053,4211,1108,6372,226,2753,2979
2019-04-26,19,5327,4838,2112,13861,12713,2389,78,29104,581,1714,528,2823,297,2675,2972
2019-04-26,20,5263,4932,2080,13956,12841,2459,75,29397,126,197,86,409,380,2554,2934
2019-04-26,21,5146,4911,2138,13989,12945,2480,72,29550,0,1,0,1,452,2555,3007
2019-04-26,22,4880,4736,2072,13324,12428,2367,66,28247,0,0,0,0,486,2699,3185
2019-04-26,23,4555,4491,1938,12279,11620,2196,60,26218,0,0,0,0,487,2819,3306
2019-04-26,24,4231,4282,1804,11297,10759,2021,55,24195,0,0,0,0,474,2863,3337
2019-04-27,1,3981,4182,1749,10294,9962,1889,51,22261,0,0,0,0,601,2752,3353
2019-04-27,2,3773,4123,1699,9767,9468,1792,48,21142,0,0,0,0,579,2802,3381
2019-04-27,3,3619,4102,1669,9434,9207,1731,47,20486,0,0,0,0,557,2836,3393
2019-04-27,4,3511,4118,1672,9240,9004,1700,46,20058,0,0,0,0,545,2849,3394
2019-04-27,5,3461,4196,1710,9213,9022,1706,47,20055,0,0,0,0,529,2833,3362
2019-04-27,6,3458,4300,1805,9418,9292,1752,48,20576,0,0,0,0,494,2777,3271
2019-04-27,7,3408,4384,1943,9756,9353,1811,50,21036,141,708,97,946,448,2668,3116
2019-04-27,8,3526,4545,2065,9828,9379,1853,52,21177,655,2995,543,4193,379,2473,2852
2019-04-27,9,3755,4638,2163,9928,9574,1844,56,21466,1148,5320,1114,7582,309,2266,2575
2019-04-27,10,3996,4673,2188,9744,9715,1771,60,21350,1327,6502,1481,9310,255,2148,2403
2019-04-27,11,4217,4666,2163,9702,9863,1647,63,21336,1366,7025,1662,10053,218,2132,2350
2019-04-27,12,4444,4626,2115,9619,9932,1544,67,21220,1362,7199,1711,10272,213,2232,2445
2019-04-27,13,4646,4587,2076,9689,9997,1470,70,21281,1337,7166,1699,10202,255,2434,2689
2019-04-27,14,4833,4554,2032,9867,10085,1441,73,21521,1286,7053,1690,10029,345,2675,3020
2019-04-27,15,5009,4567,1994,10172,10214,1483,75,22006,1200,6803,1633,9636,452,2884,3336
2019-04-27,16,5160,4639,1973,10592,10484,1588,77,22808,1146,6365,1546,9057,540,3030,3570
2019-04-27,17,5219,4715,1976,11103,10713,1754,79,23718,1120,5691,1464,8275,597,3107,3704
2019-04-27,18,5237,4689,1991,11694,11016,1949,77,24805,978,4197,1171,6346,631,3100,3731
2019-04-27,19,5156,4707,2004,12178,11233,2158,75,25712,557,1762,564,2883,667,3022,3689
2019-04-27,20,5071,4836,2018,12377,11674,2342,71,26532,119,201,91,411,739,2899,3638
2019-04-27,21,4950,4830,2119,12629,11885,2348,69,26997,0,1,0,1,812,2816,3628
2019-04-27,22,4685,4664,2090,12142,11483,2264,64,26018,0,0,0,0,838,2810,3648
2019-04-27,23,4439,4428,1967,11340,10859,2123,58,24446,0,0,0,0,831,2805,3636
2019-04-27,24,4144,4222,1840,10623,10099,1969,53,22810,0,0,0,0,805,2799,3604
2019-04-28,1,3949,4117,1755,10095,9321,1850,50,21382,0,0,0,0,575,2672,3247
2019-04-28,2,3760,4052,1712,9593,8899,1753,47,20358,0,0,0,0,566,2651,3217
2019-04-28,3,3616,4026,1702,9301,8662,1693,46,19768,0,0,0,0,573,2618,3191
2019-04-28,4,3506,4039,1719,9130,8508,1669,45,19418,0,0,0,0,567,2564,3131
2019-04-28,5,3444,4089,1770,9098,8461,1669,45,19341,0,0,0,0,532,2480,3012
2019-04-28,6,3444,4134,1859,9218,8575,1705,46,19611,0,0,0,0,467,2350,2817
2019-04-28,7,3355,4207,1956,9330,8448,1706,47,19596,137,662,106,905,392,2134,2526
2019-04-28,8,3465,4372,2091,9309,8441,1711,50,19576,646,2867,587,4100,316,1820,2136
2019-04-28,9,3666,4443,2191,9252,8494,1697,54,19563,1160,5225,1213,7598,251,1505,1756
2019-04-28,10,3869,4495,2206,9062,8439,1575,57,19199,1354,6478,1580,9412,199,1282,1481
2019-04-28,11,4054,4500,2165,8906,8414,1486,60,18932,1398,6983,1740,10121,159,1183,1342
2019-04-28,12,4220,4537,2098,8801,8446,1421,63,18796,1414,7116,1799,10329,125,1217,1342
2019-04-28,13,4374,4520,2049,8791,8595,1385,65,18903,1412,7085,1798,10295,97,1346,1443
2019-04-28,14,4527,4531,2007,8880,8764,1437,67,19216,1403,6953,1777,10133,83,1512,1595
2019-04-28,15,4661,4545,1970,9112,9010,1475,67,19733,1376,6590,1681,9647,94,1625,1719
2019-04-28,16,4788,4608,1954,9531,9330,1601,70,20600,1332,5985,1537,8854,143,1657,1800
2019-04-28,17,4773,4640,1970,10079,9714,1800,69,21729,1252,5059,1345,7656,243,1677,1920
2019-04-28,18,4784,4650,2030,10863,10194,2048,69,23240,1013,3476,970,5459,371,1610,1981
2019-04-28,19,4707,4694,2073,11586,10582,2200,67,24501,536,1407,437,2380,484,1420,1904
2019-04-28,20,4688,4875,2108,12042,11068,2349,64,25589,112,172,71,355,610,1308,1918
2019-04-28,21,4668,4897,2204,12436,11434,2411,62,26408,0,0,0,0,727,1297,2024
2019-04-28,22,4459,4702,2151,12043,11020,2291,58,25477,0,0,0,0,804,1306,2110
2019-04-28,23,4217,4460,1987,11180,10366,2104,52,23768,0,0,0,0,861,1342,2203
2019-04-28,24,3931,4304,1838,10367,9690,1927,47,22096,0,0,0,0,897,1411,2308
2019-04-29,1,3663,4235,1724,9335,9376,1826,48,20652,0,0,0,0,945,1368,2313
2019-04-29,2,3491,4204,1697,8979,9105,1751,46,19948,0,0,0,0,965,1421,2386
2019-04-29,3,3392,4217,1698,8773,8926,1704,45,19515,0,0,0,0,968,1427,2395
2019-04-29,4,3322,4305,1736,8782,8914,1687,45,19493,0,0,0,0,956,1388,2344
2019-04-29,5,3342,4525,1844,9045,9188,1724,46,20069,0,0,0,0,929,1381,2310
2019-04-29,6,3470,4866,2093,9624,9893,1865,50,21497,0,0,0,0,897,1430,2327
2019-04-29,7,3579,5133,2427,10508,10534,2056,53,23216,109,408,47,564,850,1472,2322
2019-04-29,8,3666,5234,2598,11046,11034,2170,56,24372,553,1881,299,2733,779,1476,2255
2019-04-29,9,3775,5244,2549,10970,11236,2167,59,24497,1059,3714,714,5487,709,1484,2193
2019-04-29,10,3856,5243,2484,10624,11327,2135,62,24214,1297,4942,1048,7287,651,1524,2175
2019-04-29,11,3910,5213,2428,10327,11339,2075,63,23871,1368,5472,1263,8103,595,1603,2198
2019-04-29,12,3927,5158,2360,10063,11337,1994,63,23524,1399,5610,1392,8401,565,1779,2344
2019-04-29,13,3958,5144,2326,9927,11184,1942,63,23183,1404,5594,1447,8445,562,2066,2628
2019-04-29,14,3985,5109,2297,10003,11232,1930,62,23295,1394,5452,1466,8312,589,2343,2932
2019-04-29,15,3992,5082,2253,10118,11258,1968,61,23473,1370,5186,1504,8060,661,2558,3219
2019-04-29,16,3973,5073,2217,10560,11427,2007,61,24124,1337,4815,1485,7637,752,2693,3445
2019-04-29,17,3920,5054,2206,11070,11489,2093,58,24777,1287,4223,1359,6869,836,2731,3567
2019-04-29,18,3904,5073,2240,11613,11578,2212,58,25529,1086,3039,1078,5203,901,2706,3607
2019-04-29,19,3925,5092,2269,12144,11780,2336,58,26385,598,1222,515,2335,952,2636,3588
2019-04-29,20,4007,5231,2289,12496,12235,2492,60,27349,127,138,86,351,999,2544,3543
2019-04-29,21,4053,5204,2360,12882,12533,2522,62,28064,0,0,0,0,1036,2486,3522
2019-04-29,22,3896,4936,2294,12356,12013,2379,59,26872,0,0,0,0,1050,2462,3512
2019-04-29,23,3629,4647,2116,11413,11149,2161,54,24843,0,0,0,0,1035,2442,3477
2019-04-29,24,3390,4454,1945,10601,10326,1966,50,23019,0,0,0,0,970,2424,3394
2019-04-30,1,3345,4295,1839,9797,9617,1855,47,21383,0,0,0,0,922,2257,3179
2019-04-30,2,3231,4253,1795,9418,9257,1775,46,20562,0,0,0,0,817,2185,3002
2019-04-30,3,3147,4247,1779,9185,9027,1726,45,20049,0,0,0,0,734,2114,2848
2019-04-30,4,3116,4324,1800,9143,8969,1711,46,19934,0,0,0,0,700,2056,2756
2019-04-30,5,3151,4527,1893,9360,9177,1755,48,20405,0,0,0,0,709,1983,2692
2019-04-30,6,3236,4856,2137,9928,9829,1895,52,21769,0,0,0,0,711,1865,2576
2019-04-30,7,3355,5105,2454,10802,10478,2070,57,23472,144,634,94,872,701,1714,2415
2019-04-30,8,3449,5191,2618,11249,10894,2175,58,24441,649,2713,521,3883,689,1565,2254
2019-04-30,9,3532,5185,2562,11075,10915,2159,59,24274,1137,5016,1092,7245,703,1507,2210
2019-04-30,10,3608,5178,2492,10722,10842,2107,59,23797,1315,6340,1473,9128,702,1585,2287
2019-04-30,11,3695,5161,2424,10449,10855,2035,58,23463,1356,6926,1667,9949,647,1767,2414
2019-04-30,12,3762,5118,2363,10179,10805,1969,58,23079,1372,7168,1750,10290,551,1998,2549
2019-04-30,13,3824,5119,2341,10030,10694,1902,58,22753,1377,7203,1766,10346,437,2236,2673
2019-04-30,14,3894,5099,2313,10079,10738,1913,59,22856,1378,7192,1771,10341,344,2452,2796
2019-04-30,15,3975,5086,2270,10176,10771,1952,59,23026,1364,7040,1772,10176,276,2640,2916
2019-04-30,16,4069,5098,2235,10362,10819,1955,60,23262,1342,6652,1716,9710,228,2772,3000
2019-04-30,17,4155,5095,2227,10675,10972,2017,60,23791,1305,5947,1571,8823,207,2811,3018
2019-04-30,18,4173,5087,2255,11272,11164,2124,60,24685,1115,4328,1210,6653,213,2763,2976
2019-04-30,19,4186,5104,2282,11830,11568,2264,60,25787,621,1786,578,2985,258,2630,2888
2019-04-30,20,4266,5230,2299,12265,12051,2423,61,26865,133,234,98,465,340,2440,2780
2019-04-30,21,4293,5206,2359,12641,12439,2496,61,27703,0,1,0,1,402,2248,2650
2019-04-30,22,4112,4940,2296,12153,11952,2370,57,26598,0,0,0,0,411,2081,2492
2019-04-30,23,3797,4652,2120,11231,11106,2157,53,24611,0,0,0,0,392,2012,2404
2019-04-30,24,3551,4458,1957,10445,10301,1961,49,22822,0,0,0,0,383,2049,2432
2019-05-01,1,3311,4353,1875,9838,9612,1853,44,21412,0,0,0,0,377,2175,2552
2019-05-01,2,3202,4304,1826,9475,9258,1773,43,20614,0,0,0,0,370,2184,2554
2019-05-01,3,3140,4317,1805,9267,9025,1726,43,20126,0,0,0,0,336,2154,2490
2019-05-01,4,3118,4398,1826,9215,8955,1710,43,19989,0,0,0,0,289,2041,2330
2019-05-01,5,3159,4599,1910,9496,9173,1754,46,20534,0,0,0,0,255,1864,2119
2019-05-01,6,3275,4922,2146,10090,9801,1897,50,21903,0,0,0,0,237,1606,1843
2019-05-01,7,3366,5191,2428,10875,10448,2071,55,23514,154,750,101,1005,216,1256,1472
2019-05-01,8,3453,5245,2599,11320,10895,2149,56,24486,676,3071,567,4314,176,875,1051
2019-05-01,9,3499,5223,2549,11060,10969,2103,57,24255,1162,5428,1178,7768,121,552,673
2019-05-01,10,3538,5191,2484,10660,10956,2014,57,23753,1334,6635,1541,9510,80,356,436
2019-05-01,11,3569,5152,2428,10274,10933,1921,56,23251,1376,7139,1698,10213,59,266,325
2019-05-01,12,3603,5088,2390,9990,10898,1838,56,22851,1393,7333,1776,10502,44,225,269
2019-05-01,13,3658,5063,2373,9777,10882,1797,57,22582,1391,7321,1791,10503,37,207,244
2019-05-01,14,3738,5032,2348,9811,10985,1814,57,22738,1384,7282,1780,10446,40,230,270
2019-05-01,15,3818,5012,2333,10005,11181,1856,58,23171,1365,7107,1749,10221,52,335,387
2019-05-01,16,3917,5025,2321,10221,11206,1947,58,23505,1320,6634,1647,9601,89,550,639
2019-05-01,17,3988,5039,2324,10700,11379,2078,59,24284,1248,5851,1464,8563,166,856,1022
2019-05-01,18,4052,5030,2340,11313,11515,2198,59,25152,1053,4275,1106,6434,279,1203,1482
2019-05-01,19,4054,5041,2344,11890,11584,2278,58,25876,592,1807,531,2930,395,1504,1899
2019-05-01,20,4077,5173,2337,12264,11983,2410,58,26782,130,249,95,474,492,1697,2189
2019-05-01,21,4171,5181,2384,12514,12390,2495,59,27524,0,1,0,1,564,1784,2348
2019-05-01,22,3984,4915,2343,12059,11885,2351,55,26415,0,0,0,0,594,1796,2390
2019-05-01,23,3705,4623,2157,11122,11033,2140,50,24411,0,0,0,0,591,1768,2359
2019-05-01,24,3473,4431,1990,10323,10225,1952,46,22612,0,0,0,0,572,1753,2325
2019-05-02,1,3253,4336,1880,9792,9748,1848,44,21496,0,0,0,0,575,1871,2446
2019-05-02,2,3143,4291,1834,9424,9471,1777,42,20779,0,0,0,0,531,1835,2366
2019-05-02,3,3083,4303,1811,9227,9228,1726,42,20288,0,0,0,0,480,1796,2276
2019-05-02,4,3063,4376,1827,9150,9157,1708,43,20124,0,0,0,0,433,1754,2187
2019-05-02,5,3115,4575,1907,9337,9378,1752,45,20577,0,0,0,0,403,1666,2069
2019-05-02,6,3242,4896,2131,9888,9980,1892,49,21874,0,0,0,0,377,1520,1897
2019-05-02,7,3320,5147,2420,10704,10624,2064,53,23511,164,704,129,997,343,1294,1637
2019-05-02,8,3419,5209,2579,11330,10925,2146,56,24523,700,2813,634,4147,278,996,1274
2019-05-02,9,3483,5190,2532,11065,10910,2102,56,24200,1179,4890,1242,7311,198,665,863
2019-05-02,10,3544,5160,2476,10697,10827,2015,56,23661,1345,6001,1581,8927,132,376,508
2019-05-02,11,3617,5118,2423,10383,10768,1920,56,23194,1388,6470,1730,9588,87,234,321
2019-05-02,12,3679,5054,2388,10166,10747,1831,58,22868,1406,6634,1802,9842,67,205,272
2019-05-02,13,3759,5033,2375,9984,10800,1792,60,22703,1409,6672,1811,9892,65,235,300
2019-05-02,14,3868,5021,2351,10048,10954,1811,62,22941,1409,6601,1809,9819,73,348,421
2019-05-02,15,3984,5012,2335,10228,11130,1868,63,23356,1401,6396,1795,9592,89,584,673
2019-05-02,16,4092,5033,2322,10629,11311,1945,64,24017,1376,5992,1714,9082,118,1002,1120
2019-05-02,17,4195,5038,2338,11141,11512,2064,66,24849,1322,5261,1552,8135,168,1506,1674
2019-05-02,18,4270,5020,2353,11725,11639,2176,65,25671,1136,3825,1196,6157,234,1879,2113
2019-05-02,19,4199,5006,2351,12264,11808,2255,63,26456,650,1650,582,2882,318,2047,2365
2019-05-02,20,4217,5122,2322,12680,12234,2374,62,27416,143,242,105,490,424,2087,2511
2019-05-02,21,4261,5124,2363,12955,12500,2457,61,28040,0,0,0,0,503,2045,2548
2019-05-02,22,4064,4869,2313,12433,11970,2317,56,26842,0,0,0,0,516,1953,2469
2019-05-02,23,3752,4576,2130,11450,11155,2115,51,24837,0,0,0,0,504,1873,2377
2019-05-02,24,3493,4375,1964,10537,10483,1938,46,23069,0,0,0,0,502,1826,2328
2019-05-03,1,3334,4237,1846,10083,9743,1869,44,21815,0,0,0,0,517,1703,2220
2019-05-03,2,3211,4186,1794,9667,9399,1791,43,20976,0,0,0,0,503,1653,2156
2019-05-03,3,3132,4189,1768,9416,9138,1745,43,20418,0,0,0,0,488,1606,2094
2019-05-03,4,3099,4259,1781,9314,9028,1711,43,20173,0,0,0,0,468,1553,2021
2019-05-03,5,3130,4439,1859,9512,9225,1747,45,20607,0,0,0,0,441,1493,1934
2019-05-03,6,3213,4714,2063,10020,9733,1870,49,21749,0,0,0,0,401,1414,1815
2019-05-03,7,3289,4975,2326,10785,10331,2036,52,23289,154,818,116,1088,345,1284,1629
2019-05-03,8,3443,5067,2481,11299,10740,2101,54,24280,652,3211,587,4450,272,1042,1314
2019-05-03,9,3592,5076,2451,11063,10863,2035,55,24089,1100,5462,1144,7706,187,727,914
2019-05-03,10,3722,5069,2408,10701,10833,1923,54,23586,1269,6546,1485,9300,116,424,540
2019-05-03,11,3831,5045,2374,10441,10875,1791,55,23239,1324,7021,1672,10017,72,214,286
2019-05-03,12,3943,4992,2345,10286,10944,1687,58,23054,1364,7187,1750,10301,52,140,192
2019-05-03,13,4084,4976,2322,10183,11068,1675,61,23074,1359,7173,1759,10291,50,149,199
2019-05-03,14,4226,4955,2309,10326,11301,1685,64,23458,1354,7131,1764,10249,65,222,287
2019-05-03,15,4350,4930,2304,10577,11556,1734,66,24020,1348,6983,1754,10085,97,429,526
2019-05-03,16,4479,4942,2300,11009,11786,1803,68,24745,1330,6625,1688,9643,147,844,991
2019-05-03,17,4607,4941,2313,11571,12057,1925,71,25699,1304,5983,1556,8843,212,1347,1559
2019-05-03,18,4603,4867,2315,12030,12122,2098,70,26394,1147,4488,1229,6864,289,1711,2000
2019-05-03,19,4514,4822,2290,12435,12143,2243,68,26958,672,1970,607,3249,370,1865,2235
2019-05-03,20,4470,4901,2253,12678,12242,2433,65,27493,152,278,112,542,472,1880,2352
2019-05-03,21,4475,4945,2245,12916,12378,2449,63,27881,0,1,0,1,591,1873,2464
2019-05-03,22,4258,4755,2197,12487,12000,2346,57,26967,0,0,0,0,690,1917,2607
2019-05-03,23,3982,4494,2040,11675,11210,2176,52,25190,0,0,0,0,753,1986,2739
2019-05-03,24,3716,4288,1877,10861,10413,1988,47,23386,0,0,0,0,780,2039,2819
2019-05-04,1,3541,4186,1769,9900,9681,1892,44,21613,0,0,0,0,749,2355,3104
2019-05-04,2,3366,4125,1706,9373,9305,1803,42,20618,0,0,0,0,749,2358,3107
2019-05-04,3,3248,4113,1667,9103,9006,1740,41,19985,0,0,0,0,753,2316,3069
2019-05-04,4,3177,4136,1663,8994,8863,1708,41,19701,0,0,0,0,748,2234,2982
2019-05-04,5,3158,4207,1689,9076,8892,1719,43,19824,0,0,0,0,725,2117,2842
2019-05-04,6,3169,4288,1772,9481,9003,1760,45,20385,0,0,0,0,666,1989,2655
2019-05-04,7,3160,4405,1854,9706,9061,1792,47,20702,157,846,128,1131,567,1850,2417
2019-05-04,8,3291,4554,1978,9861,9145,1809,49,20959,671,3304,628,4603,444,1625,2069
2019-05-04,9,3501,4640,2064,9740,9301,1780,50,20960,1143,5614,1227,7984,328,1339,1667
2019-05-04,10,3686,4673,2115,9460,9321,1684,51,20612,1330,6734,1573,9637,242,1072,1314
2019-05-04,11,3870,4688,2129,9219,9310,1545,54,20226,1395,7207,1726,10328,193,867,1060
2019-05-04,12,4044,4670,2100,9036,9272,1492,57,19958,1420,7394,1789,10603,184,798,982
2019-05-04,13,4195,4653,2073,8937,9299,1472,61,19872,1419,7418,1796,10633,218,879,1097
2019-05-04,14,4344,4672,2047,9014,9372,1485,64,20041,1403,7405,1804,10612,294,1101,1395
2019-05-04,15,4492,4717,2052,9236,9578,1530,67,20520,1368,7253,1793,10414,409,1407,1816
2019-05-04,16,4625,4814,2064,9696,9838,1611,69,21324,1328,6864,1721,9913,533,1692,2225
2019-05-04,17,4733,4896,2102,10257,10195,1747,72,22368,1292,6163,1575,9030,632,1910,2542
2019-05-04,18,4715,4854,2160,10831,10641,1941,70,23581,1135,4610,1233,6978,706,2018,2724
2019-05-04,19,4628,4809,2138,11364,10954,2123,67,24605,663,2088,612,3363,790,1994,2784
2019-05-04,20,4559,4893,2125,11766,11278,2329,64,25534,151,308,115,574,870,1909,2779
2019-05-04,21,4551,4897,2130,12087,11550,2355,62,26150,0,1,0,1,941,1884,2825
2019-05-04,22,4340,4693,2075,11808,11230,2257,57,25447,0,0,0,0,986,1958,2944
2019-05-04,23,4074,4445,1914,11152,10598,2116,52,24013,0,0,0,0,1011,2057,3068
2019-05-04,24,3818,4229,1763,10402,9855,1948,47,22349,0,0,0,0,1014,2114,3128
2019-05-05,1,3634,4100,1676,9820,9274,1861,44,21096,0,0,0,0,1024,2076,3100
2019-05-05,2,3469,4030,1610,9446,8905,1776,42,20264,0,0,0,0,992,2013,3005
2019-05-05,3,3336,4002,1568,9179,8608,1710,41,19633,0,0,0,0,981,1952,2933
2019-05-05,4,3259,4012,1561,9011,8501,1681,41,19328,0,0,0,0,982,1900,2882
2019-05-05,5,3217,4049,1579,8980,8479,1683,42,19279,0,0,0,0,985,1837,2822
2019-05-05,6,3233,4072,1634,9095,8525,1712,43,19471,0,0,0,0,968,1773,2741
2019-05-05,7,3135,4164,1695,9209,8436,1716,45,19503,158,827,131,1116,932,1671,2603
2019-05-05,8,3257,4313,1803,9302,8443,1738,47,19626,663,3234,631,4528,883,1482,2365
2019-05-05,9,3444,4395,1912,9197,8464,1755,49,19561,1120,5509,1209,7838,826,1265,2091
2019-05-05,10,3633,4471,1999,9018,8464,1575,50,19203,1293,6620,1535,9448,775,1149,1924
2019-05-05,11,3808,4494,1996,8753,8424,1486,52,18809,1350,7110,1662,10122,738,1181,1919
2019-05-05,12,3997,4539,1983,8470,8423,1421,55,18463,1373,7322,1653,10348,727,1352,2079
2019-05-05,13,4152,4552,1982,8312,8461,1385,57,18310,1368,7353,1616,10337,744,1585,2329
2019-05-05,14,4284,4621,1976,8329,8527,1437,59,18444,1337,7307,1580,10224,795,1783,2578
2019-05-05,15,4413,4703,2008,8399,8706,1475,61,18735,1278,7096,1487,9861,867,1913,2780
2019-05-05,16,4526,4832,2046,8667,8970,1601,64,19399,1227,6647,1421,9295,937,1967,2904
2019-05-05,17,4601,4949,2129,8980,9373,1800,64,20315,1135,5888,1285,8308,990,1957,2947
2019-05-05,18,4618,4885,2142,9776,9810,1990,63,21735,878,4331,945,6154,1018,1900,2918
2019-05-05,19,4534,4851,2160,10535,10298,2128,60,23114,467,1947,453,2867,1032,1840,2872
2019-05-05,20,4494,4929,2152,11165,10707,2276,57,24298,109,297,84,490,1010,1798,2808
2019-05-05,21,4512,4908,2177,11647,11181,2370,56,25347,0,1,0,1,986,1752,2738
2019-05-05,22,4314,4634,2105,11354,10780,2257,53,24539,0,0,0,0,977,1709,2686
2019-05-05,23,4006,4358,1909,10663,10128,2077,49,23011,0,0,0,0,957,1681,2638
2019-05-05,24,3723,4170,1739,9949,9464,1907,45,21461,0,0,0,0,885,1660,2545
2019-05-06,1,3522,4116,1654,9171,9378,1822,44,20516,0,0,0,0,997,1628,2625
2019-05-06,2,3371,4068,1599,8863,9067,1761,42,19835,0,0,0,0,837,1608,2445
2019-05-06,3,3265,4061,1575,8682,8948,1712,42,19485,0,0,0,0,684,1593,2277
2019-05-06,4,3204,4127,1587,8666,8921,1694,42,19425,0,0,0,0,566,1593,2159
2019-05-06,5,3218,4321,1661,8921,9197,1744,44,20007,0,0,0,0,486,1617,2103
2019-05-06,6,3324,4625,1861,9519,9804,1885,48,21356,0,0,0,0,417,1337,1754
2019-05-06,7,3391,4924,2137,10393,10476,2048,51,23068,122,719,66,907,350,1625,1975
2019-05-06,8,3550,5058,2317,10987,10937,2147,54,24222,538,2820,356,3714,299,1582,1881
2019-05-06,9,3690,5138,2337,10947,11107,2146,57,24353,940,5039,744,6723,263,1558,1821
2019-05-06,10,3818,5198,2357,10617,11123,2103,58,23997,1113,6259,1026,8398,224,1560,1784
2019-05-06,11,3917,5228,2363,10216,11104,2022,57,23496,1171,6741,1170,9082,190,1590,1780
2019-05-06,12,4011,5235,2362,9905,11090,1951,56,23099,1197,6801,1213,9211,182,1639,1821
2019-05-06,13,4109,5291,2383,9648,10875,1911,56,22587,1217,6729,1260,9206,197,1717,1914
2019-05-06,14,4190,5332,2393,9665,10824,1919,56,22557,1213,6548,1252,9013,236,1826,2062
2019-05-06,15,4248,5390,2421,9751,10820,1958,56,22684,1188,6075,1169,8432,314,1962,2276
2019-05-06,16,4310,5448,2433,10073,10879,2022,56,23133,1150,5630,1096,7876,437,2112,2549
2019-05-06,17,4366,5466,2449,10541,11023,2128,56,23851,1069,4926,984,6979,557,2232,2789
2019-05-06,18,4346,5361,2497,11219,11345,2244,57,24969,859,3576,779,5214,633,2309,2942
2019-05-06,19,4314,5256,2460,11823,11603,2325,57,25909,468,1542,402,2412,672,2359,3031
2019-05-06,20,4313,5289,2426,12213,12090,2460,58,26924,106,204,76,386,681,2389,3070
2019-05-06,21,4355,5221,2418,12555,12359,2541,58,27614,0,1,0,1,683,2442,3125
2019-05-06,22,4155,4882,2318,12127,11867,2392,54,26541,0,0,0,0,654,2540,3194
2019-05-06,23,3835,4567,2094,11217,11060,2165,50,24589,0,0,0,0,615,2637,3252
2019-05-06,24,3556,4341,1902,10432,10261,1974,46,22812,0,0,0,0,593,2726,3319
2019-05-07,1,3430,4215,1804,9749,9743,1862,44,21503,0,0,0,0,740,2714,3454
2019-05-07,2,3280,4143,1733,9402,9351,1783,43,20678,0,0,0,0,658,2703,3361
2019-05-07,3,3190,4124,1689,9189,9107,1735,42,20173,0,0,0,0,566,2699,3265
2019-05-07,4,3155,4178,1686,9139,8962,1718,43,19960,0,0,0,0,470,2701,3171
2019-05-07,5,3184,4364,1747,9350,9197,1762,45,20453,0,0,0,0,393,2675,3068
2019-05-07,6,3250,4660,1935,9918,9805,1900,49,21771,0,0,0,0,334,2606,2940
2019-05-07,7,3351,4943,2201,10712,10452,2078,53,23395,167,774,112,1053,280,2468,2748
2019-05-07,8,3494,5059,2367,11225,10915,2177,55,24478,689,3044,575,4308,229,2246,2475
2019-05-07,9,3618,5113,2379,11131,11074,2156,56,24514,1138,5304,1156,7598,174,2046,2220
2019-05-07,10,3745,5157,2393,10724,10989,2094,55,23960,1307,6514,1509,9330,125,1944,2069
2019-05-07,11,3853,5181,2386,10358,10922,2007,56,23440,1358,7040,1672,10070,102,1943,2045
2019-05-07,12,3958,5170,2399,10072,10877,1908,56,23011,1380,7241,1753,10374,102,2070,2172
2019-05-07,13,4057,5180,2426,9868,10845,1852,58,22720,1383,7256,1768,10407,122,2345,2467
2019-05-07,14,4183,5167,2439,9927,10870,1861,59,22815,1382,7195,1765,10342,182,2670,2852
2019-05-07,15,4300,5157,2462,10026,10974,1908,61,23065,1378,7004,1756,10138,308,2923,3231
2019-05-07,16,4441,5209,2473,10331,11070,1970,62,23531,1351,6632,1704,9687,515,3072,3587
2019-05-07,17,4513,5247,2520,10693,11143,2087,64,24087,1287,5958,1556,8801,742,3135,3877
2019-05-07,18,4545,5164,2486,11314,11301,2205,63,24983,1099,4426,1207,6732,899,3108,4007
2019-05-07,19,4503,5140,2481,11904,11501,2286,62,25852,643,1983,597,3223,975,3017,3992
2019-05-07,20,4507,5221,2458,12281,11948,2428,60,26817,153,291,114,558,1002,2931,3933
2019-05-07,21,4542,5220,2446,12614,12285,2517,60,27579,0,1,0,1,1009,2911,3920
2019-05-07,22,4320,4945,2348,12209,11880,2373,56,26621,0,0,0,0,1002,2954,3956
2019-05-07,23,3996,4627,2129,11262,11076,2155,50,24646,0,0,0,0,982,2992,3974
2019-05-07,24,3687,4398,1934,10444,10298,1966,46,22859,0,0,0,0,970,3003,3973
2019-05-08,1,3496,4215,1812,9989,9624,1867,44,21622,0,0,0,0,936,3093,4029
2019-05-08,2,3347,4150,1736,9594,9233,1793,43,20762,0,0,0,0,922,3077,3999
2019-05-08,3,3236,4146,1687,9380,8968,1749,43,20238,0,0,0,0,856,3040,3896
2019-05-08,4,3183,4213,1682,9308,8889,1728,43,20068,0,0,0,0,734,2976,3710
2019-05-08,5,3202,4406,1740,9481,9080,1760,45,20464,0,0,0,0,594,2888,3482
2019-05-08,6,3284,4699,1929,10058,9651,1885,49,21742,0,0,0,0,476,2772,3248
2019-05-08,7,3417,4972,2195,10793,10398,2049,53,23392,183,791,128,1102,382,2588,2970
2019-05-08,8,3578,5071,2362,11303,10818,2183,56,24464,733,3081,621,4435,301,2299,2600
2019-05-08,9,3714,5095,2382,11247,10929,2223,56,24556,1204,5358,1213,7775,227,1931,2158
2019-05-08,10,3836,5115,2397,10909,10888,2201,56,24152,1369,6529,1561,9459,164,1552,1716
2019-05-08,11,3966,5125,2400,10587,10764,2146,58,23651,1414,7018,1722,10154,121,1266,1387
2019-05-08,12,4090,5102,2408,10408,10581,2101,61,23245,1432,7204,1795,10431,103,1152,1255
2019-05-08,13,4204,5110,2432,10277,10567,2075,64,23079,1432,7178,1803,10413,105,1230,1335
2019-05-08,14,4339,5107,2449,10465,10657,2070,67,23353,1426,7118,1798,10342,137,1493,1630
2019-05-08,15,4467,5104,2487,10726,10737,2070,69,23699,1412,6931,1787,10130,236,1898,2134
2019-05-08,16,4598,5125,2512,11153,10896,2097,71,24317,1375,6508,1706,9589,435,2341,2776
2019-05-08,17,4698,5132,2516,11578,11070,2138,73,24960,1321,5792,1546,8659,675,2683,3358
2019-05-08,18,4742,5111,2524,12179,11320,2234,72,25905,1153,4307,1206,6666,843,2816,3659
2019-05-08,19,4660,5088,2502,12712,11632,2301,69,26815,689,1962,609,3260,923,2772,3695
2019-05-08,20,4633,5165,2467,12972,12096,2440,66,27674,167,303,120,590,972,2632,3604
2019-05-08,21,4658,5177,2458,13250,12548,2501,64,28463,0,1,0,1,1007,2511,3518
2019-05-08,22,4432,4921,2370,12785,12100,2371,59,27416,0,0,0,0,1019,2484,3503
2019-05-08,23,4115,4611,2148,11745,11143,2167,53,25208,0,0,0,0,1024,2445,3469
2019-05-08,24,3808,4388,1948,10872,10273,1970,48,23262,0,0,0,0,1029,2330,3359
2019-05-09,1,3523,4243,1816,10187,9836,1855,45,22020,0,0,0,0,1043,2204,3247
2019-05-09,2,3369,4186,1743,9790,9421,1778,44,21130,0,0,0,0,1013,2012,3025
2019-05-09,3,3277,4186,1694,9500,9073,1734,43,20447,0,0,0,0,961,1813,2774
2019-05-09,4,3233,4257,1681,9353,8964,1717,43,20175,0,0,0,0,902,1618,2520
2019-05-09,5,3260,4448,1737,9532,9170,1750,45,20593,0,0,0,0,828,1420,2248
2019-05-09,6,3376,4742,1918,10104,9749,1874,49,21872,0,0,0,0,751,1213,1964
2019-05-09,7,3465,5010,2183,10982,10433,2054,52,23618,171,671,88,930,699,982,1681
2019-05-09,8,3589,5099,2342,11434,10990,2170,55,24753,693,2525,469,3687,667,746,1413
2019-05-09,9,3668,5109,2371,11402,11189,2186,56,24935,1151,4321,994,6466,665,562,1227
2019-05-09,10,3748,5116,2392,11076,11208,2172,59,24611,1322,5315,1374,8011,687,442,1129
2019-05-09,11,3794,5111,2397,10785,11217,2143,62,24302,1368,5826,1576,8770,706,392,1098
2019-05-09,12,3821,5076,2404,10635,11171,2112,64,24076,1379,6024,1676,9079,721,420,1141
2019-05-09,13,3854,5074,2427,10492,11122,2070,66,23846,1374,6018,1701,9093,752,503,1255
2019-05-09,14,3909,5064,2438,10625,11150,2071,68,24011,1347,5913,1686,8946,815,616,1431
2019-05-09,15,3954,5053,2447,10869,11244,2081,69,24360,1282,5593,1628,8503,882,778,1660
2019-05-09,16,4012,5069,2434,11220,11294,2109,71,24795,1214,5149,1532,7895,932,1010,1942
2019-05-09,17,4034,5068,2467,11582,11468,2151,71,25376,1089,4443,1343,6875,958,1254,2212
2019-05-09,18,4027,5047,2441,12053,11600,2198,70,26019,800,3118,960,4878,954,1421,2375
2019-05-09,19,3987,5029,2431,12593,11766,2272,67,26794,413,1358,450,2221,933,1485,2418
2019-05-09,20,4019,5111,2413,12866,12062,2420,65,27508,99,203,86,388,892,1477,2369
2019-05-09,21,4128,5130,2402,13124,12522,2478,64,28283,0,0,0,0,945,1450,2395
2019-05-09,22,3984,4884,2323,12688,12003,2340,60,27187,0,0,0,0,1046,1436,2482
2019-05-09,23,3705,4585,2136,11691,11141,2152,54,25133,0,0,0,0,1061,1426,2487
2019-05-09,24,3468,4377,1947,10814,10328,1967,49,23253,0,0,0,0,1046,1405,2451
2019-05-10,1,3353,4260,1821,10136,9821,1861,46,21961,0,0,0,0,1044,1349,2393
2019-05-10,2,3230,4205,1747,9744,9409,1784,45,21079,0,0,0,0,994,1231,2225
2019-05-10,3,3143,4204,1703,9538,9149,1732,44,20560,0,0,0,0,928,1116,2044
2019-05-10,4,3110,4268,1699,9412,9064,1720,44,20336,0,0,0,0,854,1026,1880
2019-05-10,5,3138,4445,1758,9608,9244,1754,46,20745,0,0,0,0,793,963,1756
2019-05-10,6,3201,4706,1936,10167,9816,1871,48,21997,0,2,0,2,720,915,1635
2019-05-10,7,3297,4965,2180,10906,10539,2055,51,23650,92,433,29,554,624,852,1476
2019-05-10,8,3420,5069,2349,11352,11043,2176,54,24724,373,1722,202,2297,525,760,1285
2019-05-10,9,3500,5083,2370,11295,11203,2196,57,24848,622,3192,488,4302,404,678,1082
2019-05-10,10,3566,5080,2393,10935,11284,2187,59,24560,759,4176,743,5678,293,626,919
2019-05-10,11,3605,5056,2393,10659,11404,2170,60,24390,839,4655,875,6369,232,605,837
2019-05-10,12,3627,5003,2388,10492,11505,2145,59,24297,896,4811,920,6627,207,608,815
2019-05-10,13,3687,4990,2395,10269,11511,2134,59,24069,947,4852,992,6791,203,607,810
2019-05-10,14,3772,4972,2403,10251,11589,2129,58,24124,968,4667,980,6615,224,601,825
2019-05-10,15,3845,4945,2420,10409,11558,2131,58,24252,1005,4296,877,6178,275,621,896
2019-05-10,16,3913,4934,2436,10625,11459,2126,58,24364,1015,3917,794,5726,396,680,1076
2019-05-10,17,3980,4916,2445,11032,11401,2136,59,24725,957,3306,667,4930,581,762,1343
2019-05-10,18,4024,4878,2486,11447,11314,2176,60,25093,796,2255,496,3547,747,819,1566
2019-05-10,19,3943,4862,2436,12021,11480,2250,60,25907,460,928,256,1644,852,828,1680
2019-05-10,20,3946,4915,2373,12230,11904,2401,60,26691,112,116,48,276,924,812,1736
2019-05-10,21,4017,4975,2348,12547,12231,2419,60,27354,0,0,0,0,971,775,1746
2019-05-10,22,3877,4796,2284,12234,11852,2301,57,26542,0,0,0,0,985,705,1690
2019-05-10,23,3683,4534,2105,11446,11112,2148,54,24856,0,0,0,0,976,626,1602
2019-05-10,24,3478,4320,1924,10625,10338,1980,50,23089,0,0,0,0,939,554,1493
2019-05-11,1,3301,4170,1839,10297,9796,1864,46,22104,0,0,0,0,1023,503,1526
2019-05-11,2,3164,4109,1763,9863,9382,1777,44,21166,0,0,0,0,979,462,1441
2019-05-11,3,3081,4101,1704,9625,9079,1719,43,20565,0,0,0,0,927,407,1334
2019-05-11,4,3030,4124,1677,9450,8929,1695,43,20214,0,0,0,0,864,343,1207
2019-05-11,5,3022,4193,1689,9434,8979,1710,44,20264,0,0,0,0,783,294,1077
2019-05-11,6,3011,4253,1752,9731,9247,1759,45,20879,0,1,0,1,692,272,964
2019-05-11,7,2996,4369,1825,9882,9262,1799,47,21087,196,678,134,1008,589,235,824
2019-05-11,8,3090,4525,1946,9971,9440,1891,49,21449,759,2604,623,3986,471,170,641
2019-05-11,9,3249,4604,2087,9962,9615,1934,51,21656,1213,4567,1204,6984,338,119,457
2019-05-11,10,3396,4632,2154,9750,9743,1920,52,21556,1375,5702,1543,8620,247,125,372
2019-05-11,11,3515,4636,2167,9503,9759,1853,52,21252,1422,6171,1687,9280,191,203,394
2019-05-11,12,3632,4610,2193,9350,9719,1775,53,20980,1438,6245,1754,9437,178,281,459
2019-05-11,13,3737,4583,2225,9219,9692,1719,54,20766,1440,6202,1763,9405,231,278,509
2019-05-11,14,3846,4580,2261,9282,9743,1686,55,20857,1437,6012,1752,9201,312,222,534
2019-05-11,15,3966,4621,2315,9541,9829,1699,57,21220,1433,5628,1697,8758,424,197,621
2019-05-11,16,4098,4702,2372,9936,9949,1747,59,21788,1414,5163,1607,8184,543,306,849
2019-05-11,17,4225,4783,2456,10419,10181,1858,61,22616,1369,4465,1452,7286,649,516,1165
2019-05-11,18,4273,4787,2461,11021,10281,1984,61,23444,1191,3198,1097,5486,740,717,1457
2019-05-11,19,4212,4784,2459,11526,10536,2120,60,24339,707,1423,546,2676,823,820,1643
2019-05-11,20,4153,4829,2410,11832,10836,2279,59,25104,169,222,110,501,907,875,1782
2019-05-11,21,4189,4863,2359,12163,11324,2328,59,25970,0,1,0,1,976,977,1953
2019-05-11,22,4031,4677,2273,11885,11043,2246,56,25327,0,0,0,0,1006,1086,2092
2019-05-11,23,3752,4432,2079,11158,10492,2098,51,23899,0,0,0,0,1007,1161,2168
2019-05-11,24,3528,4216,1892,10434,9893,1946,47,22421,0,0,0,0,984,1184,2168
2019-05-12,1,3443,4143,1756,9942,9458,1872,43,21415,0,0,0,0,1035,1302,2337
2019-05-12,2,3267,4077,1679,9526,9035,1780,42,20482,0,0,0,0,1006,1300,2306
2019-05-12,3,3141,4050,1620,9222,8737,1718,41,19819,0,0,0,0,963,1323,2286
2019-05-12,4,3059,4058,1595,9058,8554,1687,41,19439,0,0,0,0,884,1341,2225
2019-05-12,5,3033,4098,1594,9030,8505,1689,42,19365,0,0,0,0,765,1314,2079
2019-05-12,6,3006,4107,1626,9141,8591,1718,44,19593,0,3,0,3,615,1257,1872
2019-05-12,7,2993,4199,1683,9204,8531,1716,45,19596,201,881,162,1244,463,1136,1599
2019-05-12,8,3120,4359,1813,9248,8420,1744,48,19556,771,3201,690,4662,341,894,1235
2019-05-12,9,3318,4437,1939,9178,8558,1759,49,19639,1219,5332,1259,7810,270,600,870
2019-05-12,10,3509,4512,1995,8927,8711,1696,51,19480,1373,6435,1571,9379,256,346,602
2019-05-12,11,3722,4537,2009,8715,8701,1580,53,19145,1419,6946,1713,10078,277,200,477
2019-05-12,12,3916,4585,2062,8607,8711,1488,56,18958,1436,7154,1784,10374,312,165,477
2019-05-12,13,4083,4604,2108,8609,8793,1469,60,19028,1438,7134,1793,10365,353,200,553
2019-05-12,14,4247,4684,2150,8795,9014,1486,63,19453,1436,7052,1788,10276,413,300,713
2019-05-12,15,4417,4780,2196,9106,9333,1515,65,20114,1435,6872,1767,10074,516,519,1035
2019-05-12,16,4567,4921,2247,9620,9644,1621,68,21050,1417,6501,1693,9611,653,882,1535
2019-05-12,17,4729,5034,2329,10244,10076,1759,71,22253,1373,5825,1543,8741,789,1295,2084
2019-05-12,18,4794,5035,2367,10980,10504,1999,70,23654,1209,4337,1204,6750,896,1637,2533
2019-05-12,19,4723,5005,2374,11540,10743,2207,69,24660,728,2002,617,3347,971,1846,2817
2019-05-12,20,4666,5045,2333,11803,11066,2329,67,25365,178,327,128,633,1023,1964,2987
2019-05-12,21,4660,5029,2293,12236,11503,2411,64,26314,0,1,0,1,1060,2071,3131
2019-05-12,22,4452,4745,2226,11998,11197,2286,59,25640,0,0,0,0,1077,2188,3265
2019-05-12,23,4120,4436,2032,11116,10485,2111,53,23865,0,0,0,0,1084,2293,3377
2019-05-12,24,3822,4230,1831,10287,9788,1924,48,22148,0,0,0,0,1087,2368,3455
2019-05-13,1,3597,4249,1691,9727,9515,1859,45,21247,0,0,0,0,1092,2388,3480
2019-05-13,2,3422,4202,1624,9351,9209,1790,43,20493,0,0,0,0,1069,2337,3406
2019-05-13,3,3291,4183,1585,9151,9009,1739,42,20042,0,0,0,0,1040,2267,3307
2019-05-13,4,3228,4238,1580,9112,8967,1726,42,19948,0,0,0,0,1010,2185,3195
2019-05-13,5,3233,4417,1642,9345,9230,1774,44,20493,0,0,0,0,970,2086,3056
2019-05-13,6,3276,4686,1820,9924,9867,1915,47,21851,0,3,0,3,929,1991,2920
2019-05-13,7,3438,4981,2086,10778,10495,2070,50,23491,195,955,145,1295,891,1899,2790
2019-05-13,8,3622,5158,2274,11443,11082,2177,53,24855,749,3415,642,4806,847,1728,2575
2019-05-13,9,3815,5277,2336,11413,11328,2194,57,25090,1196,5563,1197,7956,804,1467,2271
2019-05-13,10,4013,5366,2367,11145,11437,2152,59,24892,1355,6593,1528,9476,776,1191,1967
2019-05-13,11,4246,5427,2392,10922,11678,1963,62,24725,1402,7058,1683,10143,763,1015,1778
2019-05-13,12,4443,5481,2403,10747,11849,1876,66,24637,1421,7238,1757,10416,767,1017,1784
2019-05-13,13,4633,5572,2433,10652,12061,1853,70,24735,1417,7221,1771,10409,774,1232,2006
2019-05-13,14,4848,5665,2456,10862,12371,1873,73,25278,1406,7138,1767,10311,778,1610,2388
2019-05-13,15,5065,5754,2469,11152,12534,1943,75,25804,1390,6935,1751,10076,787,2006,2793
2019-05-13,16,5248,5821,2470,11596,12722,2049,77,26544,1358,6504,1675,9537,805,2313,3118
2019-05-13,17,5375,5865,2483,12047,12956,2172,78,27355,1300,5787,1513,8600,823,2519,3342
2019-05-13,18,5358,5765,2531,12557,12943,2293,77,27969,1130,4345,1180,6655,836,2601,3437
2019-05-13,19,5256,5659,2492,12897,12870,2456,74,28393,689,2059,616,3364,857,2537,3394
2019-05-13,20,5143,5604,2461,13071,12940,2553,70,28734,174,351,131,656,910,2385,3295
2019-05-13,21,5095,5537,2443,13307,13282,2614,67,29370,0,1,0,1,968,2254,3222
2019-05-13,22,4811,5172,2358,12835,12654,2454,61,28105,0,0,0,0,989,2220,3209
2019-05-13,23,4432,4780,2145,11767,11629,2201,55,25750,0,0,0,0,992,2260,3252
2019-05-13,24,4094,4515,1940,10850,10701,2004,50,23704,0,0,0,0,982,2290,3272
2019-05-14,1,3832,4438,1771,10157,9866,1883,48,22051,0,0,0,0,1029,2308,3337
2019-05-14,2,3652,4357,1691,9702,9411,1794,46,21050,0,0,0,0,1017,2299,3316
2019-05-14,3,3530,4320,1644,9412,9158,1735,45,20448,0,0,0,0,990,2226,3216
2019-05-14,4,3448,4352,1630,9323,9050,1719,44,20232,0,0,0,0,958,2080,3038
2019-05-14,5,3454,4519,1681,9525,9234,1750,45,20650,0,0,0,0,919,1877,2796
2019-05-14,6,3518,4772,1849,10092,9794,1872,48,21902,0,4,0,4,870,1672,2542
2019-05-14,7,3617,5057,2130,10989,10469,2035,51,23633,196,999,152,1347,694,1473,2167
2019-05-14,8,3818,5237,2295,11733,11033,2118,54,25038,731,3501,664,4896,607,1230,1837
2019-05-14,9,4009,5363,2329,11593,11289,2086,57,25123,1139,5629,1209,7977,559,987,1546
2019-05-14,10,4189,5460,2348,11319,11427,2010,62,24915,1282,6657,1526,9465,516,790,1306
2019-05-14,11,4388,5534,2354,11053,11637,1919,66,24770,1333,7127,1679,10139,486,689,1175
2019-05-14,12,4577,5596,2367,10800,11844,1851,69,24660,1343,7286,1748,10377,472,710,1182
2019-05-14,13,4764,5699,2370,10620,12041,1843,73,24675,1320,7275,1758,10353,460,828,1288
2019-05-14,14,4947,5801,2359,10766,12422,1873,76,25234,1262,7233,1740,10235,454,999,1453
2019-05-14,15,5099,5902,2338,10912,12704,1931,78,25721,1182,7064,1672,9918,455,1169,1624
2019-05-14,16,5233,5968,2322,11145,13088,2011,80,26421,1117,6607,1547,9271,444,1330,1774
2019-05-14,17,5316,5982,2312,11560,13438,2134,81,27311,1003,5864,1365,8232,427,1483,1910
2019-05-14,18,5259,5884,2322,12014,13469,2272,79,27931,741,4398,1027,6166,404,1596,2000
2019-05-14,19,5158,5778,2342,12574,13291,2363,77,28400,388,2090,519,2997,369,1649,2018
2019-05-14,20,5050,5715,2341,12910,13275,2525,73,28878,96,371,110,577,415,1642,2057
2019-05-14,21,5038,5657,2354,13177,13552,2586,70,29481,0,1,0,1,402,1594,1996
2019-05-14,22,4779,5299,2314,12761,12967,2439,64,28327,0,1,0,1,408,1570,1978
2019-05-14,23,4432,4920,2140,11776,11938,2227,57,26094,0,0,0,0,462,1558,2020
2019-05-14,24,4104,4629,1948,10883,10949,2026,52,24005,0,0,0,0,518,1509,2027
2019-05-15,1,3849,4513,1776,10161,9994,1886,48,22181,0,0,0,0,465,1322,1787
2019-05-15,2,3674,4416,1708,9747,9528,1808,45,21221,0,0,0,0,450,1186,1636
2019-05-15,3,3546,4370,1674,9465,9221,1762,44,20584,0,0,0,0,429,1052,1481
2019-05-15,4,3479,4402,1678,9399,9087,1739,44,20360,0,0,0,0,441,947,1388
2019-05-15,5,3473,4566,1744,9593,9253,1764,45,20746,0,0,0,0,474,890,1364
2019-05-15,6,3537,4803,1938,10124,9810,1895,47,21967,0,2,0,2,503,850,1353
2019-05-15,7,3633,5090,2224,10894,10437,2067,51,23540,36,708,46,790,519,778,1297
2019-05-15,8,3827,5285,2403,11521,10971,2167,54,24802,162,2519,245,2926,504,672,1176
2019-05-15,9,3990,5433,2392,11452,11232,2179,57,25009,316,4315,535,5166,415,647,1062
2019-05-15,10,4164,5548,2373,11271,11411,2172,60,25004,452,5466,797,6715,297,759,1056
2019-05-15,11,4341,5637,2360,11125,11482,2100,63,24860,585,6113,1001,7699,225,980,1205
2019-05-15,12,4493,5707,2351,10933,11380,2008,66,24477,722,6406,1153,8281,209,1297,1506
2019-05-15,13,4632,5822,2349,10734,11281,1919,69,24093,811,6418,1251,8480,232,1588,1820
2019-05-15,14,4773,5931,2339,10756,11332,1894,70,24143,814,6400,1274,8488,278,1765,2043
2019-05-15,15,4906,6000,2320,10852,11385,1917,71,24316,841,6337,1278,8456,315,1883,2198
2019-05-15,16,5013,6082,2306,11075,11547,1993,72,24781,861,6051,1227,8139,327,1969,2296
2019-05-15,17,5089,6105,2306,11438,11780,2100,73,25485,745,5450,1025,7220,349,2007,2356
2019-05-15,18,5012,5966,2325,11802,12006,2251,71,26224,506,4010,707,5223,422,1974,2396
2019-05-15,19,4891,5835,2342,12145,12212,2365,68,26881,247,1825,333,2405,470,1870,2340
2019-05-15,20,4816,5795,2332,12371,12402,2520,65,27448,58,300,64,422,445,1737,2182
2019-05-15,21,4837,5767,2344,12638,12781,2551,64,28123,0,1,0,1,421,1605,2026
2019-05-15,22,4622,5405,2305,12335,12284,2410,59,27178,0,0,0,0,452,1492,1944
2019-05-15,23,4308,5017,2112,11454,11376,2200,53,25175,0,0,0,0,507,1443,1950
2019-05-15,24,3984,4703,1925,10685,10492,2000,49,23317,0,0,0,0,510,1422,1932
2019-05-16,1,3690,4435,1788,10125,9769,1899,45,21930,0,0,0,0,521,1427,1948
2019-05-16,2,3518,4329,1719,9708,9370,1816,44,21030,0,0,0,0,747,1442,2189
2019-05-16,3,3406,4287,1686,9500,9101,1762,43,20497,0,0,0,0,897,1427,2324
2019-05-16,4,3352,4322,1684,9411,8972,1742,43,20258,0,0,0,0,889,1393,2282
2019-05-16,5,3368,4488,1751,9609,9174,1780,45,20697,0,0,0,0,794,1396,2190
2019-05-16,6,3456,4733,1934,10119,9696,1912,47,21866,0,4,0,4,673,1477,2150
2019-05-16,7,3533,5015,2209,11012,10369,2081,50,23601,155,534,61,750,567,1615,2182
2019-05-16,8,3656,5205,2380,11576,10830,2189,54,24737,652,2010,394,3056,510,1723,2233
2019-05-16,9,3732,5333,2370,11532,11043,2194,56,24915,1105,3571,886,5562,547,1966,2513
2019-05-16,10,3815,5435,2368,11345,11189,2168,58,24851,1267,4564,1227,7058,632,2407,3039
2019-05-16,11,3856,5506,2362,11158,11262,2175,58,24744,1237,5163,1396,7796,701,2778,3479
2019-05-16,12,3850,5547,2354,10830,11252,2181,58,24413,1134,5548,1456,8138,809,2979,3788
2019-05-16,13,3823,5624,2355,10544,11200,2184,58,24079,1079,5684,1469,8232,937,3095,4032
2019-05-16,14,3823,5678,2346,10496,11287,2151,57,24083,1024,5735,1453,8212,1006,3179,4185
2019-05-16,15,3822,5720,2320,10501,11225,2152,56,24029,935,5746,1410,8091,1048,3221,4269
2019-05-16,16,3831,5735,2300,10486,11253,2159,57,24047,879,5544,1361,7784,1068,3240,4308
2019-05-16,17,3853,5707,2299,10804,11272,2203,57,24429,781,5159,1214,7154,1069,3246,4315
2019-05-16,18,3821,5529,2310,11204,11373,2261,58,24987,597,4094,893,5584,1059,3234,4293
2019-05-16,19,3763,5389,2326,11768,11454,2325,57,25695,338,1990,442,2770,1030,3194,4224
2019-05-16,20,3790,5340,2318,12184,11887,2424,57,26641,86,328,91,505,1008,3133,4141
2019-05-16,21,3902,5321,2332,12603,12278,2468,58,27496,0,1,0,1,1003,3079,4082
2019-05-16,22,3795,5077,2319,12306,11887,2336,55,26673,0,0,0,0,974,3038,4012
2019-05-16,23,3626,4789,2143,11459,11092,2137,51,24828,0,0,0,0,937,3010,3947
2019-05-16,24,3422,4556,1955,10608,10282,1961,47,22989,0,0,0,0,926,2980,3906
2019-05-17,1,3285,4342,1789,9817,9716,1853,45,21521,0,0,0,0,1055,2564,3619
2019-05-17,2,3167,4252,1717,9445,9353,1770,44,20703,0,0,0,0,982,2657,3639
2019-05-17,3,3094,4224,1685,9201,9115,1726,44,20177,0,0,0,0,926,2744,3670
2019-05-17,4,3074,4265,1684,9105,9037,1710,45,19988,0,0,0,0,910,2783,3693
2019-05-17,5,3122,4432,1747,9245,9198,1753,47,20333,0,0,0,0,899,2781,3680
2019-05-17,6,3202,4658,1915,9809,9715,1870,52,21537,0,7,0,7,857,2747,3604
2019-05-17,7,3316,4938,2180,10582,10318,2038,55,23088,172,940,121,1233,783,2707,3490
2019-05-17,8,3442,5101,2358,10971,10573,2134,56,23823,662,3291,536,4489,698,2693,3391
2019-05-17,9,3512,5183,2372,11035,10504,2109,55,23793,1055,5343,1006,7404,628,2749,3377
2019-05-17,10,3538,5240,2362,10795,10403,2041,55,23385,1198,6402,1313,8913,586,2854,3440
2019-05-17,11,3560,5262,2349,10568,10357,1938,54,23008,1223,6956,1446,9625,541,2964,3505
2019-05-17,12,3579,5224,2323,10282,10263,1834,54,22525,1199,7213,1442,9854,490,3051,3541
2019-05-17,13,3635,5203,2302,10010,10189,1765,54,22109,1193,7277,1441,9911,436,3138,3574
2019-05-17,14,3713,5181,2287,10007,10210,1749,55,22113,1205,7280,1476,9961,407,3212,3619
2019-05-17,15,3801,5158,2251,10001,10207,1782,56,22137,1223,7169,1515,9907,448,3262,3710
2019-05-17,16,3890,5146,2230,9989,10297,1827,57,22261,1223,6841,1480,9544,531,3286,3817
2019-05-17,17,4000,5134,2228,10286,10437,1921,58,22793,1211,6212,1344,8767,633,3298,3931
2019-05-17,18,4016,5103,2231,10606,10621,2026,59,23401,1096,4824,1082,7002,714,3295,4009
2019-05-17,19,3972,5068,2224,11050,10796,2129,58,24122,683,2390,587,3660,732,3270,4002
2019-05-17,20,3970,5108,2197,11487,11140,2252,57,25026,178,443,130,751,717,3240,3957
2019-05-17,21,4051,5192,2209,11927,11708,2363,56,26145,0,1,0,1,702,3201,3903
2019-05-17,22,3934,5034,2231,11834,11536,2286,53,25797,0,1,0,1,699,3140,3839
2019-05-17,23,3722,4776,2109,11212,10963,2127,50,24441,0,0,0,0,712,3064,3776
2019-05-17,24,3521,4531,1947,10459,10229,1962,46,22786,0,0,0,0,735,2998,3733
2019-05-18,1,3356,4276,1762,9934,9629,1870,45,21576,0,0,0,0,693,2746,3439
2019-05-18,2,3221,4202,1698,9573,9254,1780,44,20750,0,0,0,0,660,2376,3036
2019-05-18,3,3139,4178,1669,9316,8987,1720,44,20166,0,0,0,0,625,1974,2599
2019-05-18,4,3094,4194,1668,9184,8876,1694,45,19896,0,0,0,0,574,1664,2238
2019-05-18,5,3095,4255,1706,9237,8883,1701,47,19966,0,0,0,0,475,1367,1842
2019-05-18,6,3086,4300,1772,9425,9107,1747,51,20428,0,8,0,8,351,1025,1376
2019-05-18,7,3076,4422,1853,9596,9083,1784,52,20614,172,1051,149,1372,233,645,878
2019-05-18,8,3166,4606,1989,9866,9090,1843,52,20950,592,3591,591,4774,160,355,515
2019-05-18,9,3288,4704,2088,10142,9108,1858,53,21258,872,5654,1021,7547,141,208,349
2019-05-18,10,3398,4750,2124,9991,9123,1823,52,21087,975,6598,1287,8860,157,147,304
2019-05-18,11,3507,4757,2112,9866,9057,1726,52,20800,975,7026,1393,9394,188,153,341
2019-05-18,12,3582,4723,2081,9738,9024,1615,52,20530,890,7095,1363,9348,210,239,449
2019-05-18,13,3660,4684,2044,9465,9024,1522,54,20167,856,7014,1346,9216,195,494,689
2019-05-18,14,3737,4667,2006,9275,9091,1472,56,19995,761,6729,1225,8715,170,944,1114
2019-05-18,15,3861,4659,1978,9292,9224,1481,58,20155,556,6035,927,7518,184,1430,1614
2019-05-18,16,4008,4694,1973,9400,9486,1539,59,20589,457,5305,721,6483,219,1816,2035
2019-05-18,17,4132,4762,1993,9682,9761,1662,62,21269,356,4530,517,5403,255,2120,2375
2019-05-18,18,4151,4788,2007,10003,10083,1834,61,22083,191,3157,254,3602,306,2349,2655
2019-05-18,19,4098,4797,2018,10435,10283,2016,60,22893,72,1358,83,1513,355,2448,2803
2019-05-18,20,4054,4858,2012,10614,10603,2183,58,23557,12,210,9,231,374,2403,2777
2019-05-18,21,4129,4947,2032,11091,11070,2310,59,24630,0,1,0,1,371,2250,2621
2019-05-18,22,4032,4809,2054,11153,10805,2239,55,24350,0,0,0,0,347,2016,2363
2019-05-18,23,3789,4574,1942,10700,10381,2095,51,23326,0,0,0,0,308,1782,2090
2019-05-18,24,3582,4358,1805,10105,9843,1947,47,22040,0,0,0,0,288,1630,1918
2019-05-19,1,3330,4138,1667,9490,9296,1850,45,20792,0,0,0,0,201,1549,1750
2019-05-19,2,3178,4069,1608,9103,8908,1764,44,19932,0,0,0,0,266,1543,1809
2019-05-19,3,3092,4039,1583,8839,8632,1706,43,19332,0,0,0,0,361,1482,1843
2019-05-19,4,3043,4045,1577,8697,8457,1676,43,18984,0,0,0,0,403,1418,1821
2019-05-19,5,3033,4075,1603,8719,8445,1672,44,18991,0,0,0,0,377,1402,1779
2019-05-19,6,2991,4060,1644,8890,8512,1697,45,19255,0,4,0,4,328,1438,1766
2019-05-19,7,2946,4145,1712,9186,8611,1708,46,19671,169,554,103,826,279,1509,1788
2019-05-19,8,3011,4315,1845,9539,8697,1752,49,20155,646,2174,519,3339,236,1601,1837
2019-05-19,9,3122,4381,1965,9582,8714,1792,52,20247,1010,3974,1034,6018,236,1776,2012
2019-05-19,10,3229,4420,2023,9493,8815,1818,53,20286,1130,5081,1353,7564,276,2092,2368
2019-05-19,11,3293,4411,2025,9319,8671,1720,52,19871,1106,5597,1434,8137,347,2482,2829
2019-05-19,12,3333,4438,2003,9174,8475,1638,53,19447,999,5911,1364,8274,423,2788,3211
2019-05-19,13,3372,4417,1989,8998,8415,1593,53,19170,943,6033,1332,8308,502,2970,3472
2019-05-19,14,3417,4435,1970,8779,8431,1564,53,18937,913,6008,1307,8228,564,3094,3658
2019-05-19,15,3477,4461,1947,8665,8464,1574,54,18865,893,6000,1229,8122,589,3172,3761
2019-05-19,16,3571,4547,1947,8660,8656,1643,56,19122,890,5794,1137,7821,608,3202,3810
2019-05-19,17,3704,4614,1979,8992,8842,1761,58,19761,824,5222,1010,7056,573,3184,3757
2019-05-19,18,3752,4640,2030,9553,9014,1906,59,20640,661,3979,791,5431,487,3135,3622
2019-05-19,19,3736,4675,2062,10047,9394,2054,59,21660,383,1915,419,2717,399,3052,3451
2019-05-19,20,3736,4769,2071,10556,9995,2208,58,22921,99,342,89,530,332,2955,3287
2019-05-19,21,3845,4854,2094,11131,10779,2312,57,24384,0,1,0,1,281,2868,3149
2019-05-19,22,3734,4669,2084,11170,10660,2225,55,24217,0,0,0,0,236,2802,3038
2019-05-19,23,3609,4415,1926,10560,10102,2051,51,22870,0,0,0,0,198,2751,2949
2019-05-19,24,3407,4229,1766,9865,9518,1884,48,21423,0,0,0,0,174,2667,2841
2019-05-20,1,3236,4156,1641,9098,9073,1814,45,20160,0,0,0,0,135,2415,2550
2019-05-20,2,3125,4115,1595,8793,8758,1750,44,19476,0,0,0,0,140,2226,2366
2019-05-20,3,3065,4114,1580,8611,8643,1702,44,19130,0,0,0,0,153,2233,2386
2019-05-20,4,3050,4190,1602,8594,8617,1684,45,19071,0,0,0,0,181,2389,2570
2019-05-20,5,3100,4390,1686,8847,8899,1729,48,19654,0,0,0,0,223,2583,2806
2019-05-20,6,3186,4664,1890,9504,9522,1863,54,21074,0,9,0,9,248,2799,3047
2019-05-20,7,3325,4957,2181,10292,10159,2026,57,22665,208,895,125,1228,243,2959,3202
2019-05-20,8,3445,5092,2373,11051,10625,2132,58,23985,766,3176,547,4489,227,3028,3255
2019-05-20,9,3510,5132,2365,11089,10703,2114,58,24091,1186,5280,1019,7485,220,3056,3276
2019-05-20,10,3538,5157,2344,10866,10675,2052,58,23779,1322,6380,1325,9027,235,3076,3311
2019-05-20,11,3552,5158,2327,10491,10677,1972,58,23327,1351,6886,1481,9718,278,3091,3369
2019-05-20,12,3535,5126,2310,10148,10561,1889,58,22787,1345,7046,1541,9932,346,3112,3458
2019-05-20,13,3543,5120,2304,9768,10446,1835,58,22237,1330,7026,1576,9932,460,3166,3626
2019-05-20,14,3599,5100,2293,9606,10416,1826,58,22038,1316,6961,1589,9866,622,3242,3864
2019-05-20,15,3670,5075,2261,9519,10428,1864,59,22002,1283,6758,1598,9639,783,3299,4082
2019-05-20,16,3779,5085,2243,9609,10449,1928,60,22179,1239,6379,1526,9144,915,3321,4236
2019-05-20,17,3889,5104,2246,9939,10620,2042,60,22792,1205,5851,1364,8420,1011,3304,4315
2019-05-20,18,3983,5106,2273,10512,10875,2187,62,23768,1071,4660,1092,6823,1068,3272,4340
2019-05-20,19,3972,5094,2297,11024,11072,2294,62,24581,672,2374,598,3644,1089,3218,4307
2019-05-20,20,3985,5129,2292,11542,11512,2433,60,25680,185,453,135,773,1093,3155,4248
2019-05-20,21,4078,5164,2296,11940,12165,2537,60,26832,0,1,0,1,1090,3096,4186
2019-05-20,22,3937,4918,2276,11720,11751,2411,56,26069,0,0,0,0,1070,3043,4113
2019-05-20,23,3732,4613,2107,10891,10925,2181,51,24178,0,0,0,0,1049,3004,4053
2019-05-20,24,3497,4396,1923,10157,10132,1983,47,22449,0,0,0,0,1035,2978,4013
2019-05-21,1,3319,4319,1780,9490,9464,1872,45,21001,0,0,0,0,848,2800,3648
2019-05-21,2,3193,4259,1717,9134,9145,1790,44,20242,0,0,0,0,753,2593,3346
2019-05-21,3,3128,4248,1690,8926,8915,1742,44,19756,0,0,0,0,693,2425,3118
2019-05-21,4,3101,4311,1695,8859,8837,1723,44,19594,0,0,0,0,675,2327,3002
2019-05-21,5,3139,4497,1764,9092,9060,1760,46,20088,0,0,0,0,706,2264,2970
2019-05-21,6,3214,4774,1961,9696,9637,1889,50,21404,0,9,0,9,756,2257,3013
2019-05-21,7,3347,5038,2248,10498,10176,2066,53,22927,160,974,115,1249,801,2281,3082
2019-05-21,8,3454,5160,2428,11122,10817,2180,55,24306,565,3312,465,4342,840,2354,3194
2019-05-21,9,3501,5189,2419,11322,10898,2225,56,24632,840,5315,809,6964,864,2529,3393
2019-05-21,10,3540,5209,2391,11063,10890,2217,57,24359,938,6346,1039,8323,867,2750,3617
2019-05-21,11,3587,5225,2358,10829,10843,2186,57,24052,975,6846,1167,8988,854,2956,3810
2019-05-21,12,3608,5209,2335,10598,10763,2151,57,23704,989,6998,1169,9156,871,3101,3972
2019-05-21,13,3647,5223,2327,10234,10660,2116,57,23203,1019,6961,1180,9160,947,3195,4142
2019-05-21,14,3707,5209,2313,10185,10678,2128,57,23183,1005,6845,1156,9006,1031,3246,4277
2019-05-21,15,3791,5197,2280,10235,10700,2090,57,23218,960,6509,1025,8494,1082,3259,4341
2019-05-21,16,3899,5215,2261,10267,10809,2074,59,23345,932,6009,918,7859,1098,3253,4351
2019-05-21,17,4023,5226,2267,10423,10883,2148,61,23648,889,5411,801,7101,1092,3215,4307
2019-05-21,18,4047,5223,2291,10675,10985,2208,62,24061,777,4167,614,5558,1074,3139,4213
2019-05-21,19,4010,5200,2312,11204,11074,2293,61,24763,478,2034,329,2841,1042,2981,4023
2019-05-21,20,3994,5254,2306,11651,11552,2424,60,25817,126,369,69,564,984,2828,3812
2019-05-21,21,4074,5290,2304,11984,11938,2529,59,26640,0,1,0,1,897,2857,3754
2019-05-21,22,3917,5042,2272,11719,11542,2405,56,25851,0,1,0,1,789,2957,3746
2019-05-21,23,3744,4732,2099,10846,10773,2183,51,23984,0,0,0,0,667,2988,3655
2019-05-21,24,3507,4501,1915,10101,10055,1986,48,22320,0,0,0,0,546,2983,3529
2019-05-22,1,3269,4309,1794,9366,9435,1872,47,20854,0,0,0,0,763,2910,3673
2019-05-22,2,3149,4251,1729,8986,9163,1788,47,20116,0,0,0,0,585,2945,3530
2019-05-22,3,3092,4246,1700,8775,8909,1738,47,19601,0,0,0,0,419,2931,3350
2019-05-22,4,3071,4310,1700,8753,8851,1719,48,19504,0,0,0,0,317,2915,3232
2019-05-22,5,3116,4493,1770,8970,8990,1755,51,19897,0,0,0,0,245,2912,3157
2019-05-22,6,3195,4753,1959,9513,9475,1885,56,21059,0,10,0,10,186,2941,3127
2019-05-22,7,3330,5035,2230,10257,10086,2059,60,22599,163,763,81,1007,147,2972,3119
2019-05-22,8,3436,5144,2402,10726,10536,2171,61,23626,615,2635,378,3628,133,2962,3095
2019-05-22,9,3476,5153,2386,10805,10544,2209,60,23750,988,4278,737,6003,152,2924,3076
2019-05-22,10,3495,5150,2367,10450,10531,2186,59,23359,1127,5154,992,7273,209,2891,3100
2019-05-22,11,3514,5134,2355,9900,10501,2096,58,22698,1135,5541,1112,7788,282,2883,3165
2019-05-22,12,3502,5086,2345,9640,10475,2014,58,22320,1113,5503,1154,7770,348,2881,3229
2019-05-22,13,3500,5076,2342,9415,10414,1969,58,21990,1134,5413,1231,7778,383,2880,3263
2019-05-22,14,3544,5057,2338,9293,10461,1943,58,21887,1129,5325,1244,7698,372,2909,3281
2019-05-22,15,3619,5042,2327,9173,10519,1943,59,21826,1111,5192,1163,7466,316,2991,3307
2019-05-22,16,3725,5061,2324,9273,10587,1992,60,22044,1089,4977,1095,7161,297,3093,3390
2019-05-22,17,3824,5071,2336,9643,10707,2060,61,22603,1018,4478,984,6480,392,3180,3572
2019-05-22,18,3865,5073,2354,10460,10786,2152,63,23592,869,3487,775,5131,511,3228,3739
2019-05-22,19,3833,5085,2353,10990,10925,2260,62,24367,540,1772,422,2734,584,3236,3820
2019-05-22,20,3852,5140,2328,11518,11282,2408,61,25399,147,342,92,581,659,3216,3875
2019-05-22,21,3966,5190,2306,11978,11841,2517,60,26526,0,0,0,0,733,3175,3908
2019-05-22,22,3848,4955,2275,11739,11559,2392,57,25876,0,0,0,0,774,3116,3890
2019-05-22,23,3712,4650,2093,10926,10776,2174,53,24057,0,0,0,0,776,3028,3804
2019-05-22,24,3484,4430,1906,10171,10104,1970,49,22422,0,0,0,0,720,2928,3648
2019-05-23,1,3254,4276,1767,9656,9466,1863,46,21159,0,0,0,0,582,2750,3332
2019-05-23,2,3135,4221,1699,9306,9098,1782,45,20360,0,0,0,0,461,2551,3012
2019-05-23,3,3075,4214,1666,9100,8941,1732,45,19948,0,0,0,0,390,2355,2745
2019-05-23,4,3060,4273,1662,9034,8865,1713,46,19788,0,0,0,0,356,2213,2569
2019-05-23,5,3114,4455,1725,9242,9102,1751,49,20273,0,0,0,0,336,2035,2371
2019-05-23,6,3207,4716,1908,9820,9582,1880,54,21468,0,11,0,11,321,1818,2139
2019-05-23,7,3337,4995,2181,10549,10182,2053,57,22970,176,860,129,1165,294,1584,1878
2019-05-23,8,3434,5106,2350,11084,10648,2159,57,24079,653,2927,550,4130,245,1387,1632
2019-05-23,9,3469,5120,2343,10980,10641,2140,57,23953,1039,4824,1026,6889,194,1331,1525
2019-05-23,10,3481,5122,2352,10665,10633,2070,56,23557,1190,5910,1344,8444,158,1416,1574
2019-05-23,11,3486,5109,2349,10354,10625,1985,55,23152,1251,6325,1536,9112,147,1561,1708
2019-05-23,12,3468,5065,2338,10120,10538,1886,55,22732,1292,6209,1640,9141,144,1667,1811
2019-05-23,13,3456,5060,2347,9870,10403,1824,55,22285,1308,6051,1663,9022,129,1698,1827
2019-05-23,14,3495,5057,2357,9843,10327,1816,55,22175,1231,5871,1620,8722,108,1711,1819
2019-05-23,15,3566,5046,2357,9957,10269,1856,56,22273,1094,5441,1525,8060,90,1747,1837
2019-05-23,16,3666,5072,2359,10179,10330,1926,56,22627,1007,4986,1425,7418,77,1774,1851
2019-05-23,17,3773,5081,2370,10564,10483,2030,57,23269,888,4395,1272,6555,76,1750,1826
2019-05-23,18,3847,5077,2364,11146,10611,2151,58,24096,665,3313,963,4941,91,1650,1741
2019-05-23,19,3807,5072,2363,11737,10881,2251,57,25058,370,1603,498,2471,122,1485,1607
2019-05-23,20,3796,5115,2343,12202,11318,2375,56,26082,87,279,109,475,171,1306,1477
2019-05-23,21,3900,5159,2314,12538,11884,2490,56,27098,0,1,0,1,233,1151,1384
2019-05-23,22,3795,4931,2253,12330,11639,2382,53,26533,0,0,0,0,291,1032,1323
2019-05-23,23,3646,4636,2078,11458,10883,2170,49,24688,0,0,0,0,351,945,1296
2019-05-23,24,3426,4413,1891,10573,10114,1977,46,22838,0,0,0,0,429,880,1309
2019-05-24,1,3243,4297,1743,9516,9321,1853,45,20865,0,0,0,0,434,782,1216
2019-05-24,2,3123,4236,1665,9130,8968,1768,45,20041,0,0,0,0,472,695,1167
2019-05-24,3,3062,4223,1626,8835,8752,1723,45,19485,0,0,0,0,507,556,1063
2019-05-24,4,3039,4275,1620,8765,8679,1706,46,19327,0,0,0,0,510,386,896
2019-05-24,5,3079,4438,1675,8905,8922,1744,49,19750,0,0,0,0,485,266,751
2019-05-24,6,3148,4670,1833,9422,9455,1865,54,20926,0,11,0,11,436,207,643
2019-05-24,7,3251,4933,2077,10212,10031,2023,57,22452,209,1054,133,1396,370,162,532
2019-05-24,8,3375,5066,2248,10839,10414,2085,57,23524,763,3549,606,4918,306,116,422
2019-05-24,9,3437,5100,2282,10827,10429,2077,56,23522,1186,5646,1177,8009,259,108,367
2019-05-24,10,3486,5096,2304,10543,10312,1958,55,23004,1329,6661,1524,9514,230,158,388
2019-05-24,11,3529,5066,2308,10205,10248,1778,55,22422,1360,7100,1667,10127,220,229,449
2019-05-24,12,3576,5003,2293,9948,10073,1697,54,21906,1364,7207,1726,10297,246,251,497
2019-05-24,13,3636,4984,2284,9699,9984,1665,55,21536,1364,7140,1741,10245,318,210,528
2019-05-24,14,3708,4962,2282,9751,9995,1627,56,21562,1342,6990,1701,10033,421,156,577
2019-05-24,15,3811,4933,2255,9808,10100,1670,57,21769,1311,6642,1607,9560,524,116,640
2019-05-24,16,3925,4920,2239,10063,10244,1740,57,22241,1283,6174,1505,8962,611,105,716
2019-05-24,17,4048,4910,2234,10520,10423,1863,59,23001,1255,5603,1348,8206,674,160,834
2019-05-24,18,4073,4886,2233,10970,10588,2045,60,23795,1109,4377,1037,6523,709,355,1064
2019-05-24,19,4012,4869,2197,11484,10756,2167,59,24597,690,2228,552,3470,727,701,1428
2019-05-24,20,3942,4893,2147,11738,11140,2257,58,25322,187,446,126,759,756,1055,1811
2019-05-24,21,4020,4986,2141,12027,11691,2368,58,26273,0,1,0,1,809,1270,2079
2019-05-24,22,3910,4837,2156,11858,11423,2301,55,25765,0,0,0,0,863,1315,2178
2019-05-24,23,3675,4591,2043,11197,10773,2140,50,24288,0,0,0,0,895,1298,2193
2019-05-24,24,3454,4363,1888,10412,10037,1971,47,22596,0,0,0,0,896,1350,2246
2019-05-25,1,3369,4198,1733,9509,9733,1887,44,21302,0,0,0,0,858,1689,2547
2019-05-25,2,3244,4128,1666,9137,9279,1794,42,20382,0,0,0,0,876,1786,2662
2019-05-25,3,3167,4098,1637,8839,8968,1737,42,19716,0,0,0,0,864,1770,2634
2019-05-25,4,3120,4113,1632,8714,8804,1701,42,19393,0,0,0,0,808,1629,2437
2019-05-25,5,3109,4172,1661,8812,8833,1708,43,19526,0,0,0,0,731,1400,2131
2019-05-25,6,3057,4202,1724,9157,8976,1745,44,20051,0,13,0,13,646,1162,1808
2019-05-25,7,3056,4319,1826,9383,8956,1771,46,20285,214,1111,165,1490,549,903,1452
2019-05-25,8,3160,4505,1965,9578,9150,1809,49,20712,776,3683,671,5130,441,640,1081
2019-05-25,9,3349,4612,2079,9695,9323,1839,50,21035,1210,5788,1208,8206,328,470,798
2019-05-25,10,3533,4657,2117,9467,9425,1804,51,20873,1362,6768,1531,9661,227,386,613
2019-05-25,11,3654,4668,2102,9177,9393,1708,51,20455,1397,7196,1663,10256,158,383,541
2019-05-25,12,3719,4644,2068,8883,9305,1587,53,19954,1373,7290,1690,10353,115,486,601
2019-05-25,13,3773,4622,2028,8670,9220,1499,55,19570,1357,7214,1701,10272,95,692,787
2019-05-25,14,3847,4625,1988,8651,9176,1477,58,19489,1317,7068,1686,10071,101,953,1054
2019-05-25,15,3955,4646,1954,8740,9175,1501,59,19604,1246,6767,1615,9628,121,1230,1351
2019-05-25,16,4076,4701,1952,9008,9305,1593,62,20097,1212,6336,1519,9067,160,1500,1660
2019-05-25,17,4185,4786,1972,9325,9615,1723,62,20854,1203,5710,1404,8317,239,1705,1944
2019-05-25,18,4223,4829,1985,10007,9909,1868,62,21975,1117,4447,1147,6711,361,1786,2147
2019-05-25,19,4140,4790,1997,10613,10265,2014,61,23081,730,2280,643,3653,508,1728,2236
2019-05-25,20,4090,4816,1991,11027,10583,2167,57,23963,206,460,153,819,693,1610,2303
2019-05-25,21,4157,4870,1998,11349,11173,2291,57,24999,0,1,0,1,871,1498,2369
2019-05-25,22,4072,4734,2031,11265,10998,2228,54,24675,0,1,0,1,969,1418,2387
2019-05-25,23,3874,4491,1930,10789,10491,2080,50,23539,0,0,0,0,1008,1383,2391
2019-05-25,24,3599,4266,1792,10084,9858,1937,47,22054,0,0,0,0,1032,1383,2415
2019-05-26,1,3364,4089,1639,9346,9204,1871,44,20595,0,0,0,0,1079,1458,2537
2019-05-26,2,3204,4022,1578,8953,8777,1760,43,19664,0,0,0,0,1076,1464,2540
2019-05-26,3,3112,3990,1556,8709,8557,1693,42,19132,0,0,0,0,1069,1474,2543
2019-05-26,4,3037,3997,1553,8563,8440,1661,42,18837,0,0,0,0,1064,1498,2562
2019-05-26,5,3014,4027,1582,8590,8402,1661,42,18827,0,0,0,0,1064,1532,2596
2019-05-26,6,2991,4002,1611,8660,8378,1697,43,18908,0,13,0,13,1060,1576,2636
2019-05-26,7,2947,4093,1669,8703,8283,1695,44,18854,33,872,39,944,1061,1628,2689
2019-05-26,8,3033,4269,1800,8736,8340,1748,47,18999,140,2836,171,3147,1055,1688,2743
2019-05-26,9,3167,4350,1916,8769,8365,1798,50,19107,297,4471,339,5107,1025,1732,2757
2019-05-26,10,3298,4413,1973,8681,8508,1823,51,19189,466,5428,523,6417,979,1764,2743
2019-05-26,11,3369,4425,1982,8596,8582,1769,50,19124,594,5909,706,7209,915,1828,2743
2019-05-26,12,3432,4459,1971,8382,8566,1689,50,18813,722,5761,886,7369,840,1912,2752
2019-05-26,13,3461,4457,1957,8265,8479,1635,49,18555,835,5531,1064,7430,748,1981,2729
2019-05-26,14,3473,4501,1938,8065,8357,1615,49,18213,870,5239,1109,7218,653,2022,2675
2019-05-26,15,3496,4545,1912,8198,8304,1623,50,18302,919,4693,1074,6686,562,2034,2596
2019-05-26,16,3590,4649,1913,8442,8496,1691,52,18809,931,4252,1030,6213,453,2032,2485
2019-05-26,17,3638,4746,1950,8772,8897,1815,55,19667,839,3623,906,5368,373,2078,2451
2019-05-26,18,3657,4796,2011,9456,9321,1950,56,20911,692,2618,709,4019,312,2179,2491
2019-05-26,19,3653,4768,2041,10037,9779,2081,56,22080,429,1236,386,2051,263,2292,2555
2019-05-26,20,3587,4769,2039,10576,10296,2220,54,23273,116,198,83,397,253,2371,2624
2019-05-26,21,3664,4795,2048,11034,10925,2359,54,24499,0,1,0,1,268,2399,2667
2019-05-26,22,3574,4615,2035,10901,10739,2310,52,24130,0,0,0,0,297,2397,2694
2019-05-26,23,3529,4357,1873,10171,10159,2160,50,22666,0,0,0,0,337,2434,2771
2019-05-26,24,3387,4157,1711,9450,9500,1999,47,21125,0,0,0,0,386,2577,2963
2019-05-27,1,3118,3972,1587,9019,8880,1825,45,19899,0,0,0,0,457,2865,3322
2019-05-27,2,3003,3915,1521,8655,8623,1740,44,19192,0,0,0,0,450,2951,3401
2019-05-27,3,2945,3895,1499,8461,8413,1674,45,18723,0,0,0,0,433,2984,3417
2019-05-27,4,2917,3909,1494,8385,8252,1651,46,18465,0,0,0,0,411,2965,3376
2019-05-27,5,2937,3960,1527,8475,8276,1682,48,18612,0,0,0,0,371,2914,3285
2019-05-27,6,2914,3970,1561,8673,8364,1737,52,18957,0,14,0,14,325,2849,3174
2019-05-27,7,2941,4089,1627,8837,8292,1748,54,19064,164,1010,129,1303,291,2801,3092
2019-05-27,8,3000,4257,1746,8940,8329,1774,53,19229,623,3422,543,4588,266,2783,3049
2019-05-27,9,3100,4355,1869,8995,8456,1798,52,19428,1037,5502,1020,7559,238,2820,3058
2019-05-27,10,3210,4434,1982,8867,8546,1765,53,19358,1209,6548,1331,9088,195,2886,3081
2019-05-27,11,3246,4472,2047,8703,8586,1684,51,19152,1236,7064,1449,9749,160,2942,3102
2019-05-27,12,3230,4458,2055,8450,8529,1581,51,18739,1216,7235,1470,9921,149,2984,3133
2019-05-27,13,3253,4435,2044,8259,8479,1493,51,18410,1202,7224,1499,9925,150,3016,3166
2019-05-27,14,3348,4418,2035,8147,8495,1443,53,18266,1138,7183,1450,9771,162,3058,3220
2019-05-27,15,3434,4431,2039,8221,8486,1462,55,18353,1042,7027,1316,9385,191,3129,3320
2019-05-27,16,3619,4485,2059,8494,8651,1508,57,18843,998,6673,1211,8882,259,3197,3456
2019-05-27,17,3771,4569,2093,8989,9059,1645,59,19887,948,6110,1088,8146,360,3234,3594
2019-05-27,18,3900,4631,2140,9870,9514,1823,60,21399,815,4870,865,6550,478,3238,3716
2019-05-27,19,3917,4684,2156,10597,9850,1985,59,22622,514,2546,478,3538,558,3207,3765
2019-05-27,20,3850,4745,2150,11077,10378,2158,58,23802,142,528,106,776,589,3157,3746
2019-05-27,21,3962,4858,2130,11452,10954,2315,57,24906,0,2,0,2,603,3113,3716
2019-05-27,22,3844,4658,2103,11406,10687,2229,54,24507,0,1,0,1,616,3050,3666
2019-05-27,23,3593,4379,1929,10618,10098,2046,50,22943,0,0,0,0,652,2947,3599
2019-05-27,24,3380,4161,1752,9845,9441,1882,46,21346,0,0,0,0,691,2842,3533
2019-05-28,1,3159,3987,1667,9067,8863,1829,45,19934,0,0,0,0,672,2834,3506
2019-05-28,2,3032,3943,1600,8736,8602,1755,44,19266,0,0,0,0,662,2727,3389
2019-05-28,3,2968,3947,1564,8537,8418,1708,44,18835,0,0,0,0,636,2607,3243
2019-05-28,4,2945,4019,1559,8493,8366,1694,45,18725,0,0,0,0,574,2501,3075
2019-05-28,5,2984,4212,1619,8743,8571,1729,47,19218,0,0,0,0,457,2415,2872
2019-05-28,6,3031,4475,1794,9322,9096,1862,52,20458,0,17,0,17,332,2331,2663
2019-05-28,7,3159,4739,2069,10086,9718,2030,55,22016,184,1156,141,1481,229,2216,2445
2019-05-28,8,3315,4830,2244,10637,10324,2129,56,23274,663,3752,583,4998,151,2003,2154
2019-05-28,9,3407,4817,2256,10576,10440,2095,57,23301,1046,5817,1081,7944,108,1705,1813
2019-05-28,10,3507,4778,2262,10252,10429,2010,56,22886,1199,6765,1405,9369,92,1326,1418
2019-05-28,11,3604,4725,2244,10000,10375,1918,57,22488,1244,7203,1548,9995,92,929,1021
2019-05-28,12,3675,4652,2238,9680,10252,1822,58,21947,1260,7378,1595,10233,99,651,750
2019-05-28,13,3740,4631,2254,9436,10195,1764,59,21592,1314,7398,1617,10329,120,557,677
2019-05-28,14,3848,4574,2267,9461,10245,1759,61,21664,1329,7316,1632,10277,192,671,863
2019-05-28,15,3980,4536,2279,9574,10244,1790,62,21804,1344,7063,1638,10045,320,1044,1364
2019-05-28,16,4133,4540,2280,9920,10392,1858,64,22365,1345,6637,1588,9570,477,1698,2175
2019-05-28,17,4241,4560,2305,10358,10517,1971,66,23044,1324,6012,1508,8844,625,2313,2938
2019-05-28,18,4275,4585,2321,10877,10752,2109,67,23937,1202,4736,1264,7202,719,2636,3355
2019-05-28,19,4227,4623,2332,11487,11005,2217,66,24908,776,2497,717,3990,753,2766,3519
2019-05-28,20,4169,4681,2309,11845,11332,2328,64,25701,220,535,175,930,747,2796,3543
2019-05-28,21,4224,4737,2268,12033,11888,2440,63,26557,0,1,0,1,712,2768,3480
2019-05-28,22,4055,4523,2194,11849,11551,2338,58,25929,0,0,0,0,673,2693,3366
2019-05-28,23,3764,4248,1994,10954,10805,2128,53,24071,0,0,0,0,668,2567,3235
2019-05-28,24,3470,4062,1807,10185,10012,1942,48,22318,0,0,0,0,696,2378,3074
2019-05-29,1,3277,4059,1733,9603,9129,1813,45,20717,0,0,0,0,761,2129,2890
2019-05-29,2,3125,4021,1664,9240,8780,1742,43,19932,0,0,0,0,761,1638,2399
2019-05-29,3,3042,4016,1619,8983,8571,1704,43,19428,0,0,0,0,722,1183,1905
2019-05-29,4,2996,4081,1607,8902,8507,1683,43,19262,0,0,0,0,626,859,1485
2019-05-29,5,3021,4267,1661,9070,8738,1710,45,19690,0,0,0,0,504,651,1155
2019-05-29,6,3077,4521,1832,9578,9262,1853,48,20868,0,16,0,16,402,538,940
2019-05-29,7,3218,4794,2092,10241,9906,2016,52,22342,182,1080,157,1419,295,462,757
2019-05-29,8,3414,4891,2264,10721,10481,2060,55,23445,678,3493,621,4792,194,358,552
2019-05-29,9,3558,4896,2300,10639,10746,2045,56,23614,1090,5459,1122,7671,129,233,362
2019-05-29,10,3698,4877,2315,10351,10888,1966,58,23391,1280,6480,1439,9199,90,136,226
2019-05-29,11,3835,4842,2316,10099,10921,1821,61,23029,1339,7016,1607,9962,68,111,179
2019-05-29,12,3954,4787,2313,9945,10965,1752,63,22853,1374,7173,1716,10263,59,129,188
2019-05-29,13,4084,4778,2332,9824,10986,1734,66,22737,1388,7087,1751,10226,60,179,239
2019-05-29,14,4224,4747,2356,9981,11172,1735,68,23084,1387,6927,1731,10045,78,278,356
2019-05-29,15,4390,4725,2380,10208,11312,1761,70,23478,1375,6619,1681,9675,134,420,554
2019-05-29,16,4571,4731,2405,10534,11436,1788,72,23957,1351,6186,1589,9126,239,635,874
2019-05-29,17,4723,4769,2431,10979,11580,1911,73,24671,1314,5557,1437,8308,374,908,1282
2019-05-29,18,4759,4790,2455,11589,11740,2076,73,25607,1175,4301,1134,6610,482,1148,1630
2019-05-29,19,4674,4821,2437,12170,11847,2217,72,26432,764,2242,620,3626,551,1299,1850
2019-05-29,20,4563,4895,2408,12477,12052,2408,68,27132,221,475,147,843,600,1344,1944
2019-05-29,21,4595,4872,2352,12615,12456,2510,66,27773,0,1,0,1,616,1311,1927
2019-05-29,22,4397,4650,2282,12332,11987,2368,61,26875,0,1,0,1,619,1272,1891
2019-05-29,23,4069,4359,2077,11359,11131,2154,55,24824,0,0,0,0,651,1306,1957
2019-05-29,24,3751,4153,1876,10530,10263,1953,50,22923,0,0,0,0,702,1377,2079
2019-05-30,1,3533,4211,1797,9833,9813,1846,45,21667,0,0,0,0,840,1464,2304
2019-05-30,2,3368,4154,1723,9397,9386,1769,43,20725,0,0,0,0,854,1462,2316
2019-05-30,3,3257,4139,1675,9129,9100,1733,42,20135,0,0,0,0,868,1400,2268
2019-05-30,4,3194,4197,1657,9023,8993,1711,42,19899,0,0,0,0,863,1242,2105
2019-05-30,5,3205,4373,1704,9189,9157,1738,44,20258,0,0,0,0,835,1032,1867
2019-05-30,6,3264,4621,1855,9668,9698,1856,46,21401,0,17,0,17,782,827,1609
2019-05-30,7,3408,4882,2124,10393,10307,1995,50,22876,256,1172,196,1624,697,616,1313
2019-05-30,8,3620,5019,2301,10848,10764,2079,53,23871,861,3765,740,5366,613,386,999
2019-05-30,9,3794,5073,2345,10790,11039,2071,55,24081,1263,5794,1252,8309,547,218,765
2019-05-30,10,3963,5106,2371,10533,11128,1998,58,23844,1385,6725,1536,9646,495,129,624
2019-05-30,11,4133,5117,2384,10356,11219,1879,62,23642,1420,7154,1650,10224,470,101,571
2019-05-30,12,4279,5099,2388,10204,11291,1815,65,23502,1411,7210,1658,10279,487,130,617
2019-05-30,13,4427,5141,2413,10078,11432,1797,69,23501,1408,7051,1645,10104,529,218,747
2019-05-30,14,4581,5169,2441,10174,11747,1794,72,23913,1382,6927,1623,9932,580,371,951
2019-05-30,15,4746,5190,2454,10408,12004,1819,73,24433,1312,6735,1539,9586,629,578,1207
2019-05-30,16,4888,5233,2477,10898,12282,1856,75,25243,1264,6399,1434,9097,655,815,1470
2019-05-30,17,5004,5266,2516,11386,12550,1949,77,26095,1195,5863,1348,8406,641,1050,1691
2019-05-30,18,4961,5265,2508,11882,12622,2097,75,26808,1001,4673,1114,6788,598,1217,1815
2019-05-30,19,4859,5193,2492,12353,12577,2230,73,27363,615,2489,622,3726,560,1270,1830
2019-05-30,20,4735,5184,2457,12605,12611,2409,69,27822,175,535,151,861,548,1236,1784
2019-05-30,21,4770,5196,2411,12676,12924,2499,66,28295,1,1,0,2,556,1192,1748
2019-05-30,22,4583,4919,2350,12421,12453,2372,61,27438,0,0,0,0,565,1197,1762
2019-05-30,23,4285,4586,2147,11505,11512,2175,55,25380,0,0,0,0,564,1275,1839
2019-05-30,24,3965,4361,1944,10625,10586,1974,50,23368,0,0,0,0,544,1367,1911
2019-05-31,1,3747,4262,1853,9929,9873,1900,48,21879,0,0,0,0,549,1292,1841
2019-05-31,2,3563,4194,1773,9531,9425,1810,45,20938,0,0,0,0,547,1194,1741
2019-05-31,3,3441,4164,1720,9270,9122,1762,44,20324,0,0,0,0,512,1026,1538
2019-05-31,4,3365,4201,1698,9151,9011,1739,43,20071,0,0,0,0,454,824,1278
2019-05-31,5,3367,4355,1736,9322,9177,1774,45,20444,0,0,0,0,402,617,1019
2019-05-31,6,3405,4563,1862,9845,9705,1886,47,21609,0,19,0,19,361,449,810
2019-05-31,7,3512,4819,2085,10533,10331,2033,49,23073,223,1210,188,1621,321,318,639
2019-05-31,8,3736,4987,2288,10971,10944,2138,52,24236,771,3835,708,5314,275,198,473
2019-05-31,9,3934,5083,2362,10899,11111,2148,54,24338,1164,5850,1213,8227,239,109,348
2019-05-31,10,4129,5129,2398,10689,11169,2010,58,24053,1328,6773,1500,9601,229,68,297
2019-05-31,11,4303,5143,2421,10542,11195,1867,61,23793,1368,7205,1620,10193,225,70,295
2019-05-31,12,4457,5138,2444,10363,11306,1817,64,23677,1376,7363,1634,10373,209,92,301
2019-05-31,13,4624,5174,2486,10290,11412,1780,68,23676,1383,7336,1624,10343,190,129,319
2019-05-31,14,4801,5202,2535,10536,11658,1779,71,24171,1372,7226,1576,10174,190,206,396
2019-05-31,15,4985,5219,2560,10805,11927,1815,73,24747,1328,7029,1458,9815,222,358,580
2019-05-31,16,5173,5219,2598,11217,12115,1856,76,25394,1292,6675,1337,9304,283,628,911
2019-05-31,17,5258,5198,2626,11630,12365,1975,78,26177,1211,6094,1215,8520,354,958,1312
2019-05-31,18,5241,5140,2638,12123,12451,2119,76,26900,1000,4867,966,6833,418,1267,1685
2019-05-31,19,5120,5128,2576,12656,12402,2216,74,27479,617,2615,532,3764,450,1499,1949
2019-05-31,20,4949,5066,2520,12921,12374,2308,69,27802,175,572,125,872,457,1633,2090
2019-05-31,21,4909,5115,2434,12986,12598,2421,67,28200,1,1,0,2,467,1697,2164
2019-05-31,22,4692,4916,2377,12659,12192,2347,62,27389,0,1,0,1,492,1716,2208
2019-05-31,23,4392,4617,2187,11754,11372,2187,56,25501,0,0,0,0,545,1710,2255
2019-05-31,24,4082,4363,1986,10922,10657,1998,51,23759,0,0,0,0,594,1677,2271
2019-06-01,1,3737,4224,1907,10469,9811,1883,47,22338,0,0,0,0,583,1318,1901
2019-06-01,2,3566,4132,1813,9923,9329,1791,44,21214,0,0,0,0,591,1227,1818
2019-06-01,3,3419,4081,1746,9513,8990,1736,42,20409,0,0,0,0,561,1137,1698
2019-06-01,4,3334,4082,1708,9303,8806,1714,41,19993,0,0,0,0,530,1026,1556
2019-06-01,5,3296,4104,1702,9258,8838,1727,42,19992,0,0,0,0,491,891,1382
2019-06-01,6,3246,4117,1727,9374,8907,1773,43,20222,0,19,0,19,426,692,1118
2019-06-01,7,3265,4231,1801,9471,8870,1814,45,20326,258,1164,199,1621,344,596,940
2019-06-01,8,3449,4439,1952,9689,9095,1883,47,20841,859,3689,740,5288,253,405,658
2019-06-01,9,3694,4595,2081,9828,9380,1938,51,21325,1250,5686,1249,8185,177,223,400
2019-06-01,10,3923,4690,2163,9847,9446,1889,55,21364,1365,6637,1535,9537,129,121,250
2019-06-01,11,4111,4726,2229,9895,9517,1673,59,21271,1402,7068,1669,10139,109,130,239
2019-06-01,12,4274,4744,2288,9951,9471,1568,64,21181,1408,7209,1705,10322,107,166,273
2019-06-01,13,4411,4808,2341,10094,9464,1501,68,21256,1405,7211,1717,10333,120,158,278
2019-06-01,14,4566,4889,2393,10364,9642,1450,72,21657,1378,7072,1674,10124,155,147,302
2019-06-01,15,4711,5013,2447,10754,9941,1454,76,22354,1316,6756,1546,9618,220,211,431
2019-06-01,16,4855,5168,2511,11292,10355,1504,78,23359,1260,6332,1425,9017,323,447,770
2019-06-01,17,4971,5279,2575,11872,10770,1639,78,24490,1149,5679,1257,8085,445,886,1331
2019-06-01,18,4968,5391,2611,12493,11032,1840,78,25573,907,4415,949,6271,534,1349,1883
2019-06-01,19,4885,5268,2577,13000,11159,2037,76,26403,536,2323,508,3367,570,1677,2247
2019-06-01,20,4747,5119,2528,13086,11179,2244,72,26713,150,507,119,776,594,1829,2423
2019-06-01,21,4720,5092,2438,13018,11429,2327,68,26972,1,2,0,3,625,1811,2436
2019-06-01,22,4564,4898,2359,12747,11173,2253,62,26365,0,1,0,1,664,1743,2407
2019-06-01,23,4269,4594,2187,12006,10574,2127,56,24892,0,0,0,0,724,1707,2431
2019-06-01,24,3953,4325,1992,11143,9892,1960,51,23175,0,0,0,0,786,1639,2425
2019-06-02,1,3673,4210,1857,10633,9579,1871,48,22257,0,0,0,0,900,1565,2465
2019-06-02,2,3470,4117,1765,10094,9122,1780,45,21167,0,0,0,0,900,1441,2341
2019-06-02,3,3319,4068,1705,9722,8793,1723,44,20408,0,0,0,0,891,1371,2262
2019-06-02,4,3243,4056,1673,9472,8587,1697,43,19925,0,0,0,0,850,1339,2189
2019-06-02,5,3186,4046,1663,9401,8528,1706,43,19803,0,0,0,0,774,1304,2078
2019-06-02,6,3123,4009,1670,9388,8495,1743,44,19796,0,22,0,22,682,1217,1899
2019-06-02,7,3136,4101,1728,9282,8338,1769,46,19560,239,1118,188,1545,586,1029,1615
2019-06-02,8,3321,4316,1855,9293,8485,1817,49,19769,812,3600,708,5120,502,721,1223
2019-06-02,9,3582,4455,1968,9360,8598,1840,53,19979,1214,5619,1218,8051,450,388,838
2019-06-02,10,3810,4556,2070,9348,8783,1792,58,20109,1344,6580,1506,9430,439,177,616
2019-06-02,11,4031,4586,2151,9265,8737,1640,62,19833,1381,6996,1642,10019,474,101,575
2019-06-02,12,4229,4699,2216,9337,8704,1546,66,19783,1388,7096,1716,10200,545,98,643
2019-06-02,13,4394,4791,2280,9476,8837,1487,70,20001,1386,7050,1743,10179,635,184,819
2019-06-02,14,4560,4932,2345,9730,9075,1467,74,20478,1356,6902,1710,9968,723,411,1134
2019-06-02,15,4734,5092,2403,10111,9431,1498,77,21248,1290,6569,1631,9490,777,707,1484
2019-06-02,16,4882,5293,2477,10670,9814,1578,79,22270,1224,6123,1523,8870,786,1029,1815
2019-06-02,17,5044,5439,2563,11266,10283,1743,82,23503,1108,5500,1335,7943,779,1410,2189
2019-06-02,18,5072,5432,2623,12010,10688,1937,81,24843,889,4298,993,6180,783,1768,2551
2019-06-02,19,4993,5334,2599,12548,10971,2098,79,25823,544,2276,519,3339,812,1992,2804
2019-06-02,20,4847,5209,2542,12687,11152,2243,75,26282,158,500,122,780,865,2069,2934
2019-06-02,21,4787,5172,2460,12739,11583,2332,70,26850,1,1,0,2,925,2089,3014
2019-06-02,22,4587,4955,2375,12489,11248,2269,65,26199,0,1,0,1,965,2129,3094
2019-06-02,23,4260,4598,2191,11638,10543,2123,57,24488,0,0,0,0,986,2139,3125
2019-06-02,24,3916,4341,1971,10665,9825,1953,51,22621,0,0,0,0,990,2092,3082
2019-06-03,1,3642,4250,1778,9995,9513,1870,48,21555,0,0,0,0,996,2213,3209
2019-06-03,2,3453,4183,1691,9598,9183,1793,46,20748,0,0,0,0,975,2165,3140
2019-06-03,3,3318,4152,1643,9327,8944,1737,44,20182,0,0,0,0,937,2127,3064
2019-06-03,4,3240,4199,1633,9270,8872,1717,43,20030,0,0,0,0,884,2077,2961
2019-06-03,5,3247,4351,1684,9475,9114,1767,45,20528,0,0,0,0,801,1973,2774
2019-06-03,6,3263,4574,1816,9965,9634,1871,47,21645,0,24,0,24,693,1767,2460
2019-06-03,7,3419,4876,2051,10622,10201,2026,50,23022,239,1197,200,1636,569,1417,1986
2019-06-03,8,3679,5087,2258,11174,10732,2144,55,24230,788,3760,734,5282,443,972,1415
2019-06-03,9,3918,5222,2345,11191,10978,2181,59,24533,1143,5737,1236,8116,334,570,904
2019-06-03,10,4159,5340,2398,11014,11118,2167,64,24488,1252,6656,1516,9424,256,317,573
2019-06-03,11,4410,5416,2453,10933,11219,2093,68,24439,1294,7100,1657,10051,205,211,416
2019-06-03,12,4636,5479,2489,10913,11288,1945,73,24344,1308,7245,1723,10276,183,210,393
2019-06-03,13,4824,5588,2544,11044,11449,1834,78,24529,1305,7217,1738,10260,195,330,525
2019-06-03,14,5032,5684,2595,11422,11787,1796,82,25212,1300,7100,1732,10132,234,556,790
2019-06-03,15,5255,5779,2620,11880,12182,1848,85,26121,1297,6856,1696,9849,317,869,1186
2019-06-03,16,5485,5874,2636,12593,12585,1961,87,27352,1275,6511,1612,9398,432,1267,1699
2019-06-03,17,5630,5922,2691,13304,12938,2101,88,28558,1228,5955,1460,8643,546,1667,2213
2019-06-03,18,5668,5930,2651,13944,13172,2258,88,29589,1097,4733,1164,6994,643,1965,2608
2019-06-03,19,5538,5758,2623,14363,13145,2346,85,30068,722,2543,658,3923,711,2136,2847
2019-06-03,20,5340,5603,2563,14441,13034,2404,80,30087,215,565,163,943,749,2217,2966
2019-06-03,21,5220,5538,2487,14314,13225,2467,75,30206,2,2,0,4,767,2263,3030
2019-06-03,22,4990,5227,2412,13879,12723,2388,68,29184,0,1,0,1,775,2316,3091
2019-06-03,23,4589,4828,2226,12719,11663,2193,61,26764,0,0,0,0,782,2392,3174
2019-06-03,24,4204,4541,2017,11660,10794,2018,55,24656,0,0,0,0,780,2450,3230
2019-06-04,1,3955,4442,1876,11052,10134,1896,52,23257,0,0,0,0,665,2444,3109
2019-06-04,2,3725,4351,1784,10495,9685,1814,49,22168,0,0,0,0,604,2386,2990
2019-06-04,3,3555,4302,1725,10138,9392,1767,47,21467,0,0,0,0,557,2321,2878
2019-06-04,4,3474,4330,1700,9978,9279,1748,47,21175,0,0,0,0,509,2228,2737
2019-06-04,5,3459,4472,1737,10099,9442,1785,48,21497,0,0,0,0,436,2063,2499
2019-06-04,6,3434,4684,1872,10526,9831,1890,50,22418,0,26,0,26,345,1800,2145
2019-06-04,7,3589,4974,2131,11212,10413,2033,53,23830,246,1226,214,1686,245,1402,1647
2019-06-04,8,3866,5177,2299,11760,11038,2140,57,25116,803,3786,770,5359,153,918,1071
2019-06-04,9,4152,5309,2366,11868,11348,2138,62,25539,1160,5804,1273,8237,88,506,594
2019-06-04,10,4452,5428,2412,11808,11499,2089,66,25586,1266,6744,1546,9556,54,261,315
2019-06-04,11,4750,5521,2442,11877,11794,2024,72,25890,1305,7182,1687,10174,38,163,201
2019-06-04,12,5043,5599,2470,12067,12010,1956,78,26233,1315,7361,1753,10429,26,138,164
2019-06-04,13,5302,5734,2512,12284,12294,1927,83,26712,1310,7376,1767,10453,24,155,179
2019-06-04,14,5561,5857,2551,12864,12768,1914,88,27759,1304,7274,1761,10339,30,248,278
2019-06-04,15,5842,5996,2575,13512,13280,1964,92,28972,1302,7027,1740,10069,52,530,582
2019-06-04,16,6104,6114,2605,14321,13734,2031,94,30304,1286,6659,1661,9606,111,1030,1141
2019-06-04,17,6230,6187,2632,15322,14151,2149,96,31841,1247,6054,1521,8822,202,1579,1781
2019-06-04,18,6252,6220,2680,15826,14464,2282,95,32789,1124,4773,1216,7113,290,1994,2284
2019-06-04,19,6158,6021,2636,16213,14411,2384,92,33223,747,2562,691,4000,374,2226,2600
2019-06-04,20,5928,5837,2580,16067,14155,2481,87,32913,226,577,176,979,458,2321,2779
2019-06-04,21,5744,5743,2505,15757,14223,2535,80,32718,2,3,0,5,520,2349,2869
2019-06-04,22,5430,5407,2425,15158,13641,2446,73,31442,0,1,0,1,564,2350,2914
2019-06-04,23,4989,4981,2232,13841,12492,2229,65,28748,0,0,0,0,602,2364,2966
2019-06-04,24,4573,4669,2018,12619,11426,2022,59,26248,0,0,0,0,635,2396,3031
2019-06-05,1,4263,4491,1868,11590,10641,1945,56,24352,0,0,0,0,646,2456,3102
2019-06-05,2,4009,4390,1781,10932,10164,1849,53,23118,0,0,0,0,630,2385,3015
2019-06-05,3,3834,4338,1726,10525,9805,1798,51,22300,0,0,0,0,573,2283,2856
2019-06-05,4,3721,4363,1707,10289,9625,1780,50,21865,0,0,0,0,498,2132,2630
2019-06-05,5,3701,4499,1749,10371,9669,1817,51,22029,0,0,0,0,415,1918,2333
2019-06-05,6,3669,4694,1892,10801,10151,1925,54,23050,0,24,0,24,334,1669,2003
2019-06-05,7,3827,4982,2147,11488,10738,2067,56,24470,259,1220,213,1692,266,1380,1646
2019-06-05,8,4108,5197,2308,11944,11302,2175,62,25603,838,3830,766,5434,197,1033,1230
2019-06-05,9,4409,5355,2370,12079,11607,2211,67,26084,1201,5823,1268,8292,134,652,786
2019-06-05,10,4744,5484,2405,12182,11827,2236,72,26436,1302,6740,1542,9584,92,331,423
2019-06-05,11,5082,5586,2433,12397,12216,2211,78,27021,1336,7188,1681,10205,70,174,244
2019-06-05,12,5394,5677,2457,12797,12589,2112,85,27702,1349,7368,1746,10463,59,153,212
2019-06-05,13,5689,5822,2513,13254,12966,2031,91,28459,1345,7384,1762,10491,62,231,293
2019-06-05,14,5980,5955,2569,13933,13513,2063,96,29722,1330,7313,1750,10393,97,422,519
2019-06-05,15,6275,6095,2612,14675,13992,2136,100,31020,1312,7056,1702,10070,170,724,894
2019-06-05,16,6531,6212,2665,15451,14383,2243,103,32296,1277,6650,1602,9529,263,1112,1375
2019-06-05,17,6636,6265,2665,16137,14736,2353,105,33444,1206,6032,1436,8674,379,1457,1836
2019-06-05,18,6614,6311,2647,16618,14898,2475,103,34207,1057,4721,1137,6915,511,1652,2163
2019-06-05,19,6514,6107,2602,16932,14744,2520,99,34404,697,2520,648,3865,638,1704,2342
2019-06-05,20,6260,5940,2528,16662,14491,2551,92,33907,213,563,166,942,768,1675,2443
2019-06-05,21,6068,5813,2462,16151,14558,2620,85,33523,1,3,0,4,891,1672,2563
2019-06-05,22,5749,5463,2395,15434,13999,2519,77,32139,0,1,0,1,973,1793,2766
2019-06-05,23,5297,5037,2222,14005,12814,2296,68,29305,0,0,0,0,1015,1999,3014
2019-06-05,24,4870,4710,2011,12668,11735,2080,61,26665,0,0,0,0,1025,2135,3160
2019-06-06,1,4527,4638,1807,11933,10776,1991,58,24881,0,0,0,0,1049,1751,2800
2019-06-06,2,4260,4519,1716,11243,10191,1900,55,23511,0,0,0,0,1033,1732,2765
2019-06-06,3,4067,4451,1664,10800,9817,1842,53,22634,0,0,0,0,1030,1692,2722
2019-06-06,4,3943,4471,1646,10569,9558,1813,52,22115,0,0,0,0,1043,1606,2649
2019-06-06,5,3916,4603,1695,10590,9663,1845,53,22273,0,0,0,0,1062,1473,2535
2019-06-06,6,3891,4787,1844,11011,10129,1955,54,23271,0,24,0,24,1071,1279,2350
2019-06-06,7,4007,5081,2088,11670,10740,2099,57,24695,235,1152,179,1566,1059,1069,2128
2019-06-06,8,4282,5336,2258,12211,11328,2223,62,25952,791,3650,696,5137,1037,887,1924
2019-06-06,9,4579,5522,2304,12214,11576,2255,68,26233,1179,5637,1226,8042,1023,751,1774
2019-06-06,10,4889,5687,2344,12106,11762,2260,74,26321,1302,6606,1532,9440,1021,648,1669
2019-06-06,11,5211,5833,2374,12063,12043,2226,80,26533,1339,7068,1685,10092,1029,618,1647
2019-06-06,12,5519,5957,2379,12115,12238,2153,87,26715,1359,7245,1767,10371,1048,734,1782
2019-06-06,13,5788,6131,2382,12175,12527,2050,93,26965,1367,7227,1784,10378,1060,958,2018
2019-06-06,14,6030,6293,2375,12467,12873,2019,98,27577,1365,7146,1779,10290,1069,1179,2248
2019-06-06,15,6267,6459,2351,12778,13248,2059,101,28304,1354,6987,1756,10097,1091,1382,2473
2019-06-06,16,6439,6556,2342,13304,13582,2165,104,29274,1336,6638,1676,9650,1103,1618,2721
2019-06-06,17,6477,6557,2331,13849,13824,2293,103,30189,1291,6056,1524,8871,1110,1824,2934
2019-06-06,18,6402,6497,2339,14215,13779,2423,100,30639,1169,4845,1252,7266,1125,1927,3052
2019-06-06,19,6270,6319,2349,14478,13741,2486,97,30923,813,2669,752,4234,1132,1934,3066
2019-06-06,20,6020,6121,2334,14482,13598,2545,90,30836,259,625,202,1086,1134,1908,3042
2019-06-06,21,5864,5992,2309,14357,13732,2685,84,30979,1,1,0,2,1123,1956,3079
2019-06-06,22,5569,5665,2313,14031,13356,2585,77,30170,0,1,0,1,1096,2179,3275
2019-06-06,23,5167,5219,2183,13000,12288,2357,69,27832,0,0,0,0,1068,2437,3505
2019-06-06,24,4765,4851,1999,11928,11274,2136,62,25520,0,0,0,0,1041,2583,3624
2019-06-07,1,4463,4544,1810,10867,10297,1954,57,23304,0,0,0,0,1036,2560,3596
2019-06-07,2,4239,4409,1735,10336,9835,1873,53,22227,0,0,0,0,993,2566,3559
2019-06-07,3,4065,4346,1702,10000,9492,1809,51,21483,0,0,0,0,939,2508,3447
2019-06-07,4,3949,4365,1705,9863,9326,1794,50,21164,0,0,0,0,879,2396,3275
2019-06-07,5,3926,4485,1772,9991,9491,1819,50,21481,0,0,0,0,816,2224,3040
2019-06-07,6,3894,4654,1941,10424,9906,1920,51,22431,1,25,0,26,738,2036,2774
2019-06-07,7,4012,4935,2192,10935,10362,2058,53,23536,261,1237,224,1722,625,1861,2486
2019-06-07,8,4255,5187,2361,11316,10861,2185,58,24548,844,3868,803,5515,463,1708,2171
2019-06-07,9,4501,5361,2380,11360,11129,2194,63,24872,1210,5889,1319,8418,291,1620,1911
2019-06-07,10,4748,5496,2373,11084,11240,2126,69,24646,1311,6807,1586,9704,201,1605,1806
2019-06-07,11,4969,5603,2354,10870,11259,2047,75,24378,1350,7255,1725,10330,233,1681,1914
2019-06-07,12,5183,5676,2323,10688,11260,1990,81,24144,1372,7452,1792,10616,285,1862,2147
2019-06-07,13,5400,5779,2302,10567,11402,1969,87,24153,1474,7475,1800,10749,276,2118,2394
2019-06-07,14,5564,5858,2286,10760,11731,1981,91,24691,1472,7447,1798,10717,243,2382,2625
2019-06-07,15,5719,5913,2247,10966,12085,1974,95,25247,1466,7305,1783,10554,241,2638,2879
2019-06-07,16,5809,5934,2229,11515,12397,2054,97,26189,1451,6966,1715,10132,278,2870,3148
2019-06-07,17,5835,5909,2237,12021,12745,2169,97,27159,1408,6401,1564,9373,325,3033,3358
2019-06-07,18,5763,5778,2246,12576,12811,2292,95,27902,1282,5207,1284,7773,366,3103,3469
2019-06-07,19,5635,5578,2238,13055,12703,2391,91,28368,902,2925,777,4604,396,3104,3500
2019-06-07,20,5422,5345,2201,13227,12480,2439,85,28360,295,698,214,1207,418,3078,3496
2019-06-07,21,5323,5286,2168,13203,12680,2507,80,28598,1,4,0,5,418,3056,3474
2019-06-07,22,5115,5127,2198,13110,12439,2434,73,28184,0,2,0,2,394,3043,3437
2019-06-07,23,4810,4885,2107,12360,11706,2265,66,26524,0,0,0,0,409,3026,3435
2019-06-07,24,4481,4622,1951,11454,10861,2083,59,24586,0,0,0,0,498,2988,3486
2019-06-08,1,4179,4307,1813,10928,10229,1938,52,23279,0,0,0,0,520,3007,3527
2019-06-08,2,3969,4191,1741,10426,9685,1834,48,22124,0,0,0,0,652,2945,3597
2019-06-08,3,3804,4137,1709,10113,9312,1781,46,21382,0,0,0,0,770,2869,3639
2019-06-08,4,3682,4133,1707,9855,9032,1753,44,20814,0,0,0,0,875,2731,3606
2019-06-08,5,3608,4154,1740,9769,9015,1761,44,20718,0,0,0,0,943,2431,3374
2019-06-08,6,3520,4151,1791,9949,9137,1799,44,21058,1,33,0,34,968,1948,2916
2019-06-08,7,3531,4260,1863,10058,9055,1814,45,21101,314,1312,253,1879,946,1356,2302
2019-06-08,8,3698,4459,1981,10169,9217,1868,48,21429,968,4001,871,5840,905,761,1666
2019-06-08,9,3953,4612,2095,10084,9430,1873,53,21568,1346,5995,1396,8737,875,333,1208
2019-06-08,10,4219,4708,2141,10061,9696,1814,59,21758,1436,6895,1647,9978,856,201,1057
2019-06-08,11,4423,4743,2140,10062,9946,1745,65,21944,1467,7341,1777,10585,843,287,1130
2019-06-08,12,4583,4734,2116,10130,10194,1701,70,22223,1481,7526,1834,10841,825,377,1202
2019-06-08,13,4741,4725,2088,10193,10520,1674,75,22590,1482,7558,1837,10877,791,348,1139
2019-06-08,14,4918,4723,2060,10452,10971,1657,79,23289,1478,7548,1833,10859,750,258,1008
2019-06-08,15,5089,4768,2041,10912,11494,1691,82,24309,1466,7416,1819,10701,709,191,900
2019-06-08,16,5229,4870,2054,11625,12073,1790,84,25701,1441,7084,1751,10276,675,157,832
2019-06-08,17,5338,4976,2088,12441,12630,1928,87,27215,1394,6515,1595,9504,643,153,796
2019-06-08,18,5333,5034,2118,12927,12944,2079,88,28167,1255,5326,1304,7885,617,199,816
2019-06-08,19,5229,5039,2132,13448,13043,2266,85,28972,868,3031,788,4687,598,334,932
2019-06-08,20,5058,4968,2105,13546,12810,2414,80,28978,282,751,218,1251,580,546,1126
2019-06-08,21,5001,4997,2053,13534,12868,2451,75,29057,2,9,0,11,571,694,1265
2019-06-08,22,4838,4897,2049,13308,12564,2360,69,28430,0,3,0,3,575,715,1290
2019-06-08,23,4608,4664,1964,12446,11786,2213,62,26637,0,0,0,0,568,655,1223
2019-06-08,24,4277,4413,1821,11528,10925,2032,56,24672,0,0,0,0,559,538,1097
2019-06-09,1,4002,4230,1745,11085,10510,1916,49,23688,0,0,0,0,675,364,1039
2019-06-09,2,3785,4145,1680,10723,9943,1820,46,22661,0,0,0,0,692,404,1096
2019-06-09,3,3622,4111,1651,10315,9528,1752,44,21767,0,0,0,0,720,456,1176
2019-06-09,4,3515,4115,1644,10031,9262,1713,43,21176,0,0,0,0,751,499,1250
2019-06-09,5,3446,4130,1667,9921,9178,1706,43,20975,0,0,0,0,758,540,1298
2019-06-09,6,3357,4096,1688,9892,9152,1704,43,20918,1,33,0,34,738,503,1241
2019-06-09,7,3338,4188,1742,9748,9300,1725,46,20942,271,1289,204,1764,675,633,1308
2019-06-09,8,3512,4374,1844,9855,9583,1794,50,21409,879,3961,715,5555,583,708,1291
2019-06-09,9,3776,4450,1956,10067,9670,1775,54,21694,1269,5975,1163,8407,515,854,1369
2019-06-09,10,4042,4514,2062,10181,9802,1746,59,21916,1374,6874,1405,9653,479,1035,1514
2019-06-09,11,4248,4531,2096,10473,10111,1720,64,22497,1415,7308,1536,10259,428,1171,1599
2019-06-09,12,4420,4579,2087,10820,10523,1695,69,23236,1437,7495,1598,10530,330,1220,1550
2019-06-09,13,4608,4596,2085,11224,11086,1697,74,24210,1434,7521,1608,10563,210,1167,1377
2019-06-09,14,4793,4662,2088,11800,11760,1744,78,25511,1416,7501,1602,10519,111,1014,1125
2019-06-09,15,4981,4756,2097,12517,12435,1823,81,26986,1388,7348,1574,10310,55,828,883
2019-06-09,16,5143,4908,2143,13472,13162,1934,84,28782,1339,6997,1476,9812,35,671,706
2019-06-09,17,5281,5028,2213,14438,13640,2078,86,30373,1250,6435,1302,8987,35,541,576
2019-06-09,18,5368,5092,2311,15222,13957,2288,86,31683,1070,5249,1029,7348,46,438,484
2019-06-09,19,5293,5093,2327,15701,13967,2456,84,32336,694,2992,599,4285,69,369,438
2019-06-09,20,5117,5029,2313,15692,13630,2531,79,32059,211,750,160,1121,110,336,446
2019-06-09,21,5033,4992,2258,15405,13647,2614,73,31867,2,8,0,10,162,322,484
2019-06-09,22,4831,4828,2206,14936,13195,2522,67,30848,0,3,0,3,200,311,511
2019-06-09,23,4476,4548,2034,13655,12143,2301,59,28285,0,0,0,0,219,307,526
2019-06-09,24,4132,4327,1844,12445,11069,2085,53,25780,0,0,0,0,222,293,515
2019-06-10,1,3873,4196,1808,11430,10713,1960,49,24280,0,0,0,0,232,321,553
2019-06-10,2,3661,4148,1745,10830,10124,1877,47,23003,0,0,0,0,200,303,503
2019-06-10,3,3509,4138,1708,10472,9762,1826,45,22232,0,0,0,0,162,277,439
2019-06-10,4,3416,4206,1699,10298,9605,1797,44,21871,0,0,0,0,134,257,391
2019-06-10,5,3422,4373,1754,10433,9783,1836,45,22224,0,0,0,0,125,239,364
2019-06-10,6,3431,4617,1899,10917,10285,1951,47,23326,0,29,0,29,132,218,350
2019-06-10,7,3549,4895,2146,11696,10891,2084,51,24849,195,1175,139,1509,152,186,338
2019-06-10,8,3811,5062,2329,12442,11559,2216,55,26401,703,3662,544,4909,174,153,327
2019-06-10,9,4095,5145,2407,12838,12191,2248,60,27465,1113,5597,977,7687,163,144,307
2019-06-10,10,4385,5219,2458,13131,12704,2242,65,28270,1264,6551,1254,9069,140,168,308
2019-06-10,11,4695,5266,2505,13706,13296,2236,71,29436,1328,7079,1406,9813,121,194,315
2019-06-10,12,4985,5283,2553,14267,13860,2245,77,30574,1371,7304,1503,10178,93,190,283
2019-06-10,13,5247,5358,2629,14910,14487,2259,82,31862,1368,7256,1534,10158,66,164,230
2019-06-10,14,5533,5455,2707,15816,15346,2302,87,33678,1349,7150,1526,10025,44,136,180
2019-06-10,15,5838,5562,2764,16683,16152,2392,91,35445,1315,6973,1484,9772,36,123,159
2019-06-10,16,6142,5683,2818,17404,16822,2519,94,36965,1256,6577,1376,9209,41,135,176
2019-06-10,17,6310,5779,2872,18082,17252,2630,95,38187,1165,5925,1207,8297,55,182,237
2019-06-10,18,6365,5811,2900,18513,17250,2741,95,38726,990,4634,936,6560,82,298,380
2019-06-10,19,6242,5684,2870,18672,16918,2775,92,38585,641,2513,538,3692,155,497,652
2019-06-10,20,5984,5535,2813,18448,16339,2773,85,37772,195,609,141,945,275,707,982
2019-06-10,21,5793,5453,2698,17787,16057,2828,78,36877,2,4,0,6,388,842,1230
2019-06-10,22,5479,5137,2580,16948,15317,2698,71,35159,0,1,0,1,453,907,1360
2019-06-10,23,5018,4745,2348,15298,13906,2442,63,31836,0,0,0,0,468,962,1430
2019-06-10,24,4589,4480,2110,13798,12577,2214,57,28773,0,0,0,0,458,1025,1483
2019-06-11,1,4148,4351,2042,13032,11734,2143,54,27091,0,0,0,0,313,822,1135
2019-06-11,2,3899,4268,1948,12145,11002,2040,51,25367,0,0,0,0,333,769,1102
2019-06-11,3,3722,4229,1886,11595,10522,1961,50,24256,0,0,0,0,368,638,1006
2019-06-11,4,3608,4266,1858,11318,10262,1927,49,23683,0,0,0,0,381,476,857
2019-06-11,5,3582,4409,1891,11328,10353,1959,50,23817,0,0,0,0,355,356,711
2019-06-11,6,3551,4623,2010,11692,10780,2068,52,24718,1,26,0,27,307,296,603
2019-06-11,7,3694,4901,2231,12501,11358,2213,55,26254,278,1109,204,1591,238,245,483
2019-06-11,8,3990,5082,2439,13169,12022,2349,60,27726,887,3473,744,5104,165,185,350
2019-06-11,9,4312,5189,2521,13473,12632,2399,65,28698,1278,5363,1238,7879,111,135,246
2019-06-11,10,4664,5278,2593,13781,13234,2418,70,29632,1389,6336,1508,9233,77,100,177
2019-06-11,11,5018,5349,2663,14251,13970,2430,76,30856,1423,6853,1638,9914,65,88,153
2019-06-11,12,5367,5405,2749,14994,14693,2449,83,32346,1437,7089,1664,10190,62,103,165
2019-06-11,13,5684,5508,2849,15623,15436,2482,90,33758,1437,7099,1652,10188,63,154,217
2019-06-11,14,6018,5613,2953,16500,16373,2560,96,35655,1421,6966,1634,10021,76,245,321
2019-06-11,15,6360,5736,3024,17356,17144,2661,100,37390,1386,6752,1569,9707,111,374,485
2019-06-11,16,6671,5870,3094,18136,17708,2770,104,38845,1340,6381,1456,9177,177,557,734
2019-06-11,17,6809,5942,3141,18805,18345,2872,106,40256,1259,5719,1277,8255,283,782,1065
2019-06-11,18,6808,5990,3186,19322,18449,2973,106,40976,1088,4484,999,6571,402,986,1388
2019-06-11,19,6720,5841,3144,19386,18112,2983,102,40710,718,2467,572,3757,495,1107,1602
2019-06-11,20,6423,5683,3062,19005,17465,2958,95,39650,221,600,148,969,588,1150,1738
2019-06-11,21,6193,5601,2926,18272,17100,2986,87,38573,2,5,0,7,684,1186,1870
2019-06-11,22,5816,5282,2789,17396,16238,2845,79,36685,0,1,0,1,757,1273,2030
2019-06-11,23,5334,4864,2532,15831,14614,2572,70,33215,0,0,0,0,803,1444,2247
2019-06-11,24,4880,4569,2271,14225,13195,2322,63,29931,0,0,0,0,795,1604,2399
2019-06-12,1,4560,4546,2150,13110,12260,2157,61,27722,0,0,0,0,525,1689,2214
2019-06-12,2,4287,4446,2031,12238,11449,2048,58,25927,0,0,0,0,441,1819,2260
2019-06-12,3,4080,4392,1950,11655,10881,1975,56,24702,0,0,0,0,406,1803,2209
2019-06-12,4,3948,4413,1914,11438,10567,1938,54,24130,0,0,0,0,444,1686,2130
2019-06-12,5,3907,4546,1944,11433,10619,1965,55,24204,0,0,0,0,517,1496,2013
2019-06-12,6,3874,4730,2065,11765,11003,2080,57,25036,0,18,0,18,587,1236,1823
2019-06-12,7,3984,5017,2279,12507,11543,2243,60,26484,195,1060,166,1421,642,953,1595
2019-06-12,8,4278,5234,2491,13133,12260,2357,65,27943,723,3431,678,4832,662,691,1353
2019-06-12,9,4614,5396,2600,13410,12893,2391,71,28892,1169,5446,1224,7839,606,479,1085
2019-06-12,10,4977,5530,2690,13720,13538,2387,77,29850,1338,6486,1529,9353,480,337,817
2019-06-12,11,5359,5648,2790,14155,14325,2369,85,31060,1386,7017,1674,10077,348,290,638
2019-06-12,12,5717,5749,2885,14647,15101,2365,93,32333,1412,7279,1749,10440,262,377,639
2019-06-12,13,6076,5904,2993,15128,15814,2377,100,33546,1420,7307,1765,10492,239,582,821
2019-06-12,14,6418,6061,3105,16001,16619,2430,107,35283,1413,7265,1765,10443,275,858,1133
2019-06-12,15,6762,6215,3181,16832,17213,2517,111,36801,1396,7139,1742,10277,352,1151,1503
2019-06-12,16,7031,6364,3256,17684,17725,2617,114,38266,1376,6815,1663,9854,449,1390,1839
2019-06-12,17,7105,6438,3283,18403,18120,2715,116,39482,1332,6246,1512,9090,548,1546,2094
2019-06-12,18,7110,6481,3287,18758,18241,2818,113,40058,1201,5099,1238,7538,647,1624,2271
2019-06-12,19,7001,6286,3244,18821,17890,2885,109,39833,834,2911,750,4495,754,1657,2411
2019-06-12,20,6712,6095,3153,18488,17468,2957,102,39142,269,724,210,1203,854,1684,2538
2019-06-12,21,6482,5971,3016,17852,17086,2921,93,38078,2,6,0,8,931,1770,2701
2019-06-12,22,6107,5630,2891,16940,16079,2746,85,35976,0,1,0,1,974,1961,2935
2019-06-12,23,5619,5162,2642,15404,14436,2492,75,32535,0,0,0,0,989,2220,3209
2019-06-12,24,5141,4819,2367,13907,13036,2265,68,29405,0,0,0,0,980,2429,3409
2019-06-13,1,4741,4729,2162,12746,11797,2125,63,26862,0,0,0,0,1061,2537,3598
2019-06-13,2,4462,4596,2030,11919,11060,2024,60,25195,0,0,0,0,1061,2562,3623
2019-06-13,3,4246,4527,1942,11435,10590,1940,57,24153,0,0,0,0,1061,2516,3577
2019-06-13,4,4108,4547,1901,11101,10374,1910,55,23572,0,0,0,0,1059,2443,3502
2019-06-13,5,4061,4678,1930,11099,10482,1944,56,23712,0,0,0,0,1052,2328,3380
2019-06-13,6,4015,4854,2048,11467,10889,2048,57,24594,1,26,0,27,1030,2165,3195
2019-06-13,7,4130,5152,2265,12126,11372,2222,59,25915,265,1222,183,1670,990,1972,2962
2019-06-13,8,4409,5417,2478,12651,12004,2323,65,27176,865,3795,654,5314,928,1825,2753
2019-06-13,9,4747,5624,2584,12875,12493,2338,72,27909,1267,5775,1100,8142,834,1811,2645
2019-06-13,10,5108,5816,2683,12976,12845,2306,80,28334,1386,6682,1360,9428,721,1924,2645
2019-06-13,11,5468,5989,2782,13218,13293,2253,87,28983,1423,7127,1499,10049,636,2133,2769
2019-06-13,12,5807,6129,2869,13536,13768,2207,94,29740,1436,7338,1566,10340,619,2410,3029
2019-06-13,13,6121,6306,2969,13841,14164,2171,100,30406,1437,7372,1578,10387,669,2704,3373
2019-06-13,14,6416,6461,3069,14579,14802,2178,105,31796,1432,7341,1572,10345,776,2946,3722
2019-06-13,15,6693,6605,3126,15317,15329,2238,109,33122,1420,7202,1548,10170,888,3107,3995
2019-06-13,16,6906,6704,3185,16056,15838,2312,111,34445,1401,6877,1472,9750,950,3203,4153
2019-06-13,17,6928,6738,3187,16697,16167,2401,110,35504,1356,6346,1326,9028,986,3252,4238
2019-06-13,18,6886,6718,3168,17094,16149,2550,109,36031,1227,5246,1076,7549,1024,3240,4264
2019-06-13,19,6770,6510,3122,17201,15954,2647,105,36036,857,3056,651,4564,1057,3146,4203
2019-06-13,20,6500,6221,3030,17056,15465,2744,98,35493,280,795,184,1259,1075,3005,4080
2019-06-13,21,6299,6072,2902,16524,15257,2735,92,34739,2,14,0,16,1081,2938,4019
2019-06-13,22,5961,5766,2801,15912,14560,2599,85,33286,0,2,0,2,1081,2964,4045
2019-06-13,23,5505,5313,2583,14595,13240,2379,76,30424,0,0,0,0,1076,3018,4094
2019-06-13,24,5065,4952,2317,13270,11988,2160,68,27616,0,0,0,0,1066,3076,4142
2019-06-14,1,4691,4699,2030,11698,10782,2012,59,24690,0,0,0,0,1062,3164,4226
2019-06-14,2,4412,4554,1900,11050,10248,1937,55,23425,0,0,0,0,1038,3217,4255
2019-06-14,3,4204,4479,1825,10646,9860,1863,53,22552,0,0,0,0,1013,3207,4220
2019-06-14,4,4070,4487,1787,10434,9706,1830,51,22151,0,0,0,0,983,3174,4157
2019-06-14,5,4017,4601,1810,10545,9864,1857,52,22452,0,0,0,0,938,3135,4073
2019-06-14,6,3963,4747,1903,10990,10328,1960,53,23469,1,34,0,35,878,3076,3954
2019-06-14,7,4070,5023,2096,11552,10825,2112,56,24683,299,1247,198,1744,789,2997,3786
2019-06-14,8,4341,5307,2304,12018,11343,2252,60,25812,918,3822,692,5432,678,2909,3587
2019-06-14,9,4643,5521,2413,12177,11573,2314,66,26262,1299,5784,1138,8221,568,2827,3395
2019-06-14,10,4968,5690,2494,12094,11764,2263,72,26324,1403,6664,1382,9449,467,2759,3226
2019-06-14,11,5279,5819,2575,12076,11900,2131,78,26320,1437,7078,1515,10030,381,2735,3116
2019-06-14,12,5569,5913,2625,12172,11945,2012,85,26349,1454,7256,1580,10290,316,2765,3081
2019-06-14,13,5825,6014,2682,12270,12176,1952,91,26622,1459,7258,1590,10307,293,2831,3124
2019-06-14,14,6088,6115,2741,12731,12524,1944,97,27431,1457,7183,1587,10227,342,2900,3242
2019-06-14,15,6332,6195,2773,13319,12941,1970,101,28462,1447,6984,1569,10000,486,2990,3476
2019-06-14,16,6491,6276,2796,14053,13328,2046,103,29661,1430,6635,1499,9564,684,3097,3781
2019-06-14,17,6513,6265,2843,14684,13742,2163,105,30826,1389,6103,1379,8871,859,3191,4050
2019-06-14,18,6494,6188,2804,15200,13852,2315,103,31605,1266,5029,1126,7421,957,3224,4181
2019-06-14,19,6378,6106,2731,15521,13666,2408,99,31829,900,2913,690,4503,1004,3219,4223
2019-06-14,20,6122,5835,2644,15396,13312,2498,93,31433,303,736,199,1238,1033,3179,4212
2019-06-14,21,5955,5811,2532,15029,13361,2540,86,31148,4,6,0,10,1051,3152,4203
2019-06-14,22,5666,5575,2481,14570,12989,2457,78,30225,0,1,0,1,1056,3173,4229
2019-06-14,23,5271,5219,2330,13544,12110,2299,70,28154,0,0,0,0,1055,3177,4232
2019-06-14,24,4877,4889,2120,12378,11241,2113,63,25933,0,0,0,0,1048,3138,4186
2019-06-15,1,4527,4697,1941,11081,10367,1978,58,23613,0,0,0,0,1049,3030,4079
2019-06-15,2,4257,4559,1838,10468,9843,1880,54,22372,0,0,0,0,1028,2956,3984
2019-06-15,3,4037,4467,1764,10089,9470,1810,52,21548,0,0,0,0,1009,2858,3867
2019-06-15,4,3906,4435,1718,9892,9261,1769,50,21100,0,0,0,0,993,2724,3717
2019-06-15,5,3801,4441,1711,9870,9272,1755,50,21074,0,0,0,0,964,2531,3495
2019-06-15,6,3694,4412,1732,10025,9343,1780,50,21325,1,30,0,31,904,2240,3144
2019-06-15,7,3723,4547,1814,10038,9331,1808,51,21355,290,1218,230,1738,816,1840,2656
2019-06-15,8,3985,4806,1964,10228,9646,1886,56,21955,901,3747,801,5449,728,1403,2131
2019-06-15,9,4323,5049,2111,10405,9962,1976,61,22538,1291,5693,1318,8302,671,982,1653
2019-06-15,10,4704,5225,2207,10361,10220,1958,68,22737,1403,6600,1594,9597,648,632,1280
2019-06-15,11,5086,5372,2277,10405,10450,1831,75,22892,1436,7040,1731,10207,645,434,1079
2019-06-15,12,5444,5515,2344,10470,10566,1718,83,22968,1449,7236,1796,10481,641,414,1055
2019-06-15,13,5764,5664,2393,10556,10631,1649,90,23056,1449,7250,1804,10503,630,552,1182
2019-06-15,14,6089,5797,2443,10841,10918,1621,97,23606,1435,7175,1794,10404,637,841,1478
2019-06-15,15,6374,5948,2490,11241,11257,1646,102,24374,1400,6986,1766,10152,677,1329,2006
2019-06-15,16,6597,6111,2558,11862,11678,1741,105,25514,1357,6654,1674,9685,738,1912,2650
2019-06-15,17,6734,6204,2626,12526,12077,1870,108,26708,1274,6111,1503,8888,803,2358,3161
2019-06-15,18,6719,6241,2695,13174,12420,2050,107,27879,1106,4986,1226,7318,874,2603,3477
2019-06-15,19,6581,6081,2650,13678,12505,2174,103,28586,754,2842,746,4342,936,2692,3628
2019-06-15,20,6293,5876,2593,13713,12227,2249,96,28410,245,707,209,1161,980,2658,3638
2019-06-15,21,6107,5800,2485,13536,12373,2360,89,28484,2,6,0,8,1009,2623,3632
2019-06-15,22,5814,5556,2412,13319,12130,2323,81,27978,0,1,0,1,1014,2635,3649
2019-06-15,23,5434,5198,2236,12595,11522,2173,73,26489,0,0,0,0,1009,2624,3633
2019-06-15,24,5029,4859,2034,11720,10745,2010,65,24668,0,0,0,0,1008,2549,3557
2019-06-16,1,4575,4658,1862,10640,10242,1912,59,22980,0,0,0,0,1006,2528,3534
2019-06-16,2,4302,4505,1766,10105,9766,1819,56,21872,0,0,0,0,976,2410,3386
2019-06-16,3,4089,4410,1707,9719,9363,1756,53,21018,0,0,0,0,938,2244,3182
2019-06-16,4,3965,4368,1670,9494,9109,1720,52,20502,0,0,0,0,898,2038,2936
2019-06-16,5,3866,4338,1660,9440,9033,1720,51,20370,0,0,0,0,855,1783,2638
2019-06-16,6,3737,4285,1661,9471,8997,1738,51,20383,0,26,0,26,814,1488,2302
2019-06-16,7,3742,4399,1711,9256,8769,1745,53,19950,256,1070,176,1502,748,1172,1920
2019-06-16,8,3974,4659,1848,9294,8995,1784,58,20260,844,3411,651,4906,648,886,1534
2019-06-16,9,4300,4855,1976,9480,9261,1792,64,20730,1250,5353,1114,7717,521,684,1205
2019-06-16,10,4656,5041,2092,9487,9529,1753,70,20973,1382,6353,1381,9116,382,567,949
2019-06-16,11,5012,5219,2185,9581,9795,1672,76,21255,1423,6859,1524,9806,276,525,801
2019-06-16,12,5364,5447,2258,9753,10033,1595,83,21593,1441,7072,1596,10109,225,547,772
2019-06-16,13,5671,5600,2329,9965,10356,1545,89,22083,1445,7058,1608,10111,233,664,897
2019-06-16,14,5971,5776,2404,10312,10831,1556,94,22921,1445,6996,1605,10046,298,939,1237
2019-06-16,15,6261,5935,2473,10868,11250,1606,98,23951,1442,6868,1585,9895,414,1313,1727
2019-06-16,16,6482,6102,2560,11560,11648,1740,101,25176,1429,6562,1514,9505,572,1678,2250
2019-06-16,17,6596,6224,2643,12277,12105,1900,102,26511,1387,6017,1372,8776,728,1987,2715
2019-06-16,18,6606,6215,2675,13178,12480,2076,103,27964,1263,4882,1119,7264,839,2188,3027
2019-06-16,19,6469,6163,2668,13801,12614,2225,100,28867,897,2785,685,4367,895,2251,3146
2019-06-16,20,6187,5912,2619,13997,12465,2288,92,28969,301,705,197,1203,913,2238,3151
2019-06-16,21,6012,5823,2512,13902,12592,2395,86,29102,3,4,0,7,914,2254,3168
2019-06-16,22,5738,5588,2437,13586,12252,2348,78,28392,0,1,0,1,902,2362,3264
2019-06-16,23,5316,5188,2246,12622,11375,2164,70,26356,0,0,0,0,884,2467,3351
2019-06-16,24,4904,4853,2019,11629,10580,1985,62,24382,0,0,0,0,871,2471,3342
2019-06-17,1,4507,4608,1849,10799,9936,1909,57,22827,0,0,0,0,854,2388,3242
2019-06-17,2,4246,4494,1755,10281,9574,1844,53,21880,0,0,0,0,785,2220,3005
2019-06-17,3,4044,4433,1704,9890,9306,1795,51,21170,0,0,0,0,701,2079,2780
2019-06-17,4,3916,4464,1689,9745,9199,1776,50,20895,0,0,0,0,616,1937,2553
2019-06-17,5,3882,4605,1737,9898,9405,1824,50,21299,0,0,0,0,525,1739,2264
2019-06-17,6,3870,4800,1859,10382,9916,1931,52,22400,1,27,0,28,438,1472,1910
2019-06-17,7,3959,5115,2083,11034,10500,2078,55,23788,275,1200,191,1666,360,1121,1481
2019-06-17,8,4229,5404,2303,11728,11167,2209,60,25292,881,3738,674,5293,289,718,1007
2019-06-17,9,4543,5629,2402,11955,11548,2291,67,25988,1278,5722,1124,8124,231,372,603
2019-06-17,10,4854,5813,2480,12075,11782,2279,73,26336,1387,6636,1381,9404,184,168,352
2019-06-17,11,5166,5962,2562,12235,11962,2170,79,26573,1418,7069,1518,10005,154,108,262
2019-06-17,12,5454,6091,2623,12468,12017,2041,84,26739,1427,7260,1583,10270,138,131,269
2019-06-17,13,5727,6236,2704,12710,12133,2012,90,27074,1421,7283,1593,10297,140,186,326
2019-06-17,14,5959,6364,2781,13206,12420,2014,94,27864,1409,7240,1585,10234,165,269,434
2019-06-17,15,6177,6469,2831,13802,12778,2056,98,28863,1389,7079,1554,10022,229,435,664
2019-06-17,16,6348,6580,2871,14537,13171,2143,100,30081,1350,6741,1461,9552,341,718,1059
2019-06-17,17,6400,6594,2935,15295,13401,2252,101,31178,1268,6186,1300,8754,469,1097,1566
2019-06-17,18,6371,6592,2905,15896,13537,2364,101,32018,1093,5021,1030,7144,570,1419,1989
2019-06-17,19,6289,6369,2870,16300,13517,2426,97,32461,724,2850,598,4172,647,1636,2283
2019-06-17,20,6051,6196,2809,16184,13314,2456,92,32174,227,720,161,1108,730,1744,2474
2019-06-17,21,5912,6066,2690,15717,13421,2538,85,31889,1,8,0,9,808,1782,2590
2019-06-17,22,5640,5756,2592,15114,12979,2453,78,30751,0,1,0,1,866,1828,2694
2019-06-17,23,5206,5313,2372,13650,11884,2233,69,27963,0,0,0,0,900,1810,2710
2019-06-17,24,4779,4973,2129,12398,10993,2042,62,25623,0,0,0,0,907,1679,2586
2019-06-18,1,4520,4671,1976,11767,10609,2001,57,24562,0,0,0,0,875,1443,2318
2019-06-18,2,4258,4548,1867,11125,10084,1926,54,23320,0,0,0,0,819,1274,2093
2019-06-18,3,4073,4480,1800,10683,9741,1872,52,22481,0,0,0,0,761,1112,1873
2019-06-18,4,3955,4492,1771,10456,9594,1838,51,22075,0,0,0,0,706,930,1636
2019-06-18,5,3917,4620,1803,10473,9757,1867,51,22279,0,0,0,0,657,741,1398
2019-06-18,6,3906,4803,1920,10901,10250,1954,53,23284,1,29,0,30,613,574,1187
2019-06-18,7,4004,5103,2139,11601,10834,2068,56,24684,276,1170,187,1633,557,404,961
2019-06-18,8,4284,5353,2345,12234,11444,2148,62,26013,875,3625,652,5152,479,235,714
2019-06-18,9,4586,5546,2431,12450,11645,2149,67,26440,1266,5556,1085,7907,405,118,523
2019-06-18,10,4902,5697,2501,12575,11832,2097,73,26708,1381,6477,1343,9201,365,88,453
2019-06-18,11,5221,5826,2568,12759,12047,2035,79,27052,1418,6905,1477,9800,362,117,479
2019-06-18,12,5528,5955,2638,13031,12224,1990,85,27463,1427,7071,1540,10038,383,125,508
2019-06-18,13,5795,6110,2721,13342,12443,1932,91,27939,1417,7070,1555,10042,437,173,610
2019-06-18,14,6054,6241,2795,13890,12883,1925,95,28923,1406,6976,1545,9927,534,330,864
2019-06-18,15,6306,6375,2840,14589,13388,1963,99,30167,1392,6733,1496,9621,654,561,1215
2019-06-18,16,6513,6495,2888,15344,13809,2044,102,31425,1373,6367,1400,9140,784,923,1707
2019-06-18,17,6594,6545,2951,15998,14154,2175,103,32557,1333,5830,1263,8426,897,1416,2313
2019-06-18,18,6577,6539,2916,16579,14348,2350,104,33507,1208,4722,1024,6954,966,1804,2770
2019-06-18,19,6509,6457,2868,16879,14290,2434,100,33830,841,2666,610,4117,1011,1944,2955
2019-06-18,20,6274,6210,2783,16712,13968,2543,94,33444,275,662,168,1105,1043,1959,3002
2019-06-18,21,6106,6052,2664,16181,13957,2603,87,32954,3,8,0,11,1064,2008,3072
2019-06-18,22,5789,5729,2577,15474,13442,2504,79,31625,0,1,0,1,1070,2116,3186
2019-06-18,23,5348,5264,2375,14071,12389,2303,71,28959,0,0,0,0,1065,2234,3299
2019-06-18,24,4911,4919,2134,12776,11443,2094,64,26502,0,0,0,0,1045,2300,3345
2019-06-19,1,4623,4750,1903,11947,10728,1945,60,24806,0,0,0,0,1010,2220,3230
2019-06-19,2,4347,4619,1796,11260,10196,1861,56,23499,0,0,0,0,959,2137,3096
2019-06-19,3,4136,4548,1733,10869,9876,1803,54,22729,0,0,0,0,921,2007,2928
2019-06-19,4,4004,4560,1703,10629,9700,1778,53,22287,0,0,0,0,904,1807,2711
2019-06-19,5,3954,4685,1738,10710,9846,1815,53,22551,0,0,0,0,882,1544,2426
2019-06-19,6,3911,4859,1862,11173,10318,1919,55,23590,1,36,0,37,831,1257,2088
2019-06-19,7,4019,5168,2084,11743,10901,2057,58,24884,282,1222,188,1692,730,954,1684
2019-06-19,8,4310,5429,2279,12179,11562,2174,64,26106,891,3794,663,5348,590,637,1227
2019-06-19,9,4651,5631,2361,12301,11839,2185,70,26520,1285,5800,1114,8199,469,373,842
2019-06-19,10,5011,5800,2419,12360,12068,2139,75,26767,1396,6689,1378,9463,393,200,593
2019-06-19,11,5383,5953,2469,12371,12422,2080,82,27079,1432,7115,1514,10061,348,125,473
2019-06-19,12,5745,6092,2498,12584,12722,2026,89,27547,1444,7315,1582,10341,323,127,450
2019-06-19,13,6098,6260,2540,12836,13032,1998,95,28086,1439,7347,1597,10383,331,197,528
2019-06-19,14,6428,6422,2577,13408,13547,2017,101,29198,1430,7309,1592,10331,387,378,765
2019-06-19,15,6754,6552,2595,14055,14038,2081,105,30406,1422,7182,1569,10173,474,713,1187
2019-06-19,16,7018,6670,2610,15009,14516,2183,108,31941,1409,6892,1491,9792,574,1219,1793
2019-06-19,17,7103,6747,2623,15588,14857,2299,109,32978,1366,6351,1348,9065,693,1807,2500
2019-06-19,18,7090,6727,2598,16178,15033,2420,109,33865,1242,5232,1100,7574,811,2223,3034
2019-06-19,19,7007,6544,2554,16448,14903,2482,105,34064,879,3031,667,4577,908,2377,3285
2019-06-19,20,6715,6325,2511,16311,14482,2505,98,33523,293,784,188,1265,982,2380,3362
2019-06-19,21,6493,6142,2437,15810,14384,2591,90,33002,4,14,1,19,1030,2406,3436
2019-06-19,22,6147,5810,2391,15240,13816,2508,82,31769,0,0,0,0,1055,2487,3542
2019-06-19,23,5663,5361,2254,13910,12636,2296,73,29039,0,0,0,0,1069,2521,3590
2019-06-19,24,5209,4999,2047,12609,11512,2093,65,26406,0,0,0,0,1073,2533,3606
2019-06-20,1,4854,4668,1834,11967,10558,1919,61,24620,0,0,0,0,1077,2674,3751
2019-06-20,2,4563,4530,1742,11334,10052,1883,58,23449,0,0,0,0,1030,2737,3767
2019-06-20,3,4349,4462,1696,10837,9703,1813,56,22534,0,0,0,0,988,2771,3759
2019-06-20,4,4217,4470,1687,10606,9537,1784,54,22108,0,0,0,0,957,2778,3735
2019-06-20,5,4182,4592,1742,10680,9741,1790,54,22391,0,0,0,0,934,2740,3674
2019-06-20,6,4161,4769,1902,11143,10244,1904,56,23472,0,38,0,38,897,2633,3530
2019-06-20,7,4232,5063,2147,11720,10897,2068,58,24869,280,1242,178,1700,825,2446,3271
2019-06-20,8,4497,5303,2307,12187,11479,2191,64,26047,891,3847,653,5391,719,2252,2971
2019-06-20,9,4812,5491,2341,12311,11783,2331,70,26623,1294,5887,1119,8300,606,2188,2794
2019-06-20,10,5145,5645,2389,12227,11891,2366,77,26688,1411,6795,1386,9592,521,2282,2803
2019-06-20,11,5480,5755,2422,12095,11888,2321,84,26513,1445,7230,1531,10206,478,2463,2941
2019-06-20,12,5796,5832,2430,12230,11858,2195,90,26499,1458,7445,1614,10517,461,2652,3113
2019-06-20,13,6082,5952,2439,12371,11956,2101,96,26649,1461,7488,1631,10580,465,2817,3282
2019-06-20,14,6341,6082,2442,12765,12124,2121,100,27236,1458,7481,1628,10567,505,2928,3433
2019-06-20,15,6569,6181,2429,13250,12368,2167,104,28015,1446,7362,1614,10422,591,2980,3571
2019-06-20,16,6745,6283,2424,13908,12660,2207,105,29006,1432,7035,1547,10014,708,2995,3703
2019-06-20,17,6783,6360,2453,14511,13012,2229,105,29983,1393,6485,1404,9282,802,2984,3786
2019-06-20,18,6723,6197,2451,15065,13097,2357,103,30748,1269,5367,1152,7788,838,2948,3786
2019-06-20,19,6620,6021,2443,15384,12961,2416,99,30985,901,3126,712,4739,827,2871,3698
2019-06-20,20,6362,5856,2405,15309,12727,2498,93,30752,303,805,207,1315,798,2761,3559
2019-06-20,21,6186,5745,2341,14936,12843,2590,87,30582,4,12,1,17,781,2675,3456
2019-06-20,22,5883,5477,2340,14507,12513,2493,80,29715,0,3,0,3,792,2620,3412
2019-06-20,23,5449,5116,2193,13345,11606,2292,71,27429,0,0,0,0,821,2586,3407
2019-06-20,24,5027,4836,2007,12143,10790,2087,64,25200,0,0,0,0,828,2566,3394
2019-06-21,1,4654,4528,1823,11464,10296,1959,58,23904,0,0,0,0,839,2540,3379
2019-06-21,2,4391,4408,1741,10848,9782,1876,54,22686,0,0,0,0,776,2445,3221
2019-06-21,3,4184,4358,1705,10478,9450,1817,52,21923,0,0,0,0,694,2386,3080
2019-06-21,4,4055,4383,1703,10313,9326,1799,50,21613,0,0,0,0,596,2359,2955
2019-06-21,5,4014,4515,1763,10417,9494,1832,50,21917,0,0,0,0,522,2352,2874
2019-06-21,6,3994,4690,1919,10893,9939,1933,50,22939,0,29,0,29,481,2370,2851
2019-06-21,7,4077,4980,2151,11421,10515,2066,52,24177,291,1109,170,1570,442,2398,2840
2019-06-21,8,4308,5179,2302,11883,11075,2186,57,25325,911,3587,632,5130,390,2428,2818
2019-06-21,9,4551,5302,2337,11980,11313,2242,63,25720,1307,5678,1100,8085,335,2466,2801
2019-06-21,10,4776,5399,2362,11982,11493,2238,69,25898,1417,6652,1383,9452,281,2532,2813
2019-06-21,11,4984,5452,2376,11856,11535,2182,74,25762,1453,7106,1530,10089,244,2649,2893
2019-06-21,12,5203,5448,2371,11901,11507,2111,78,25724,1470,7347,1612,10429,230,2812,3042
2019-06-21,13,5398,5467,2366,11898,11365,2076,83,25547,1473,7408,1632,10513,240,2998,3238
2019-06-21,14,5555,5492,2370,12229,11455,2091,86,25988,1472,7510,1625,10607,279,3140,3419
2019-06-21,15,5689,5525,2357,12699,11555,2098,89,26567,1472,7394,1606,10472,345,3242,3587
2019-06-21,16,5769,5600,2365,13080,11803,2124,91,27224,1462,7076,1542,10080,433,3296,3729
2019-06-21,17,5798,5690,2390,13552,11932,2182,90,27875,1424,6512,1406,9342,522,3309,3831
2019-06-21,18,5752,5602,2402,14049,12078,2221,89,28544,1313,5384,1158,7855,581,3263,3844
2019-06-21,19,5653,5545,2375,14395,12064,2280,86,28933,950,3139,723,4812,598,3160,3758
2019-06-21,20,5471,5437,2326,14459,11949,2330,82,28929,326,807,214,1347,603,3051,3654
2019-06-21,21,5376,5418,2251,14274,12084,2437,77,28980,5,9,1,15,635,2994,3629
2019-06-21,22,5169,5303,2221,14164,11921,2371,71,28635,0,2,0,2,682,2986,3668
2019-06-21,23,4860,5018,2112,13321,11244,2228,64,26973,0,0,0,0,700,3006,3706
2019-06-21,24,4529,4725,1936,12363,10472,2051,58,25067,0,0,0,0,671,3026,3697
2019-06-22,1,4241,4426,1794,11276,10058,1913,51,23424,0,0,0,0,678,2877,3555
2019-06-22,2,4004,4313,1708,10683,9566,1821,48,22242,0,0,0,0,706,2583,3289
2019-06-22,3,3823,4261,1660,10317,9207,1759,45,21455,0,0,0,0,632,2300,2932
2019-06-22,4,3694,4259,1645,10088,9023,1730,44,21010,0,0,0,0,558,1945,2503
2019-06-22,5,3628,4289,1659,10021,8996,1744,43,20930,0,0,0,0,485,1541,2026
2019-06-22,6,3551,4301,1694,10127,9109,1783,44,21187,3,49,3,55,430,1133,1563
2019-06-22,7,3547,4454,1744,10205,9056,1818,46,21251,298,1467,215,1980,407,782,1189
2019-06-22,8,3697,4655,1847,10383,9297,1878,49,21735,1018,4400,778,6196,401,528,929
2019-06-22,9,3932,4803,2001,10556,9539,1889,54,22161,1330,6204,1227,8761,364,381,745
2019-06-22,10,4152,4900,2108,10639,9699,1848,59,22365,1398,6958,1456,9812,327,309,636
2019-06-22,11,4302,4961,2138,10741,9818,1776,63,22520,1427,7388,1592,10407,290,309,599
2019-06-22,12,4450,4985,2146,10931,9881,1696,67,22693,1440,7587,1632,10659,239,282,521
2019-06-22,13,4561,5020,2150,11184,10003,1642,71,23021,1442,7653,1633,10728,201,226,427
2019-06-22,14,4679,5067,2161,11716,10275,1618,75,23809,1441,7642,1632,10715,177,197,374
2019-06-22,15,4793,5128,2189,12221,10745,1654,78,24825,1435,7547,1626,10608,169,210,379
2019-06-22,16,4934,5254,2239,13000,11243,1754,79,26203,1424,7249,1570,10243,175,293,468
2019-06-22,17,5046,5375,2321,13734,11796,1889,82,27626,1391,6703,1426,9520,198,499,697
2019-06-22,18,5107,5407,2319,14368,12074,2040,84,28691,1305,5713,1203,8221,244,765,1009
2019-06-22,19,5107,5407,2304,14815,12119,2167,83,29310,966,3373,756,5095,322,1105,1427
2019-06-22,20,4949,5347,2250,14837,11896,2240,78,29178,313,720,220,1253,442,1413,1855
2019-06-22,21,4924,5260,2169,14531,11995,2356,73,29081,9,23,7,39,488,1589,2077
2019-06-22,22,4781,5149,2150,14256,11766,2320,67,28535,0,0,0,0,555,1683,2238
2019-06-22,23,4458,4877,2028,13323,11066,2170,61,26745,0,0,0,0,623,1698,2321
2019-06-22,24,4168,4605,1847,12361,10407,2007,55,24957,0,0,0,0,598,1449,2047
2019-06-23,1,3857,4384,1726,11324,9959,1930,50,23387,0,0,0,0,487,958,1445
2019-06-23,2,3632,4282,1635,10673,9412,1835,46,22092,0,0,0,0,454,747,1201
2019-06-23,3,3466,4226,1580,10147,9006,1768,44,21091,0,0,0,0,397,525,922
2019-06-23,4,3346,4213,1554,9833,8830,1732,43,20564,0,0,0,0,350,389,739
2019-06-23,5,3292,4212,1553,9670,8697,1733,43,20269,0,0,0,0,313,287,600
2019-06-23,6,3214,4175,1564,9656,8598,1755,44,20178,3,50,2,55,286,241,527
2019-06-23,7,3216,4285,1593,9572,8378,1755,47,19871,297,1474,209,1980,262,226,488
2019-06-23,8,3404,4499,1716,9746,8654,1791,50,20369,1016,4460,768,6244,231,235,466
2019-06-23,9,3671,4627,1880,10215,8973,1804,54,21180,1340,6277,1214,8831,191,207,398
2019-06-23,10,3939,4744,1982,10436,9279,1767,59,21676,1403,7016,1445,9864,151,195,346
2019-06-23,11,4179,4813,2022,10584,9653,1699,63,22129,1432,7451,1589,10472,122,174,296
2019-06-23,12,4400,4911,2046,10912,10064,1627,68,22800,1445,7635,1603,10683,86,182,268
2019-06-23,13,4589,4989,2064,11368,10540,1591,72,23699,1445,7671,1602,10718,72,188,260
2019-06-23,14,4777,5122,2092,11813,11104,1604,77,24725,1443,7651,1600,10694,84,234,318
2019-06-23,15,4990,5257,2122,12489,11832,1689,81,26218,1439,7571,1595,10605,148,363,511
2019-06-23,16,5191,5427,2169,13219,12470,1814,83,27713,1429,7266,1548,10243,255,595,850
2019-06-23,17,5413,5597,2253,13936,13078,1980,86,29207,1398,6723,1399,9520,417,948,1365
2019-06-23,18,5550,5654,2272,14842,13481,2163,89,30700,1308,5745,1180,8233,465,1235,1700
2019-06-23,19,5522,5597,2264,15492,13626,2295,87,31626,966,3394,742,5102,512,1590,2102
2019-06-23,20,5340,5492,2240,15650,13226,2346,82,31431,314,734,214,1262,600,1868,2468
2019-06-23,21,5237,5417,2191,15281,13148,2459,76,31090,9,22,5,36,670,1972,2642
2019-06-23,22,5020,5213,2163,14767,12690,2399,69,30050,0,0,0,0,736,2086,2822
2019-06-23,23,4645,4854,2013,13519,11724,2217,61,27645,0,0,0,0,794,2169,2963
2019-06-23,24,4289,4573,1830,12272,10781,2019,55,25252,0,0,0,0,774,2134,2908
2019-06-24,1,4018,4515,1706,11458,10112,1957,53,23699,0,0,0,0,689,2229,2918
2019-06-24,2,3785,4426,1630,10780,9682,1880,50,22510,0,0,0,0,618,2156,2774
2019-06-24,3,3622,4382,1593,10321,9427,1829,48,21747,0,0,0,0,580,2067,2647
2019-06-24,4,3508,4420,1594,10140,9296,1813,47,21423,0,0,0,0,544,1942,2486
2019-06-24,5,3495,4557,1660,10172,9505,1859,48,21710,0,0,0,0,508,1795,2303
2019-06-24,6,3494,4765,1822,10658,9991,1968,50,22793,3,46,2,51,467,1522,1989
2019-06-24,7,3628,5084,2062,11321,10565,2095,53,24160,292,1413,206,1911,422,1185,1607
2019-06-24,8,3927,5320,2231,11901,11213,2204,59,25500,1002,4315,755,6072,367,905,1272
2019-06-24,9,4223,5494,2310,12142,11339,2230,64,25902,1323,6153,1196,8672,281,630,911
2019-06-24,10,4531,5635,2365,12333,11749,2210,68,26485,1380,6931,1411,9722,203,386,589
2019-06-24,11,4834,5749,2403,12498,12210,2160,74,27062,1412,7379,1547,10338,139,242,381
2019-06-24,12,5129,5858,2422,12815,12615,2115,81,27745,1425,7582,1595,10602,141,288,429
2019-06-24,13,5396,5997,2459,13073,12935,2089,87,28302,1410,7617,1587,10614,160,382,542
2019-06-24,14,5652,6145,2487,13566,13540,2104,93,29420,1401,7585,1587,10573,206,542,748
2019-06-24,15,5931,6275,2511,14333,14178,2166,97,30891,1366,7507,1576,10449,321,848,1169
2019-06-24,16,6224,6397,2534,14928,14743,2243,100,32133,1282,7179,1497,9958,447,1221,1668
2019-06-24,17,6388,6528,2579,15641,15137,2330,103,33331,1191,6631,1344,9166,600,1632,2232
2019-06-24,18,6456,6434,2579,16223,15356,2434,102,34233,1053,5669,1113,7835,680,1784,2464
2019-06-24,19,6366,6319,2556,16590,15212,2501,99,34519,678,3333,662,4673,739,1872,2611
2019-06-24,20,6108,6158,2523,16459,14758,2516,92,33943,208,720,182,1110,785,1917,2702
2019-06-24,21,5930,5998,2442,15858,14606,2595,84,33261,4,15,4,23,817,1975,2792
2019-06-24,22,5628,5669,2383,15083,14010,2509,76,31797,0,0,0,0,859,2003,2862
2019-06-24,23,5191,5229,2201,13584,12779,2288,68,28837,0,0,0,0,892,2013,2905
2019-06-24,24,4763,4892,1988,12301,11730,2093,61,26303,0,0,0,0,893,1938,2831
2019-06-25,1,4471,4784,1833,11472,10908,1975,57,24532,0,0,0,0,824,2121,2945
2019-06-25,2,4200,4660,1741,10880,10374,1889,54,23316,0,0,0,0,791,2039,2830
2019-06-25,3,4015,4589,1691,10435,10000,1833,52,22438,0,0,0,0,773,1920,2693
2019-06-25,4,3896,4604,1677,10244,9819,1815,50,22049,0,0,0,0,760,1800,2560
2019-06-25,5,3863,4727,1726,10334,9956,1854,51,22314,0,0,0,0,744,1669,2413
2019-06-25,6,3841,4918,1878,10793,10424,1960,52,23348,2,50,1,53,684,1399,2083
2019-06-25,7,3958,5225,2121,11399,10981,2098,55,24651,232,1231,169,1632,624,1145,1769
2019-06-25,8,4222,5479,2275,11866,11612,2205,61,25862,864,3993,665,5522,554,886,1440
2019-06-25,9,4517,5671,2337,11996,12069,2238,66,26490,1156,5806,1092,8054,467,630,1097
2019-06-25,10,4811,5831,2387,11972,12338,2196,72,26706,1230,6335,1321,8886,382,446,828
2019-06-25,11,5111,5978,2411,11946,12550,2119,78,26821,1237,6763,1454,9454,304,356,660
2019-06-25,12,5408,6130,2437,12001,12673,2037,83,26914,1303,6953,1483,9739,365,422,787
2019-06-25,13,5644,6318,2474,12090,12833,1988,89,27122,1418,6923,1476,9817,443,569,1012
2019-06-25,14,5851,6505,2496,12515,13239,1988,94,27957,1418,6816,1441,9675,523,796,1319
2019-06-25,15,6085,6657,2509,13009,13707,2037,98,28970,1413,6633,1446,9492,663,1070,1733
2019-06-25,16,6314,6803,2538,13580,14077,2116,101,29994,1427,6047,1488,8962,798,1321,2119
2019-06-25,17,6438,6933,2542,14110,14304,2206,101,30841,1397,5409,1371,8177,932,1519,2451
2019-06-25,18,6426,6850,2547,14708,14403,2331,101,31662,1305,4493,1148,6946,962,1610,2572
2019-06-25,19,6360,6719,2551,15061,14292,2395,97,31963,972,2672,734,4378,983,1687,2670
2019-06-25,20,6111,6532,2523,15022,13963,2438,92,31633,316,547,216,1079,1002,1751,2753
2019-06-25,21,5930,6356,2443,14608,13992,2539,85,31342,8,8,4,20,1030,1819,2849
2019-06-25,22,5640,5997,2379,14140,13508,2458,77,30302,0,0,0,0,1054,1972,3026
2019-06-25,23,5208,5485,2206,13010,12410,2252,69,27859,0,0,0,0,1072,2031,3103
2019-06-25,24,4798,5094,1998,11874,11356,2050,62,25460,0,0,0,0,1057,2028,3085
2019-06-26,1,4469,4995,1815,11215,10418,1993,56,23802,0,0,0,0,1001,2351,3352
2019-06-26,2,4208,4837,1721,10633,9977,1903,53,22685,0,0,0,0,965,2331,3296
2019-06-26,3,4024,4745,1672,10235,9636,1843,51,21887,0,0,0,0,952,2270,3222
2019-06-26,4,3898,4753,1663,10084,9478,1833,49,21571,0,0,0,0,936,2204,3140
2019-06-26,5,3870,4873,1715,10203,9612,1848,50,21839,0,0,0,0,922,2123,3045
2019-06-26,6,3872,5061,1871,10664,10019,1956,51,22815,3,42,2,47,887,1870,2757
2019-06-26,7,3956,5371,2114,11202,10577,2096,55,24054,282,1413,202,1897,851,1608,2459
2019-06-26,8,4207,5670,2263,11636,11318,2238,60,25370,980,4378,738,6096,803,1356,2159
2019-06-26,9,4470,5908,2319,11657,11614,2306,65,25766,1295,6185,1167,8647,768,1198,1966
2019-06-26,10,4729,6129,2361,11449,11827,2283,70,25755,1382,6942,1407,9731,735,1036,1771
2019-06-26,11,4983,6328,2390,11291,11956,2190,75,25636,1413,7386,1538,10337,703,932,1635
2019-06-26,12,5220,6500,2405,11201,12025,2066,80,25491,1427,7603,1588,10618,773,1085,1858
2019-06-26,13,5424,6704,2429,11108,12119,2000,85,25431,1418,7645,1588,10651,858,1348,2206
2019-06-26,14,5596,6886,2441,11312,12371,1993,89,25883,1414,7625,1584,10623,946,1629,2575
2019-06-26,15,5789,7023,2445,11581,12795,2022,93,26611,1404,7533,1570,10507,993,1946,2939
2019-06-26,16,5996,7190,2458,12006,13208,2091,96,27520,1384,7231,1508,10123,1039,2246,3285
2019-06-26,17,6118,7194,2451,12447,13568,2200,98,28432,1346,6690,1379,9415,1082,2502,3584
2019-06-26,18,6105,7151,2464,13029,13675,2326,97,29245,1248,5736,1179,8163,1025,2586,3611
2019-06-26,19,6039,6987,2459,13492,13648,2388,94,29740,874,3460,738,5072,956,2545,3501
2019-06-26,20,5829,6785,2420,13590,13400,2425,88,29622,284,770,219,1273,869,2480,3349
2019-06-26,21,5680,6587,2340,13413,13492,2510,81,29615,7,17,5,29,835,2524,3359
2019-06-26,22,5426,6232,2337,13186,13066,2438,75,28884,0,0,0,0,814,2549,3363
2019-06-26,23,5064,5739,2187,12303,12102,2241,67,26831,0,0,0,0,799,2526,3325
2019-06-26,24,4685,5336,1983,11351,11107,2042,60,24678,0,0,0,0,790,2508,3298
2019-06-27,1,4386,5052,1819,10821,10248,1970,56,23238,0,0,0,0,709,2292,3001
2019-06-27,2,4139,4887,1737,10321,9711,1898,53,22128,0,0,0,0,665,2280,2945
2019-06-27,3,3964,4785,1700,9969,9427,1835,51,21427,0,0,0,0,661,2215,2876
2019-06-27,4,3853,4780,1696,9850,9290,1804,49,21136,0,0,0,0,652,2116,2768
2019-06-27,5,3846,4890,1756,10006,9431,1822,50,21451,0,0,0,0,645,1999,2644
2019-06-27,6,3833,5074,1919,10503,9921,1923,51,22535,2,52,1,55,596,1794,2390
2019-06-27,7,3936,5384,2169,11035,10492,2044,53,23752,255,1464,181,1900,550,1517,2067
2019-06-27,8,4165,5689,2316,11472,10987,2152,59,24796,916,4410,692,6018,489,1210,1699
2019-06-27,9,4431,5943,2336,11371,11135,2188,65,24880,1251,6226,1145,8622,433,999,1432
2019-06-27,10,4678,6175,2367,11142,11340,2140,70,24813,1354,6968,1363,9685,364,808,1172
2019-06-27,11,4909,6371,2385,10854,11504,2066,76,24619,1401,7420,1508,10329,312,702,1014
2019-06-27,12,5150,6530,2390,10648,11685,2001,81,24534,1410,7628,1570,10608,318,837,1155
2019-06-27,13,5348,6724,2401,10540,11902,1943,86,24590,1400,7660,1573,10633,332,1037,1369
2019-06-27,14,5531,6893,2406,10687,12365,1950,90,25212,1389,7640,1569,10598,358,1248,1606
2019-06-27,15,5736,7016,2394,10874,12878,2011,93,25976,1371,7555,1560,10486,455,1524,1979
2019-06-27,16,5947,7139,2395,11347,13298,2097,96,26959,1337,7247,1506,10090,562,1785,2347
2019-06-27,17,6085,7203,2410,11828,13673,2197,97,27916,1283,6719,1364,9366,688,2022,2710
2019-06-27,18,6092,7119,2424,12351,13768,2351,98,28689,1158,5755,1146,8059,711,2137,2848
2019-06-27,19,6012,6974,2423,12938,13715,2418,94,29288,795,3445,706,4946,726,2162,2888
2019-06-27,20,5792,6775,2379,13186,13477,2488,89,29362,255,768,203,1226,726,2137,2863
2019-06-27,21,5642,6583,2319,13153,13475,2575,82,29423,5,6,5,16,713,2153,2866
2019-06-27,22,5383,6238,2315,13018,13031,2506,75,28767,0,0,0,0,721,2134,2855
2019-06-27,23,5037,5749,2166,12151,12064,2301,67,26714,0,0,0,0,717,2074,2791
2019-06-27,24,4665,5345,1975,11283,11099,2091,60,24666,0,0,0,0,658,1997,2655
2019-06-28,1,4387,5168,1814,10516,10654,1972,56,23325,0,0,0,0,662,1885,2547
2019-06-28,2,4149,4991,1734,10009,10129,1893,52,22222,0,0,0,0,584,1812,2396
2019-06-28,3,3976,4875,1699,9707,9739,1832,50,21470,0,0,0,0,550,1709,2259
2019-06-28,4,3846,4855,1696,9572,9578,1801,48,21138,0,0,0,0,509,1571,2080
2019-06-28,5,3829,4937,1751,9701,9698,1821,49,21402,0,0,0,0,469,1435,1904
2019-06-28,6,3817,5087,1903,10173,10064,1918,50,22347,2,52,2,56,427,1201,1628
2019-06-28,7,3911,5395,2128,10714,10639,2038,53,23591,234,1481,214,1929,369,962,1331
2019-06-28,8,4171,5731,2281,11146,11158,2149,58,24650,821,4411,793,6025,311,770,1081
2019-06-28,9,4458,6022,2313,11289,11551,2178,63,25202,1129,6239,1269,8637,236,622,858
2019-06-28,10,4738,6280,2345,11086,11837,2126,68,25232,1226,6840,1505,9571,172,482,654
2019-06-28,11,4992,6496,2359,10884,12131,2056,73,25267,1317,7261,1652,10230,128,411,539
2019-06-28,12,5259,6664,2356,10772,12449,2001,78,25419,1326,7409,1713,10448,114,507,621
2019-06-28,13,5490,6855,2356,10669,12751,1958,84,25569,1295,7255,1724,10274,117,647,764
2019-06-28,14,5720,7029,2366,10836,13287,1973,89,26294,1282,7093,1725,10100,136,825,961
2019-06-28,15,5950,7169,2361,11102,13838,2042,93,27184,1231,6940,1706,9877,186,1134,1320
2019-06-28,16,6171,7272,2364,11580,14318,2132,96,28241,1123,6523,1627,9273,250,1450,1700
2019-06-28,17,6306,7329,2387,12107,14722,2238,98,29293,1032,5821,1480,8333,336,1714,2050
2019-06-28,18,6289,7243,2404,12691,14599,2378,98,29898,932,4904,1251,7087,407,1840,2247
2019-06-28,19,6189,7044,2372,13223,14361,2435,95,30244,672,2840,778,4290,510,1859,2369
2019-06-28,20,5932,6798,2323,13385,13876,2480,89,29974,232,594,217,1043,598,1861,2459
2019-06-28,21,5749,6604,2243,13272,13761,2548,82,29794,8,4,4,16,656,1960,2616
2019-06-28,22,5475,6319,2217,13120,13333,2488,75,29132,0,0,0,0,720,2041,2761
2019-06-28,23,5133,5872,2101,12311,12442,2327,67,27260,0,0,0,0,768,2110,2878
2019-06-28,24,4766,5453,1924,11466,11499,2136,60,25278,0,0,0,0,727,2133,2860
2019-06-29,1,4479,5182,1818,10646,10855,2007,53,23688,0,0,0,0,735,2036,2771
2019-06-29,2,4219,4980,1730,10084,10279,1903,49,22445,0,0,0,0,708,2023,2731
2019-06-29,3,4024,4845,1681,9690,9828,1836,47,21536,0,0,0,0,676,1931,2607
2019-06-29,4,3877,4770,1662,9368,9572,1803,46,20922,0,0,0,0,640,1828,2468
2019-06-29,5,3799,4746,1676,9384,9495,1795,46,20854,0,0,0,0,609,1690,2299
2019-06-29,6,3712,4720,1711,9487,9454,1835,46,20954,3,28,2,33,593,1378,1971
2019-06-29,7,3691,4885,1755,9493,9492,1907,48,21069,289,1026,230,1545,582,1021,1603
2019-06-29,8,3896,5177,1858,9604,9705,2000,52,21494,1018,3342,863,5223,560,734,1294
2019-06-29,9,4201,5498,2013,9800,10069,2034,56,22101,1337,4858,1321,7516,480,599,1079
2019-06-29,10,4496,5778,2123,9727,10421,2008,61,22374,1417,5491,1551,8459,393,506,899
2019-06-29,11,4768,6006,2160,9670,10747,1977,66,22619,1447,5917,1696,9060,314,556,870
2019-06-29,12,5053,6213,2169,9636,11039,1942,72,22853,1462,6120,1755,9337,278,573,851
2019-06-29,13,5298,6403,2177,9680,11399,1916,77,23235,1465,6067,1759,9291,263,667,930
2019-06-29,14,5526,6545,2183,9826,11876,1902,82,23853,1463,6014,1758,9235,274,796,1070
2019-06-29,15,5761,6688,2200,10162,12497,1956,86,24871,1458,5874,1751,9083,344,1055,1399
2019-06-29,16,6011,6832,2240,10718,13100,2020,89,26104,1441,5593,1678,8712,433,1328,1761
2019-06-29,17,6173,6922,2319,11366,13673,2173,93,27488,1410,4992,1529,7931,542,1631,2173
2019-06-29,18,6234,6980,2320,12210,13808,2317,94,28616,1319,4119,1300,6738,584,1738,2322
2019-06-29,19,6136,6793,2323,12768,13594,2425,91,29058,986,2322,794,4102,631,1832,2463
2019-06-29,20,5896,6588,2292,12957,13179,2454,85,28850,345,433,224,1002,675,1901,2576
2019-06-29,21,5723,6416,2210,12801,13130,2536,79,28693,11,2,4,17,726,2022,2748
2019-06-29,22,5495,6150,2195,12729,12799,2497,72,28223,0,0,0,0,774,2113,2887
2019-06-29,23,5147,5742,2061,12050,12014,2343,65,26597,0,0,0,0,806,2188,2994
2019-06-29,24,4791,5365,1881,11256,11213,2153,59,24806,0,0,0,0,771,2202,2973
2019-06-30,1,4553,5118,1797,10747,10508,2019,56,23459,0,0,0,0,698,2020,2718
2019-06-30,2,4283,4929,1707,10174,9948,1917,52,22222,0,0,0,0,627,1962,2589
2019-06-30,3,4095,4808,1648,9827,9491,1848,50,21349,0,0,0,0,620,1702,2322
2019-06-30,4,3947,4742,1617,9620,9202,1814,49,20812,0,0,0,0,608,1458,2066
2019-06-30,5,3865,4712,1613,9597,9062,1805,48,20640,0,0,0,0,596,1267,1863
2019-06-30,6,3764,4665,1615,9647,8953,1821,48,20599,2,25,1,28,567,1100,1667
2019-06-30,7,3716,4806,1639,9584,8807,1820,50,20388,258,948,213,1419,547,941,1488
2019-06-30,8,3920,5133,1774,9688,8959,1874,55,20702,965,3201,851,5017,521,829,1350
2019-06-30,9,4224,5393,1940,9600,9219,1914,60,20924,1277,4906,1313,7496,425,755,1180
2019-06-30,10,4540,5659,2040,9670,9596,1903,66,21366,1388,5820,1575,8783,319,699,1018
2019-06-30,11,4852,5895,2084,9701,10040,1872,71,21816,1420,6384,1728,9532,221,712,933
2019-06-30,12,5160,6166,2139,9834,10514,1843,76,22396,1439,6835,1772,10046,202,849,1051
2019-06-30,13,5428,6377,2203,9875,11043,1846,81,22972,1467,7006,1774,10247,213,1092,1305
2019-06-30,14,5671,6599,2260,10154,11754,1907,85,24027,1467,7038,1775,10280,246,1379,1625
2019-06-30,15,5912,6774,2315,10511,12495,1985,89,25206,1462,7021,1768,10251,327,1588,1915
2019-06-30,16,6149,6925,2377,11035,13075,2136,92,26463,1451,6791,1711,9953,428,1808,2236
2019-06-30,17,6293,7004,2464,11825,13747,2280,95,28071,1423,6240,1561,9224,552,2046,2598
2019-06-30,18,6361,6967,2527,12704,13888,2434,96,29249,1339,5334,1338,8011,623,2145,2768
2019-06-30,19,6255,6803,2525,13361,13860,2542,94,29982,1025,3406,854,5285,684,2288,2972
2019-06-30,20,6005,6591,2492,13561,13472,2558,89,29806,382,772,247,1401,748,2406,3154
2019-06-30,21,5840,6433,2416,13460,13388,2634,83,29691,15,11,4,30,793,2451,3244
2019-06-30,22,5584,6151,2359,13232,12944,2565,75,28942,0,0,0,0,852,2478,3330
2019-06-30,23,5191,5709,2173,12305,12087,2370,67,26954,0,0,0,0,893,2481,3374
2019-06-30,24,4803,5344,1948,11285,11089,2152,61,24712,0,0,0,0,900,2488,3388
2019-07-01,1,4457,5216,1812,10604,10569,2060,61,23421,0,0,0,0,894,2566,3460
2019-07-01,2,4202,5048,1725,10037,9988,1957,58,22169,0,0,0,0,852,2514,3366
2019-07-01,3,4022,4943,1680,9719,9618,1894,56,21417,0,0,0,0,852,2453,3305
2019-07-01,4,3889,4936,1665,9562,9447,1871,54,21067,0,0,0,0,840,2381,3221
2019-07-01,5,3885,5052,1714,9736,9606,1911,55,21437,0,0,0,0,827,2298,3125
2019-07-01,6,3888,5224,1842,10250,10076,2011,56,22523,3,54,2,59,783,2158,2941
2019-07-01,7,3972,5524,2046,10857,10574,2120,58,23738,297,1538,241,2076,745,1961,2706
2019-07-01,8,4237,5928,2241,11431,11232,2222,63,25076,1040,4486,958,6484,709,1736,2445
2019-07-01,9,4542,6279,2344,11608,11660,2262,69,25726,1351,6291,1413,9055,642,1583,2225
2019-07-01,10,4875,6592,2418,11598,12218,2261,75,26278,1423,6986,1637,10046,571,1435,2006
2019-07-01,11,5233,6859,2494,11591,12785,2231,81,26815,1452,7429,1774,10655,498,1315,1813
2019-07-01,12,5579,7085,2549,11528,13322,2214,87,27279,1467,7634,1813,10914,487,1457,1944
2019-07-01,13,5900,7302,2629,11575,13805,2243,93,27844,1471,7655,1815,10941,498,1680,2178
2019-07-01,14,6201,7500,2704,11919,14508,2297,98,28950,1471,7636,1814,10921,524,1994,2518
2019-07-01,15,6514,7619,2748,12397,15212,2381,101,30219,1468,7566,1810,10844,612,2400,3012
2019-07-01,16,6797,7709,2771,13173,15782,2507,103,31693,1453,7305,1763,10521,702,2702,3404
2019-07-01,17,6944,7779,2809,13869,16179,2623,104,32904,1421,6768,1620,9809,809,2926,3735
2019-07-01,18,6947,7698,2794,14522,16212,2740,105,33708,1334,5836,1390,8560,893,3025,3918
2019-07-01,19,6818,7514,2743,14943,15954,2781,101,33906,1001,3575,899,5475,962,3054,4016
2019-07-01,20,6517,7263,2670,14921,15382,2745,94,33268,365,821,272,1458,1026,3041,4067
2019-07-01,21,6272,7096,2557,14568,15030,2780,86,32590,14,12,7,33,1054,3101,4155
2019-07-01,22,5924,6690,2494,14111,14421,2693,79,31429,0,0,0,0,1081,3112,4193
2019-07-01,23,5467,6150,2313,12963,13243,2465,71,28869,0,0,0,0,1091,3123,4214
2019-07-01,24,5014,5702,2095,11851,12081,2230,64,26353,0,0,0,0,1067,3138,4205
2019-07-02,1,4656,5297,1906,10969,11411,2104,61,24672,0,0,0,0,1000,3088,4088
2019-07-02,2,4381,5111,1806,10390,10741,2003,58,23317,0,0,0,0,959,3054,4013
2019-07-02,3,4186,4995,1747,9979,10296,1932,55,22388,0,0,0,0,923,2990,3913
2019-07-02,4,4046,4977,1716,9818,10077,1900,54,21975,0,0,0,0,877,2905,3782
2019-07-02,5,4027,5088,1752,9973,10184,1925,54,22262,0,0,0,0,826,2806,3632
2019-07-02,6,4023,5278,1881,10441,10636,2036,55,23295,2,54,2,58,778,2666,3444
2019-07-02,7,4090,5553,2082,10999,11153,2199,57,24534,236,1542,237,2015,728,2481,3209
2019-07-02,8,4349,5934,2259,11474,11768,2274,62,25705,874,4490,929,6293,644,2268,2912
2019-07-02,9,4662,6238,2344,11378,12287,2279,68,26141,1182,6301,1368,8851,560,2174,2734
2019-07-02,10,4980,6521,2414,11219,12737,2239,74,26398,1278,6988,1585,9851,472,2068,2540
2019-07-02,11,5318,6777,2466,11137,13171,2176,81,26697,1304,7422,1714,10440,385,2015,2400
2019-07-02,12,5621,6990,2509,11119,13613,2129,87,27078,1357,7620,1769,10746,344,2163,2507
2019-07-02,13,5869,7227,2563,11199,14068,2119,93,27606,1400,7642,1787,10829,345,2399,2744
2019-07-02,14,6094,7421,2618,11581,14704,2141,97,28649,1424,7624,1794,10842,359,2622,2981
2019-07-02,15,6362,7560,2650,12017,15279,2166,101,29690,1404,7549,1784,10737,481,2823,3304
2019-07-02,16,6614,7678,2667,12643,15793,2238,104,30906,1376,7283,1731,10390,601,2969,3570
2019-07-02,17,6750,7747,2707,13321,16108,2358,107,32021,1321,6760,1573,9654,734,3055,3789
2019-07-02,18,6753,7639,2723,13982,16072,2543,105,32829,1188,5812,1347,8347,825,3053,3878
2019-07-02,19,6663,7449,2691,14281,15796,2646,102,32950,863,3565,848,5276,896,3030,3926
2019-07-02,20,6401,7198,2620,14241,15265,2721,96,32448,300,833,249,1382,965,2957,3922
2019-07-02,21,6199,7008,2523,14052,14970,2732,88,31968,10,12,5,27,1019,3003,4022
2019-07-02,22,5880,6588,2459,13714,14381,2626,80,30928,0,0,0,0,1081,3040,4121
2019-07-02,23,5429,6057,2284,12650,13182,2417,72,28447,0,0,0,0,1131,3078,4209
2019-07-02,24,4994,5609,2079,11658,12155,2189,65,26192,0,0,0,0,1109,3128,4237
2019-07-03,1,4618,5281,1902,10917,11154,2099,60,24357,0,0,0,0,1041,3204,4245
2019-07-03,2,4332,5081,1806,10388,10532,2007,57,23111,0,0,0,0,1005,3197,4202
2019-07-03,3,4138,4966,1749,10070,10087,1930,54,22268,0,0,0,0,978,3129,4107
2019-07-03,4,4002,4939,1727,9940,9861,1902,53,21883,0,0,0,0,942,3016,3958
2019-07-03,5,3985,5040,1773,10055,9971,1916,53,22123,0,0,0,0,910,2904,3814
2019-07-03,6,3975,5209,1918,10501,10411,2029,55,23123,2,53,1,56,827,2763,3590
2019-07-03,7,4034,5483,2132,11014,10868,2165,57,24232,230,1407,176,1813,747,2589,3336
2019-07-03,8,4278,5843,2278,11482,11641,2301,63,25619,853,4206,757,5816,623,2362,2985
2019-07-03,9,4572,6154,2358,11468,12115,2363,68,26142,1179,6036,1233,8448,522,2229,2751
2019-07-03,10,4874,6437,2422,11316,12493,2336,75,26347,1313,6718,1500,9531,424,2129,2553
2019-07-03,11,5191,6676,2474,11185,12841,2246,81,26479,1365,7149,1656,10170,334,2049,2383
2019-07-03,12,5458,6851,2509,11121,13163,2140,87,26637,1404,7382,1718,10504,354,2221,2575
2019-07-03,13,5699,7034,2557,11181,13488,2119,93,27007,1446,7366,1765,10577,420,2521,2941
2019-07-03,14,5909,7203,2597,11510,13926,2141,96,27799,1449,7303,1766,10518,482,2789,3271
2019-07-03,15,6168,7320,2633,12019,14457,2211,100,28902,1448,7234,1761,10443,619,2980,3599
2019-07-03,16,6410,7425,2679,12568,14828,2300,103,29916,1440,6942,1731,10113,752,3132,3884
2019-07-03,17,6527,7449,2719,13186,15156,2418,106,30990,1408,6352,1587,9347,893,3248,4141
2019-07-03,18,6584,7419,2791,13816,15126,2596,104,31751,1320,5405,1364,8089,950,3242,4192
2019-07-03,19,6486,7201,2722,14195,14918,2636,102,31976,1020,3413,893,5326,987,3209,4196
2019-07-03,20,6242,6952,2661,14193,14479,2610,95,31503,380,862,268,1510,1030,3128,4158
2019-07-03,21,6069,6839,2565,13900,14316,2657,88,31086,15,74,6,95,1063,3125,4188
2019-07-03,22,5768,6468,2496,13616,13830,2592,81,30244,0,0,0,0,1108,3115,4223
2019-07-03,23,5329,5974,2301,12600,12791,2382,72,27970,0,0,0,0,1140,3112,4252
2019-07-03,24,4908,5540,2080,11611,11795,2166,65,25762,0,0,0,0,1119,3109,4228
2019-07-04,1,4618,5071,1839,11017,10754,2090,60,24048,0,0,0,0,1061,3087,4148
2019-07-04,2,4340,4870,1735,10504,10142,1990,57,22820,0,0,0,0,998,3106,4104
2019-07-04,3,4140,4735,1666,10134,9825,1921,54,22061,0,0,0,0,947,3061,4008
2019-07-04,4,3985,4686,1636,9921,9582,1866,53,21549,0,0,0,0,892,2976,3868
2019-07-04,5,3933,4716,1653,9956,9537,1853,53,21526,0,0,0,0,835,2867,3702
2019-07-04,6,3855,4738,1689,10118,9474,1890,53,21661,3,77,2,82,750,2697,3447
2019-07-04,7,3810,4890,1767,10098,9415,1948,55,21644,292,1552,236,2080,681,2480,3161
2019-07-04,8,4024,5112,1871,10117,9558,1963,60,21829,1040,4430,927,6397,614,2215,2829
2019-07-04,9,4332,5334,2026,10106,9718,1977,65,21996,1340,6265,1403,9008,525,2065,2590
2019-07-04,10,4664,5595,2145,9980,9923,1940,70,22043,1419,6978,1630,10027,431,1888,2319
2019-07-04,11,4984,5843,2200,9869,10228,1850,75,22149,1448,7400,1769,10617,347,1778,2125
2019-07-04,12,5294,6059,2232,9950,10546,1774,82,22477,1464,7605,1803,10872,298,1828,2126
2019-07-04,13,5586,6224,2300,10138,10965,1726,88,23042,1472,7646,1805,10923,271,1936,2207
2019-07-04,14,5880,6379,2364,10491,11499,1733,92,23942,1472,7632,1804,10908,259,2056,2315
2019-07-04,15,6143,6542,2420,11111,12094,1779,96,25207,1468,7555,1798,10821,324,2318,2642
2019-07-04,16,6423,6667,2472,11673,12606,1885,100,26390,1455,7292,1754,10501,406,2547,2953
2019-07-04,17,6642,6693,2530,12338,13088,2022,102,27676,1423,6765,1606,9794,502,2727,3229
2019-07-04,18,6680,6684,2559,13068,13201,2260,102,28756,1338,5862,1390,8590,607,2779,3386
2019-07-04,19,6504,6444,2537,13591,13033,2421,98,29268,1023,3659,905,5587,702,2805,3507
2019-07-04,20,6206,6240,2470,13607,12562,2497,91,28883,383,944,271,1598,800,2784,3584
2019-07-04,21,5957,6016,2346,13257,12354,2497,82,28317,17,101,6,124,860,2805,3665
2019-07-04,22,5592,5753,2230,12910,12059,2393,75,27564,0,0,0,0,928,2792,3720
2019-07-04,23,5236,5590,2075,12392,11675,2289,70,26551,0,0,0,0,974,2762,3736
2019-07-04,24,4910,5270,1972,11718,11083,2143,63,25133,0,0,0,0,972,2689,3661
2019-07-05,1,4489,4885,1874,11195,10945,2019,59,24344,0,0,0,0,922,2711,3633
2019-07-05,2,4191,4725,1783,10650,10409,1903,55,23144,0,0,0,0,843,2603,3446
2019-07-05,3,3998,4651,1724,10251,10090,1822,53,22342,0,0,0,0,836,2428,3264
2019-07-05,4,3866,4653,1695,10051,9931,1787,51,21947,0,0,0,0,828,2245,3073
2019-07-05,5,3841,4762,1726,10182,10093,1817,51,22268,0,0,0,0,829,2039,2868
2019-07-05,6,3831,4910,1834,10573,10482,1927,51,23158,2,77,1,80,774,1740,2514
2019-07-05,7,3894,5170,2006,11103,11022,2056,55,24363,292,1465,233,1990,720,1403,2123
2019-07-05,8,4184,5471,2179,11670,11457,2156,59,25472,1049,4280,917,6246,654,1079,1733
2019-07-05,9,4529,5714,2281,11830,11758,2187,65,25975,1348,6157,1391,8896,578,681,1259
2019-07-05,10,4895,5912,2346,11783,12104,2069,70,26159,1422,6899,1629,9950,495,360,855
2019-07-05,11,5262,6090,2404,11800,12484,2014,77,26500,1454,7326,1765,10545,407,210,617
2019-07-05,12,5605,6237,2446,11905,12862,1994,83,26971,1469,7531,1800,10800,381,194,575
2019-07-05,13,5893,6404,2515,12075,13211,1991,89,27495,1473,7580,1809,10862,356,217,573
2019-07-05,14,6167,6574,2589,12526,13810,1978,93,28534,1472,7552,1809,10833,346,284,630
2019-07-05,15,6465,6708,2643,13124,14365,2035,97,29748,1467,7483,1802,10752,425,463,888
2019-07-05,16,6756,6799,2699,13751,14877,2165,99,31018,1455,7317,1760,10532,516,765,1281
2019-07-05,17,6887,6856,2756,14457,15285,2275,101,32244,1422,6812,1613,9847,609,1186,1795
2019-07-05,18,6891,6861,2762,15020,15263,2391,102,32901,1337,5923,1395,8655,688,1555,2243
2019-07-05,19,6774,6649,2681,15375,15075,2469,98,33144,1025,3683,914,5622,747,1827,2574
2019-07-05,20,6499,6410,2581,15255,14586,2493,92,32552,385,972,275,1632,805,2077,2882
2019-07-05,21,6265,6299,2449,14899,14330,2560,85,32000,19,115,6,140,845,2166,3011
2019-07-05,22,5970,6016,2380,14581,13928,2522,78,31237,0,0,0,0,891,2188,3079
2019-07-05,23,5543,5577,2211,13568,12908,2361,71,29032,0,0,0,0,920,2178,3098
2019-07-05,24,5125,5183,2008,12500,11886,2141,64,26717,0,0,0,0,909,2087,2996
2019-07-06,1,4735,4926,1874,11296,11015,2030,60,24526,0,0,0,0,885,2034,2919
2019-07-06,2,4432,4772,1765,10723,10463,1912,55,23280,0,0,0,0,839,1919,2758
2019-07-06,3,4213,4683,1693,10289,10001,1838,53,22308,0,0,0,0,837,1760,2597
2019-07-06,4,4046,4642,1647,10038,9754,1800,52,21769,0,0,0,0,829,1600,2429
2019-07-06,5,3940,4660,1639,10005,9701,1801,51,21685,0,0,0,0,819,1451,2270
2019-07-06,6,3854,4647,1661,10156,9748,1838,51,21920,4,79,1,84,772,1202,1974
2019-07-06,7,3809,4775,1704,10322,9896,1846,54,22244,284,1548,249,2081,720,928,1648
2019-07-06,8,4077,5074,1847,10385,10058,1886,58,22515,1037,4444,964,6445,653,687,1340
2019-07-06,9,4452,5342,1993,10556,10419,1895,64,23064,1352,6310,1425,9087,526,382,908
2019-07-06,10,4838,5626,2093,10587,10778,1854,70,23419,1421,7011,1661,10093,402,176,578
2019-07-06,11,5230,5871,2167,10649,11129,1807,76,23792,1451,7443,1795,10689,282,116,398
2019-07-06,12,5580,6077,2230,10780,11476,1767,82,24236,1464,7663,1822,10949,272,140,412
2019-07-06,13,5875,6284,2281,11055,11916,1749,88,24938,1464,7700,1824,10988,285,187,472
2019-07-06,14,6140,6475,2330,11527,12410,1747,92,25903,1460,7685,1823,10968,319,277,596
2019-07-06,15,6388,6658,2374,12156,13022,1778,95,27177,1456,7611,1815,10882,432,486,918
2019-07-06,16,6611,6842,2436,12898,13592,1892,99,28607,1427,7358,1773,10558,562,831,1393
2019-07-06,17,6736,6962,2522,13670,14084,2025,101,30006,1384,6842,1621,9847,702,1267,1969
2019-07-06,18,6755,6987,2513,14373,14259,2195,103,31055,1290,5956,1405,8651,818,1570,2388
2019-07-06,19,6631,6868,2469,14830,14154,2325,99,31534,896,3646,890,5432,912,1880,2792
2019-07-06,20,6357,6563,2385,14790,13753,2358,92,31119,315,893,257,1465,1008,2089,3097
2019-07-06,21,6162,6422,2263,14410,13589,2439,85,30647,13,52,5,70,1061,2182,3243
2019-07-06,22,5865,6098,2224,14015,13228,2404,77,29848,0,0,0,0,1113,2241,3354
2019-07-06,23,5447,5670,2100,13148,12422,2286,70,28051,0,0,0,0,1160,2291,3451
2019-07-06,24,5057,5280,1925,12158,11506,2117,64,25969,0,0,0,0,1157,2209,3366
2019-07-07,1,4664,5005,1792,11030,10778,2004,60,23998,0,0,0,0,1123,2051,3174
2019-07-07,2,4384,4830,1696,10458,10217,1895,56,22753,0,0,0,0,1094,1986,3080
2019-07-07,3,4175,4710,1626,10031,9785,1829,54,21825,0,0,0,0,1061,1955,3016
2019-07-07,4,4024,4646,1590,9740,9517,1794,53,21230,0,0,0,0,1027,1942,2969
2019-07-07,5,3917,4616,1583,9630,9428,1789,52,21026,0,0,0,0,990,1907,2897
2019-07-07,6,3835,4529,1587,9628,9358,1822,51,20985,1,31,1,33,931,1779,2710
2019-07-07,7,3781,4667,1608,9526,9234,1821,53,20759,201,1129,196,1526,862,1638,2500
2019-07-07,8,4018,5001,1716,9506,9375,1912,58,20979,786,3744,825,5355,798,1499,2297
2019-07-07,9,4354,5274,1884,9563,9613,1980,64,21348,1063,5538,1320,7921,729,1380,2109
2019-07-07,10,4697,5543,1993,9550,9791,2024,71,21563,1151,6339,1539,9029,649,1241,1890
2019-07-07,11,5051,5771,2042,9512,10049,1879,78,21645,1169,6780,1661,9610,568,1169,1737
2019-07-07,12,5395,6032,2086,9543,10246,1706,84,21703,1181,7072,1705,9958,587,1364,1951
2019-07-07,13,5685,6251,2146,9740,10631,1677,90,22260,1170,7170,1709,10049,621,1673,2294
2019-07-07,14,5929,6473,2197,10057,11121,1714,95,23114,1147,7105,1702,9954,671,1971,2642
2019-07-07,15,6175,6655,2236,10600,11727,1781,99,24334,1177,7019,1670,9866,786,2254,3040
2019-07-07,16,6378,6824,2301,11302,12343,1906,102,25779,1191,6701,1585,9477,896,2517,3413
2019-07-07,17,6497,6936,2388,12016,12881,2084,104,27211,1182,6059,1426,8667,1001,2726,3727
2019-07-07,18,6487,6965,2469,12805,13273,2252,102,28556,1092,5146,1223,7461,1074,2775,3849
2019-07-07,19,6368,6782,2434,13427,13300,2388,99,29339,833,3069,811,4713,1137,2762,3899
2019-07-07,20,6133,6520,2389,13509,12922,2423,93,29073,288,695,232,1215,1185,2685,3870
2019-07-07,21,5993,6407,2301,13363,12856,2493,86,28925,8,13,4,25,1192,2573,3765
2019-07-07,22,5735,6070,2264,13095,12557,2446,79,28304,0,0,0,0,1207,2588,3795
2019-07-07,23,5331,5624,2105,12170,11748,2277,72,26391,0,0,0,0,1199,2589,3788
2019-07-07,24,4943,5240,1910,11226,10899,2087,65,24402,0,0,0,0,1163,2566,3729
2019-07-08,1,4618,4990,1791,10570,10266,1934,60,22956,0,0,0,0,1161,2631,3792
2019-07-08,2,4354,4821,1712,10088,9817,1861,56,21950,0,0,0,0,1118,2608,3726
2019-07-08,3,4163,4736,1667,9809,9511,1811,54,21313,0,0,0,0,1064,2619,3683
2019-07-08,4,4035,4747,1653,9676,9396,1792,53,21045,0,0,0,0,1001,2627,3628
2019-07-08,5,4008,4870,1704,9873,9590,1840,53,21483,0,0,0,0,934,2634,3568
2019-07-08,6,4004,5057,1837,10379,10115,1945,54,22620,1,42,1,44,877,2521,3398
2019-07-08,7,4065,5354,2057,10947,10646,2067,57,23842,236,1373,177,1786,817,2362,3179
2019-07-08,8,4310,5708,2233,11440,11246,2216,62,25090,981,4282,802,6065,744,2195,2939
2019-07-08,9,4595,6010,2335,11541,11626,2287,68,25648,1306,6199,1329,8834,701,2112,2813
2019-07-08,10,4895,6276,2412,11369,11889,2211,73,25670,1388,6926,1588,9902,653,1976,2629
2019-07-08,11,5205,6501,2476,11198,12122,2106,79,25632,1417,7364,1747,10528,598,1861,2459
2019-07-08,12,5506,6681,2517,11005,12310,2055,84,25581,1435,7582,1785,10802,620,1975,2595
2019-07-08,13,5763,6844,2589,11000,12485,2045,89,25745,1456,7625,1787,10868,641,2142,2783
2019-07-08,14,5976,6970,2652,11200,12865,2071,92,26352,1456,7622,1787,10865,685,2308,2993
2019-07-08,15,6151,7050,2698,11553,13297,2065,95,27134,1450,7545,1775,10770,792,2545,3337
2019-07-08,16,6298,7084,2748,12135,13736,2153,97,28245,1395,7286,1704,10385,899,2739,3638
2019-07-08,17,6364,7085,2792,12791,14136,2272,96,29420,1344,6766,1545,9655,1006,2908,3914
2019-07-08,18,6376,6991,2851,13394,14317,2424,96,30355,1229,5851,1299,8379,1044,2928,3972
2019-07-08,19,6294,6774,2797,13956,14216,2502,93,30893,852,3378,795,5025,1065,2910,3975
2019-07-08,20,6074,6538,2731,13978,13907,2531,88,30630,253,728,202,1183,1084,2863,3947
2019-07-08,21,5912,6469,2622,13783,13897,2610,82,30498,4,64,2,70,1067,2840,3907
2019-07-08,22,5616,6108,2531,13535,13482,2519,75,29735,0,0,0,0,1062,2791,3853
2019-07-08,23,5218,5637,2324,12553,12509,2310,67,27563,0,0,0,0,1038,2730,3768
2019-07-08,24,4818,5251,2095,11575,11536,2104,62,25403,0,0,0,0,1002,2762,3764
2019-07-09,1,4433,4961,1919,10815,10748,1990,58,23740,0,0,0,0,935,2618,3553
2019-07-09,2,4179,4805,1821,10310,10204,1912,55,22613,0,0,0,0,859,2574,3433
2019-07-09,3,3994,4719,1762,9992,9903,1845,53,21924,0,0,0,0,837,2483,3320
2019-07-09,4,3874,4714,1733,9849,9751,1824,52,21608,0,0,0,0,811,2346,3157
2019-07-09,5,3862,4844,1768,9988,9904,1851,52,21927,0,0,0,0,785,2207,2992
2019-07-09,6,3867,5006,1896,10475,10363,1947,53,22967,1,40,0,41,752,1901,2653
2019-07-09,7,3925,5277,2089,11050,10909,2083,56,24229,231,1303,185,1719,724,1525,2249
2019-07-09,8,4182,5585,2268,11533,11545,2209,60,25475,964,4184,836,5984,702,1149,1851
2019-07-09,9,4491,5838,2357,11584,11850,2256,66,25886,1291,6105,1377,8773,607,755,1362
2019-07-09,10,4814,6064,2424,11457,12111,2188,72,25961,1372,6826,1625,9823,545,450,995
2019-07-09,11,5157,6282,2474,11380,12404,2085,77,26077,1404,7287,1772,10463,477,275,752
2019-07-09,12,5469,6460,2532,11302,12731,2013,83,26259,1420,7485,1808,10713,463,298,761
2019-07-09,13,5750,6657,2608,11406,13089,1961,88,26673,1425,7507,1811,10743,480,376,856
2019-07-09,14,6016,6836,2674,11739,13650,1977,92,27589,1423,7472,1810,10705,485,523,1008
2019-07-09,15,6322,6978,2710,12174,14191,2013,95,28602,1417,7388,1802,10607,582,726,1308
2019-07-09,16,6584,7098,2750,12856,14674,2091,98,29845,1401,7122,1764,10287,688,962,1650
2019-07-09,17,6722,7154,2824,13586,14979,2199,100,30990,1363,6601,1615,9579,810,1243,2053
2019-07-09,18,6765,7134,2794,14214,15146,2375,101,31962,1270,5671,1384,8325,884,1503,2387
2019-07-09,19,6681,7015,2752,14673,15030,2470,98,32396,921,3434,885,5240,941,1767,2708
2019-07-09,20,6401,6694,2684,14781,14592,2554,93,32144,268,778,230,1276,989,2028,3017
2019-07-09,21,6211,6573,2582,14514,14396,2628,85,31749,7,84,3,94,1014,2180,3194
2019-07-09,22,5878,6192,2516,14189,13867,2542,78,30801,0,0,0,0,1039,2256,3295
2019-07-09,23,5422,5702,2324,13113,12933,2340,70,28582,0,0,0,0,1058,2286,3344
2019-07-09,24,4980,5295,2108,12073,11889,2145,63,26297,0,0,0,0,1009,2255,3264
2019-07-10,1,4686,5127,1990,11332,11010,2024,60,24553,0,0,0,0,897,2114,3011
2019-07-10,2,4402,4964,1892,10788,10354,1932,57,23258,0,0,0,0,836,2014,2850
2019-07-10,3,4196,4858,1828,10421,9945,1877,54,22425,0,0,0,0,811,1886,2697
2019-07-10,4,4049,4860,1795,10209,9760,1844,53,21994,0,0,0,0,780,1726,2506
2019-07-10,5,4012,4989,1827,10322,9868,1866,54,22240,0,0,0,0,745,1524,2269
2019-07-10,6,3998,5161,1949,10778,10387,1981,55,23327,1,50,0,51,726,1185,1911
2019-07-10,7,4063,5438,2135,11368,10939,2097,58,24589,225,1353,180,1758,705,883,1588
2019-07-10,8,4359,5771,2318,11782,11549,2201,63,25726,944,4294,821,6059,648,596,1244
2019-07-10,9,4713,6074,2418,11884,12052,2223,69,26359,1268,6246,1367,8881,629,326,955
2019-07-10,10,5088,6351,2491,11843,12472,2159,75,26679,1349,6960,1626,9935,603,147,750
2019-07-10,11,5481,6617,2563,11870,12973,2108,81,27162,1386,7392,1772,10550,564,119,683
2019-07-10,12,5827,6852,2634,11995,13521,2108,88,27842,1404,7590,1808,10802,547,146,693
2019-07-10,13,6166,7119,2722,12156,14090,2118,94,28591,1432,7629,1818,10879,570,191,761
2019-07-10,14,6483,7339,2808,12595,14865,2163,99,29850,1430,7621,1817,10868,577,298,875
2019-07-10,15,6834,7523,2877,13173,15598,2239,103,31240,1427,7545,1806,10778,644,511,1155
2019-07-10,16,7133,7676,2934,13813,16198,2329,106,32573,1406,7248,1779,10433,718,873,1591
2019-07-10,17,7260,7729,2994,14541,16728,2437,107,33940,1359,6789,1624,9772,801,1353,2154
2019-07-10,18,7288,7730,3020,15129,16769,2581,108,34712,1261,5867,1400,8528,849,1625,2474
2019-07-10,19,7204,7519,2969,15498,16482,2620,105,34830,935,3505,886,5326,886,1879,2765
2019-07-10,20,6898,7197,2886,15517,15854,2674,98,34267,273,800,225,1298,919,2103,3022
2019-07-10,21,6680,7027,2762,15119,15524,2731,90,33589,8,104,1,113,948,2152,3100
2019-07-10,22,6294,6601,2672,14682,14921,2640,82,32449,0,0,0,0,975,2124,3099
2019-07-10,23,5799,6043,2443,13458,13679,2417,74,29752,0,0,0,0,984,2076,3060
2019-07-10,24,5321,5600,2202,12306,12498,2199,66,27195,0,0,0,0,943,2012,2955
2019-07-11,1,4963,5434,2030,11629,11747,2130,62,25693,0,0,0,0,903,2130,3033
2019-07-11,2,4657,5251,1919,11090,11145,2026,58,24447,0,0,0,0,841,2058,2899
2019-07-11,3,4429,5134,1849,10697,10725,1961,56,23567,0,0,0,0,820,1963,2783
2019-07-11,4,4276,5115,1816,10498,10481,1912,54,23078,0,0,0,0,797,1831,2628
2019-07-11,5,4235,5223,1847,10619,10572,1933,55,23311,0,0,0,0,768,1679,2447
2019-07-11,6,4219,5385,1965,11069,11034,2042,57,24330,2,45,1,48,709,1431,2140
2019-07-11,7,4282,5654,2147,11612,11537,2154,59,25490,241,1202,186,1629,633,1149,1782
2019-07-11,8,4586,6039,2332,12121,12153,2264,65,26731,1006,4036,855,5897,542,914,1456
2019-07-11,9,4973,6392,2434,12229,12642,2313,71,27384,1336,5988,1408,8732,477,619,1096
2019-07-11,10,5384,6720,2517,12243,13163,2313,78,27927,1415,6597,1660,9672,420,360,780
2019-07-11,11,5811,7025,2602,12371,13824,2318,85,28730,1445,7015,1793,10253,363,238,601
2019-07-11,12,6207,7289,2675,12526,14588,2326,93,29662,1461,7154,1820,10435,356,278,634
2019-07-11,13,6581,7574,2766,12813,15343,2362,100,30748,1467,7037,1822,10326,377,356,733
2019-07-11,14,6927,7813,2859,13364,16356,2444,105,32398,1464,6944,1824,10232,400,492,892
2019-07-11,15,7279,7975,2923,13972,17095,2549,109,33849,1463,6814,1815,10092,506,752,1258
2019-07-11,16,7549,8110,2984,14697,17823,2691,112,35446,1445,6568,1797,9810,626,1174,1800
2019-07-11,17,7638,8151,3038,15428,18380,2828,114,36874,1408,6052,1639,9099,756,1628,2384
2019-07-11,18,7642,8003,3070,15931,18408,2941,114,37519,1314,5185,1417,7916,831,1942,2773
2019-07-11,19,7531,7803,3004,16241,18084,2941,110,37500,963,3109,896,4968,899,2198,3097
2019-07-11,20,7212,7462,2911,16118,17304,2885,102,36534,282,713,221,1216,962,2369,3331
2019-07-11,21,6973,7279,2786,15673,16862,2916,94,35671,10,103,1,114,972,2413,3385
2019-07-11,22,6580,6856,2686,15114,16081,2816,86,34220,0,0,0,0,1018,2368,3386
2019-07-11,23,6061,6297,2468,13890,14698,2568,76,31357,0,0,0,0,1018,2290,3308
2019-07-11,24,5580,5836,2225,12716,13375,2334,69,28620,0,0,0,0,984,2198,3182
2019-07-12,1,5175,5557,2084,11979,12475,2199,64,26842,0,0,0,0,926,2245,3171
2019-07-12,2,4851,5344,1962,11330,11639,2085,60,25241,0,0,0,0,866,2103,2969
2019-07-12,3,4611,5213,1882,10859,11086,2006,58,24134,0,0,0,0,863,1966,2829
2019-07-12,4,4455,5182,1844,10612,10779,1959,56,23531,0,0,0,0,856,1820,2676
2019-07-12,5,4398,5264,1867,10708,10842,1984,56,23716,0,0,0,0,843,1630,2473
2019-07-12,6,4364,5397,1961,11126,11262,2091,58,24662,2,35,1,38,793,1337,2130
2019-07-12,7,4420,5669,2116,11644,11801,2190,61,25821,233,1012,180,1425,740,1026,1766
2019-07-12,8,4727,6073,2311,12198,12582,2296,66,27275,987,3628,847,5462,684,751,1435
2019-07-12,9,5099,6467,2439,12326,13309,2352,72,28194,1328,5472,1393,8193,590,462,1052
2019-07-12,10,5514,6827,2546,12402,14155,2351,79,29122,1417,6210,1644,9271,487,235,722
2019-07-12,11,5929,7143,2644,12561,15099,2363,87,30245,1446,6501,1775,9722,386,171,557
2019-07-12,12,6325,7396,2725,12788,16097,2389,95,31497,1462,6761,1798,10021,350,204,554
2019-07-12,13,6676,7668,2814,13185,17055,2446,103,32916,1467,6890,1802,10159,327,274,601
2019-07-12,14,6984,7872,2905,13855,18110,2529,109,34730,1465,6901,1800,10166,325,383,708
2019-07-12,15,7285,8023,2978,14676,18937,2634,114,36487,1464,6875,1796,10135,410,571,981
2019-07-12,16,7515,8086,3039,15523,19635,2776,117,38175,1446,6666,1774,9886,510,874,1384
2019-07-12,17,7560,8129,3096,16333,20118,2903,119,39597,1411,6160,1646,9217,624,1302,1926
2019-07-12,18,7562,7961,3108,16836,19913,3013,118,40006,1320,5385,1421,8126,722,1659,2381
2019-07-12,19,7427,7701,3011,17016,19390,3013,114,39660,963,3253,896,5112,816,1913,2729
2019-07-12,20,7134,7345,2902,16757,18394,2947,106,38331,277,671,212,1160,906,2128,3034
2019-07-12,21,6931,7183,2762,16234,17847,2964,98,37270,10,5,1,16,952,2155,3107
2019-07-12,22,6593,6839,2679,15684,17028,2867,89,35794,0,0,0,0,989,2095,3084
2019-07-12,23,6142,6344,2483,14542,15679,2653,80,33078,0,0,0,0,1014,2016,3030
2019-07-12,24,5697,5885,2243,13369,14342,2428,72,30338,0,0,0,0,978,1892,2870
2019-07-13,1,5370,5505,2024,12360,13028,2269,67,27863,0,0,0,0,966,1975,2941
2019-07-13,2,5029,5288,1884,11656,12119,2145,63,26123,0,0,0,0,921,1850,2771
2019-07-13,3,4787,5142,1803,11140,11478,2054,60,24861,0,0,0,0,888,1705,2593
2019-07-13,4,4593,5070,1759,10785,11032,1998,58,24000,0,0,0,0,857,1545,2402
2019-07-13,5,4462,5057,1754,10704,10867,1973,58,23730,0,0,0,0,827,1401,2228
2019-07-13,6,4344,5031,1769,10789,10874,2018,58,23866,2,20,1,23,794,1150,1944
2019-07-13,7,4300,5206,1813,10878,10856,2033,60,23954,224,1083,177,1484,757,918,1675
2019-07-13,8,4572,5571,1946,11066,11294,2094,65,24648,968,3974,846,5788,713,711,1424
2019-07-13,9,4984,5975,2090,11424,11857,2150,72,25627,1333,5931,1405,8669,614,476,1090
2019-07-13,10,5440,6335,2234,11737,12684,2175,80,26802,1420,6701,1658,9779,511,293,804
2019-07-13,11,5886,6657,2339,12078,13745,2193,89,28228,1448,7138,1789,10375,411,254,665
2019-07-13,12,6282,6920,2423,12451,14805,2236,97,29714,1463,7332,1815,10610,394,332,726
2019-07-13,13,6628,7151,2497,12921,15891,2292,105,31333,1466,7292,1818,10576,377,460,837
2019-07-13,14,6937,7316,2563,13539,16814,2349,111,32938,1462,7242,1816,10520,387,649,1036
2019-07-13,15,7199,7455,2627,14263,17542,2428,115,34473,1462,7147,1811,10420,466,831,1297
2019-07-13,16,7385,7610,2692,15077,18228,2574,118,36123,1443,6820,1783,10046,563,1075,1638
2019-07-13,17,7453,7617,2778,15701,18571,2719,121,37237,1407,6347,1625,9379,682,1327,2009
2019-07-13,18,7414,7556,2777,16277,18582,2840,119,37943,1310,5470,1402,8182,748,1424,2172
2019-07-13,19,7244,7346,2718,16462,18161,2914,115,37776,951,3190,880,5021,819,1548,2367
2019-07-13,20,6948,7012,2633,16292,17245,2869,107,36637,271,635,205,1111,890,1644,2534
2019-07-13,21,6737,6863,2515,15727,16690,2894,99,35536,9,4,1,14,942,1673,2615
2019-07-13,22,6400,6523,2452,15245,15975,2801,90,34238,0,0,0,0,986,1704,2690
2019-07-13,23,5970,6082,2286,14278,14956,2604,82,32048,0,0,0,0,1021,1723,2744
2019-07-13,24,5559,5669,2084,13166,13862,2393,74,29630,0,0,0,0,997,1744,2741
2019-07-14,1,5201,5393,1903,11991,12498,2196,68,26881,0,0,0,0,1029,1449,2478
2019-07-14,2,4903,5183,1789,11274,11621,2072,64,25153,0,0,0,0,992,1420,2412
2019-07-14,3,4652,5054,1722,10751,11026,1985,61,23945,0,0,0,0,989,1316,2305
2019-07-14,4,4480,4979,1681,10424,10603,1933,59,23138,0,0,0,0,987,1221,2208
2019-07-14,5,4348,4937,1666,10294,10379,1923,58,22775,0,0,0,0,985,1131,2116
2019-07-14,6,4234,4899,1669,10274,10245,1939,58,22638,1,20,1,22,958,931,1889
2019-07-14,7,4166,5021,1689,10087,10034,1933,59,22231,208,1143,168,1519,916,807,1723
2019-07-14,8,4390,5375,1801,10073,10259,1969,64,22494,947,4026,831,5804,890,673,1563
2019-07-14,9,4772,5736,1936,10330,10761,2000,72,23291,1318,5944,1379,8641,826,566,1392
2019-07-14,10,5193,6071,2061,10565,11494,2007,80,24274,1414,6720,1626,9760,745,475,1220
2019-07-14,11,5636,6366,2167,10830,12388,2019,89,25453,1442,7155,1776,10373,667,455,1122
2019-07-14,12,6058,6681,2252,11174,13332,2059,98,26793,1455,7375,1798,10628,664,558,1222
2019-07-14,13,6422,6950,2328,11698,14334,2118,105,28384,1460,7410,1801,10671,654,755,1409
2019-07-14,14,6743,7196,2396,12303,15475,2220,111,30247,1459,7421,1801,10681,658,1004,1662
2019-07-14,15,7034,7391,2455,13021,16398,2343,116,32010,1459,7314,1795,10568,722,1339,2061
2019-07-14,16,7235,7547,2520,13818,17157,2496,119,33720,1441,6950,1769,10160,791,1713,2504
2019-07-14,17,7325,7611,2618,14730,17707,2679,121,35364,1404,6478,1618,9500,874,2108,2982
2019-07-14,18,7278,7570,2660,15544,17994,2846,121,36632,1305,5552,1389,8246,913,2264,3177
2019-07-14,19,7103,7354,2635,15981,17734,2949,116,36902,947,3339,858,5144,940,2369,3309
2019-07-14,20,6805,7060,2569,15861,16867,2916,108,35868,268,691,200,1159,960,2411,3371
2019-07-14,21,6614,6946,2479,15406,16248,2941,100,34817,8,5,1,14,990,2502,3492
2019-07-14,22,6300,6569,2418,14881,15453,2829,91,33382,0,0,0,0,1016,2592,3608
2019-07-14,23,5857,6076,2241,13723,14133,2587,83,30651,0,0,0,0,1044,2643,3687
2019-07-14,24,5419,5664,2026,12504,12977,2353,75,28036,0,0,0,0,1025,2661,3686
2019-07-15,1,5021,5317,1864,11686,11908,2144,67,25934,0,0,0,0,880,2341,3221
2019-07-15,2,4715,5150,1760,11051,11172,2041,63,24457,0,0,0,0,855,2299,3154
2019-07-15,3,4495,5050,1702,10647,10748,1978,60,23563,0,0,0,0,830,2251,3081
2019-07-15,4,4327,5049,1685,10481,10487,1946,59,23103,0,0,0,0,806,2192,2998
2019-07-15,5,4285,5163,1734,10590,10610,1984,59,23373,0,0,0,0,773,2113,2886
2019-07-15,6,4283,5342,1863,11057,11041,2095,61,24385,1,21,1,23,734,1973,2707
2019-07-15,7,4307,5623,2047,11710,11561,2220,63,25686,202,1183,159,1544,699,1810,2509
2019-07-15,8,4566,6020,2250,12306,12401,2361,69,27258,941,4159,823,5923,644,1606,2250
2019-07-15,9,4906,6400,2364,12541,13085,2442,77,28270,1318,6210,1371,8899,552,1486,2038
2019-07-15,10,5282,6742,2457,12679,13822,2472,84,29183,1413,6983,1620,10016,462,1369,1831
2019-07-15,11,5671,7049,2547,12961,14669,2496,92,30344,1443,7397,1768,10608,383,1320,1703
2019-07-15,12,6054,7312,2611,13316,15572,2542,100,31658,1457,7593,1794,10844,442,1472,1914
2019-07-15,13,6424,7561,2690,13761,16483,2611,107,33088,1462,7640,1798,10900,510,1726,2236
2019-07-15,14,6752,7742,2760,14452,17470,2703,112,34865,1460,7625,1798,10883,602,2018,2620
2019-07-15,15,7054,7875,2805,15134,18314,2829,115,36524,1455,7547,1792,10794,694,2373,3067
2019-07-15,16,7246,7953,2838,15876,18892,2984,117,38000,1438,7275,1763,10476,779,2662,3441
2019-07-15,17,7286,7931,2861,16510,19313,3125,118,39194,1409,6789,1618,9816,875,2895,3770
2019-07-15,18,7229,7866,2886,17079,19374,3252,115,39947,1309,5802,1391,8502,954,3001,3955
2019-07-15,19,7106,7600,2832,17296,19006,3259,112,39800,950,3479,854,5283,1006,3074,4080
2019-07-15,20,6803,7296,2769,17062,18216,3180,105,38692,267,730,202,1199,1046,3081,4127
2019-07-15,21,6582,7147,2663,16404,17745,3173,97,37547,7,6,1,14,1071,3107,4178
2019-07-15,22,6193,6705,2578,15672,16837,3019,88,35743,0,0,0,0,1098,3131,4229
2019-07-15,23,5736,6162,2370,14248,15380,2736,79,32570,0,0,0,0,1118,3126,4244
2019-07-15,24,5277,5709,2140,12919,13941,2465,72,29524,0,0,0,0,1095,3127,4222
2019-07-16,1,4947,5414,1964,11887,12560,2222,66,26862,0,0,0,0,1019,3268,4287
2019-07-16,2,4640,5204,1855,11275,11786,2097,62,25350,0,0,0,0,974,3219,4193
2019-07-16,3,4423,5074,1789,10873,11276,2031,59,24369,0,0,0,0,951,3143,4094
2019-07-16,4,4261,5040,1758,10634,10976,1986,58,23780,0,0,0,0,923,3045,3968
2019-07-16,5,4218,5146,1789,10710,11024,2003,58,23921,0,0,0,0,880,2926,3806
2019-07-16,6,4197,5283,1912,11164,11392,2120,59,24862,0,21,0,21,781,2766,3547
2019-07-16,7,4245,5592,2097,11766,11849,2240,61,26048,193,1151,158,1502,698,2552,3250
2019-07-16,8,4512,5949,2278,12233,12549,2368,67,27344,925,4144,816,5885,594,2302,2896
2019-07-16,9,4861,6295,2381,12309,13183,2423,74,28116,1308,6197,1381,8886,486,2073,2559
2019-07-16,10,5235,6616,2458,12334,13852,2424,82,28818,1407,6975,1645,10027,385,1798,2183
2019-07-16,11,5618,6899,2519,12480,14618,2431,90,29744,1437,7389,1786,10612,294,1579,1873
2019-07-16,12,5975,7130,2587,12714,15404,2452,97,30793,1452,7591,1815,10858,288,1702,1990
2019-07-16,13,6323,7356,2667,13093,16175,2491,104,31991,1459,7640,1818,10917,337,1940,2277
2019-07-16,14,6636,7536,2736,13768,17084,2581,110,33668,1456,7629,1817,10902,419,2218,2637
2019-07-16,15,6951,7661,2788,14362,17803,2698,114,35105,1453,7553,1812,10818,540,2475,3015
2019-07-16,16,7188,7766,2832,15096,18307,2818,116,36470,1437,7270,1781,10488,677,2556,3233
2019-07-16,17,7267,7778,2904,15739,18664,2940,118,37590,1402,6789,1629,9820,812,2666,3478
2019-07-16,18,7238,7702,2903,16180,18629,3046,117,38100,1305,5786,1386,8477,907,2687,3594
2019-07-16,19,7136,7475,2859,16499,18211,3044,113,37994,952,3426,853,5231,983,2641,3624
2019-07-16,20,6844,7197,2782,16294,17445,2977,106,36950,261,734,203,1198,1053,2580,3633
2019-07-16,21,6637,7030,2672,15756,17064,2993,98,36039,4,29,1,34,1086,2652,3738
2019-07-16,22,6260,6607,2578,15127,16241,2862,89,34448,0,0,0,0,1124,2701,3825
2019-07-16,23,5775,6085,2372,13825,14831,2610,80,31478,0,0,0,0,1164,2756,3920
2019-07-16,24,5300,5642,2144,12609,13479,2370,71,28658,0,0,0,0,1154,2785,3939
2019-07-17,1,4992,5309,1984,11963,12432,2173,63,26758,0,0,0,0,1072,2900,3972
2019-07-17,2,4683,5106,1877,11358,11666,2054,59,25262,0,0,0,0,1031,2898,3929
2019-07-17,3,4469,4989,1812,10937,11164,1988,57,24270,0,0,0,0,985,2764,3749
2019-07-17,4,4312,4961,1781,10731,10864,1948,55,23722,0,0,0,0,956,2601,3557
2019-07-17,5,4263,5068,1814,10812,10910,1968,56,23869,0,0,0,0,916,2407,3323
2019-07-17,6,4265,5227,1939,11244,11320,2088,58,24832,0,14,0,14,810,2044,2854
2019-07-17,7,4280,5482,2120,11752,11718,2203,60,25860,170,1104,144,1418,718,1621,2339
2019-07-17,8,4537,5848,2299,12184,12382,2318,66,27075,845,4087,780,5712,624,1212,1836
2019-07-17,9,4881,6177,2404,12206,12945,2367,72,27715,1220,6150,1347,8717,485,897,1382
2019-07-17,10,5254,6485,2480,12182,13537,2348,78,28271,1329,6890,1610,9829,331,653,984
2019-07-17,11,5621,6759,2549,12260,14174,2321,85,28954,1372,7325,1756,10453,216,533,749
2019-07-17,12,5970,6982,2614,12439,14808,2308,93,29770,1393,7515,1786,10694,183,612,795
2019-07-17,13,6284,7216,2696,12806,15446,2316,100,30787,1400,7521,1770,10691,162,791,953
2019-07-17,14,6575,7403,2776,13421,16166,2378,104,32192,1400,7495,1765,10660,157,1020,1177
2019-07-17,15,6878,7548,2846,14126,16799,2469,108,33617,1392,7414,1760,10566,234,1237,1471
2019-07-17,16,7109,7667,2898,14899,17337,2570,111,35027,1369,7097,1723,10189,349,1467,1816
2019-07-17,17,7182,7694,2980,15703,17683,2695,113,36312,1315,6603,1565,9483,485,1664,2149
2019-07-17,18,7167,7642,2954,16260,17658,2814,112,36969,1186,5584,1325,8095,600,1716,2316
2019-07-17,19,7075,7426,2905,16623,17245,2837,107,36937,836,3315,817,4968,704,1768,2472
2019-07-17,20,6810,7135,2826,16425,16491,2788,100,35931,221,692,190,1103,769,1804,2573
2019-07-17,21,6607,6974,2718,15934,16150,2814,93,35119,2,22,1,25,810,1866,2676
2019-07-17,22,6238,6560,2626,15308,15396,2722,85,33637,0,0,0,0,845,1982,2827
2019-07-17,23,5754,6043,2410,14003,14099,2493,76,30796,0,0,0,0,869,2058,2927
2019-07-17,24,5289,5610,2171,12769,12862,2270,68,28098,0,0,0,0,880,1962,2842
2019-07-18,1,4895,5347,1983,12138,11796,2075,63,26191,0,0,0,0,890,1537,2427
2019-07-18,2,4588,5155,1873,11494,11084,1980,59,24736,0,0,0,0,867,1413,2280
2019-07-18,3,4367,5037,1808,10986,10616,1919,57,23698,0,0,0,0,842,1307,2149
2019-07-18,4,4229,5019,1777,10784,10369,1875,55,23203,0,0,0,0,811,1213,2024
2019-07-18,5,4186,5122,1810,10854,10470,1901,56,23399,0,0,0,0,773,1127,1900
2019-07-18,6,4195,5277,1934,11314,10896,2018,57,24405,0,11,0,11,732,1003,1735
2019-07-18,7,4222,5574,2116,11899,11344,2136,58,25558,156,1015,141,1312,692,885,1577
2019-07-18,8,4479,5925,2291,12472,11931,2246,64,26830,797,3872,766,5435,649,781,1430
2019-07-18,9,4823,6259,2394,12609,12301,2285,70,27383,1199,5877,1325,8401,547,737,1284
2019-07-18,10,5183,6576,2474,12607,12706,2248,77,27755,1318,6716,1600,9634,446,733,1179
2019-07-18,11,5550,6863,2540,12733,13298,2202,84,28432,1367,7110,1745,10222,353,769,1122
2019-07-18,12,5894,7099,2598,12917,13716,2163,91,28999,1399,7336,1772,10507,405,940,1345
2019-07-18,13,6235,7369,2674,13202,14211,2153,98,29780,1414,7403,1774,10591,467,1142,1609
2019-07-18,14,6528,7577,2741,13737,14854,2200,102,31011,1422,7369,1774,10565,551,1337,1888
2019-07-18,15,6826,7726,2798,14265,15507,2268,105,32263,1415,7312,1769,10496,681,1542,2223
2019-07-18,16,7038,7853,2837,14834,16042,2376,108,33479,1411,7060,1725,10196,824,1720,2544
2019-07-18,17,7099,7865,2896,15402,16288,2499,110,34418,1370,6557,1581,9508,947,1860,2807
2019-07-18,18,7083,7801,2861,15838,16302,2624,108,34991,1261,5561,1335,8157,1012,1906,2918
2019-07-18,19,6993,7549,2815,16086,16030,2661,104,35000,919,3224,814,4957,1057,1949,3006
2019-07-18,20,6729,7222,2734,15946,15360,2638,97,34160,247,658,187,1092,1111,1971,3082
2019-07-18,21,6548,7055,2628,15586,15117,2692,90,33605,3,29,1,33,1121,1995,3116
2019-07-18,22,6201,6641,2553,15005,14538,2604,83,32349,0,0,0,0,1141,2036,3177
2019-07-18,23,5732,6117,2365,13855,13391,2401,74,29841,0,0,0,0,1132,2081,3213
2019-07-18,24,5270,5671,2143,12683,12372,2194,67,27435,0,0,0,0,1088,2061,3149
2019-07-19,1,4862,5411,1931,11960,11411,2071,60,25622,0,0,0,0,997,2061,3058
2019-07-19,2,4556,5196,1825,11343,10747,1970,56,24235,0,0,0,0,947,2021,2968
2019-07-19,3,4346,5078,1758,10917,10329,1899,54,23318,0,0,0,0,905,1984,2889
2019-07-19,4,4197,5048,1726,10665,10087,1864,52,22788,0,0,0,0,857,1988,2845
2019-07-19,5,4155,5135,1757,10759,10211,1884,53,23026,0,0,0,0,824,1943,2767
2019-07-19,6,4153,5279,1884,11171,10668,1990,54,24001,0,12,0,12,761,1781,2542
2019-07-19,7,4176,5537,2061,11728,11108,2115,56,25125,180,1059,144,1383,704,1598,2302
2019-07-19,8,4433,5927,2211,12206,11651,2217,60,26254,891,3990,765,5646,632,1379,2011
2019-07-19,9,4764,6285,2325,12331,11958,2248,66,26723,1301,6023,1310,8634,531,1236,1767
2019-07-19,10,5126,6618,2407,12251,12260,2173,73,26875,1398,6800,1573,9771,427,1154,1581
2019-07-19,11,5487,6905,2462,12289,12658,2089,79,27235,1436,7202,1720,10358,329,1141,1470
2019-07-19,12,5837,7137,2493,12340,12962,2042,86,27549,1452,7447,1775,10674,324,1252,1576
2019-07-19,13,6168,7368,2533,12602,13356,2024,92,28194,1453,7509,1779,10741,335,1393,1728
2019-07-19,14,6454,7568,2579,13100,13879,2054,97,29249,1448,7514,1776,10738,357,1514,1871
2019-07-19,15,6722,7708,2620,13704,14432,2111,100,30466,1444,7446,1769,10659,472,1702,2174
2019-07-19,16,6920,7785,2653,14389,14907,2190,103,31707,1426,7183,1716,10325,634,1911,2545
2019-07-19,17,6972,7786,2693,15071,15258,2294,105,32847,1390,6691,1572,9653,811,2106,2917
2019-07-19,18,6918,7719,2730,15586,15257,2425,104,33490,1290,5672,1335,8297,884,2242,3126
2019-07-19,19,6808,7436,2660,15823,14993,2499,100,33533,937,3318,815,5070,970,2425,3395
2019-07-19,20,6549,7090,2570,15693,14457,2558,93,32920,251,680,182,1113,1045,2525,3570
2019-07-19,21,6380,6904,2469,15285,14229,2614,86,32334,2,29,0,31,1092,2569,3661
2019-07-19,22,6074,6563,2420,14805,13804,2545,79,31353,0,0,0,0,1118,2599,3717
2019-07-19,23,5652,6106,2257,13771,12880,2386,72,29228,0,0,0,0,1121,2617,3738
2019-07-19,24,5241,5661,2063,12619,11934,2193,65,26930,0,0,0,0,1101,2608,3709
2019-07-20,1,4888,5383,1937,11849,11443,2093,60,25565,0,0,0,0,1076,2402,3478
2019-07-20,2,4584,5151,1839,11240,10789,1983,56,24189,0,0,0,0,1031,2320,3351
2019-07-20,3,4368,4999,1771,10795,10311,1909,54,23190,0,0,0,0,1014,2243,3257
2019-07-20,4,4197,4919,1730,10512,10040,1861,52,22587,0,0,0,0,989,2179,3168
2019-07-20,5,4090,4895,1729,10440,10001,1862,52,22475,0,0,0,0,967,2094,3061
2019-07-20,6,4017,4861,1757,10548,10123,1904,53,22749,0,10,0,10,926,1877,2803
2019-07-20,7,3953,4948,1798,10576,9978,1915,54,22645,174,1055,142,1371,888,1654,2542
2019-07-20,8,4197,5304,1898,10696,10168,1968,58,23010,886,4049,788,5723,842,1424,2266
2019-07-20,9,4567,5680,2083,10917,10373,2005,64,23479,1297,6155,1349,8801,751,1134,1885
2019-07-20,10,4970,6016,2201,10978,10732,1990,70,23889,1401,6939,1613,9953,650,858,1508
2019-07-20,11,5371,6303,2271,11086,11177,1946,76,24399,1437,7364,1770,10571,548,655,1203
2019-07-20,12,5757,6548,2321,11207,11576,1909,83,24876,1453,7590,1783,10826,529,651,1180
2019-07-20,13,6103,6762,2382,11466,12057,1892,88,25606,1457,7634,1785,10876,526,727,1253
2019-07-20,14,6417,6904,2448,11891,12688,1900,93,26688,1457,7622,1783,10862,532,859,1391
2019-07-20,15,6690,7054,2519,12456,13326,1975,97,27973,1449,7543,1779,10771,618,1067,1685
2019-07-20,16,6898,7180,2601,13193,13957,2088,100,29456,1433,7225,1759,10417,717,1293,2010
2019-07-20,17,7013,7245,2693,13942,14536,2238,103,30936,1400,6709,1612,9721,832,1522,2354
2019-07-20,18,7018,7267,2753,14535,14737,2368,103,31861,1302,5668,1378,8348,921,1653,2574
2019-07-20,19,6892,7038,2720,15048,14690,2475,99,32431,944,3237,838,5019,973,1790,2763
2019-07-20,20,6614,6756,2638,14990,14154,2506,93,31865,254,665,194,1113,1023,1930,2953
2019-07-20,21,6421,6602,2522,14671,14003,2575,86,31456,2,38,0,40,1056,2002,3058
2019-07-20,22,6093,6305,2440,14303,13506,2516,79,30522,0,0,0,0,1089,2074,3163
2019-07-20,23,5673,5897,2244,13409,12705,2362,71,28665,0,0,0,0,1114,2087,3201
2019-07-20,24,5253,5490,2051,12372,11819,2176,65,26551,0,0,0,0,1102,1942,3044
2019-07-21,1,5003,5273,1941,11416,11109,2069,62,24777,0,0,0,0,1038,1698,2736
2019-07-21,2,4725,5063,1845,10800,10481,1955,58,23418,0,0,0,0,996,1505,2501
2019-07-21,3,4492,4927,1776,10312,10016,1882,56,22393,0,0,0,0,954,1348,2302
2019-07-21,4,4319,4845,1734,10065,9706,1836,54,21788,0,0,0,0,902,1195,2097
2019-07-21,5,4208,4801,1725,9916,9581,1832,54,21511,0,0,0,0,851,1072,1923
2019-07-21,6,4137,4744,1730,9927,9499,1865,54,21472,0,9,0,9,813,860,1673
2019-07-21,7,4041,4823,1736,9758,9278,1862,55,21075,171,1010,142,1323,785,661,1446
2019-07-21,8,4283,5211,1857,9800,9429,1887,60,21297,887,3970,785,5642,743,446,1189
2019-07-21,9,4670,5568,2027,9938,9703,1888,66,21708,1299,6085,1336,8720,668,261,929
2019-07-21,10,5103,5908,2147,10056,10138,1850,74,22233,1384,6798,1593,9775,578,189,767
2019-07-21,11,5531,6216,2265,10222,10781,1807,81,23013,1424,7244,1737,10405,493,191,684
2019-07-21,12,5939,6547,2367,10494,11471,1791,89,23962,1429,7452,1771,10652,461,259,720
2019-07-21,13,6316,6819,2462,10949,12326,1812,96,25295,1394,7456,1754,10604,440,345,785
2019-07-21,14,6669,7084,2556,11510,13321,1885,101,26936,1367,7397,1750,10514,429,453,882
2019-07-21,15,6997,7314,2657,12200,14296,1978,106,28695,1347,7272,1743,10362,510,550,1060
2019-07-21,16,7227,7509,2761,13000,15109,2129,109,30464,1300,6902,1689,9891,601,674,1275
2019-07-21,17,7378,7601,2863,13912,15814,2314,111,32269,1255,6279,1544,9078,698,831,1529
2019-07-21,18,7370,7614,2945,14683,16243,2496,111,33650,1118,5209,1307,7634,748,995,1743
2019-07-21,19,7244,7399,2932,15265,16215,2619,108,34326,759,2923,767,4449,791,1178,1969
2019-07-21,20,6967,7099,2863,15268,15601,2631,101,33721,188,543,167,898,830,1412,2242
2019-07-21,21,6767,6935,2745,14947,15367,2692,94,33218,1,19,0,20,873,1518,2391
2019-07-21,22,6431,6559,2639,14457,14704,2595,86,31958,0,0,0,0,909,1538,2447
2019-07-21,23,5945,6062,2395,13304,13569,2393,77,29457,0,0,0,0,942,1502,2444
2019-07-21,24,5502,5638,2157,12209,12475,2195,70,27065,0,0,0,0,927,1431,2358
2019-07-22,1,5253,5437,2020,11393,11519,2136,66,25240,0,0,0,0,797,1219,2016
2019-07-22,2,4965,5253,1911,10818,10847,2033,62,23888,0,0,0,0,755,1113,1868
2019-07-22,3,4722,5138,1847,10458,10475,1977,60,23100,0,0,0,0,732,979,1711
2019-07-22,4,4569,5128,1824,10305,10278,1951,59,22722,0,0,0,0,711,878,1589
2019-07-22,5,4517,5247,1871,10446,10497,1997,60,23130,0,0,0,0,700,785,1485
2019-07-22,6,4526,5431,2004,10971,11064,2117,62,24345,0,7,0,7,693,650,1343
2019-07-22,7,4558,5726,2188,11673,11568,2243,64,25675,155,780,130,1065,677,520,1197
2019-07-22,8,4835,6145,2393,12185,12325,2365,70,27073,831,3369,733,4933,656,391,1047
2019-07-22,9,5223,6562,2528,12413,12964,2432,77,28018,1238,5180,1314,7732,550,243,793
2019-07-22,10,5655,6934,2646,12536,13634,2455,85,28843,1364,5927,1594,8885,439,195,634
2019-07-22,11,6106,7283,2757,12770,14474,2465,92,29933,1416,6360,1752,9528,339,216,555
2019-07-22,12,6553,7599,2861,13105,15331,2484,100,31146,1431,6590,1736,9757,312,267,579
2019-07-22,13,6984,7897,2986,13563,16230,2538,108,32563,1427,6680,1690,9797,303,362,665
2019-07-22,14,7349,8132,3108,14297,17229,2617,113,34380,1413,6603,1642,9658,321,493,814
2019-07-22,15,7662,8312,3201,15063,18035,2738,117,36078,1390,6492,1617,9499,393,624,1017
2019-07-22,16,7837,8433,3279,15918,18721,2862,118,37743,1357,6130,1530,9017,485,816,1301
2019-07-22,17,7850,8463,3352,16643,19180,3004,120,39071,1291,5506,1323,8120,592,1105,1697
2019-07-22,18,7804,8407,3345,17275,19310,3126,117,39956,1180,4608,1143,6931,640,1284,1924
2019-07-22,19,7732,8140,3308,17673,18947,3142,113,40000,835,2612,678,4125,672,1464,2136
2019-07-22,20,7445,7796,3198,17481,18166,3089,106,38969,211,503,149,863,696,1593,2289
2019-07-22,21,7208,7572,3046,16901,17740,3087,99,37952,1,16,0,17,728,1655,2383
2019-07-22,22,6792,7082,2900,16025,16820,2941,90,36003,0,0,0,0,755,1724,2479
2019-07-22,23,6272,6484,2628,14547,15319,2674,81,32747,0,0,0,0,787,1769,2556
2019-07-22,24,5795,6003,2357,13222,13905,2425,73,29752,0,0,0,0,797,1686,2483
2019-07-23,1,5425,5675,2123,12423,12864,2317,68,27801,0,0,0,0,832,1602,2434
2019-07-23,2,5122,5455,1986,11698,12024,2188,64,26109,0,0,0,0,801,1459,2260
2019-07-23,3,4901,5316,1899,11234,11451,2116,61,24997,0,0,0,0,792,1281,2073
2019-07-23,4,4749,5278,1849,10986,11144,2069,60,24394,0,0,0,0,784,1137,1921
2019-07-23,5,4698,5380,1878,11008,11212,2093,60,24509,0,0,0,0,775,1010,1785
2019-07-23,6,4719,5554,2007,11436,11715,2215,62,25562,0,4,0,4,765,760,1525
2019-07-23,7,4722,5831,2185,12052,12281,2340,64,26867,152,690,124,966,755,563,1318
2019-07-23,8,4994,6239,2369,12536,13068,2468,70,28271,833,3045,726,4604,727,435,1162
2019-07-23,9,5352,6636,2496,12667,13733,2553,77,29147,1246,4593,1298,7137,653,258,911
2019-07-23,10,5729,7011,2605,12734,14562,2601,85,30105,1366,5289,1589,8244,581,170,751
2019-07-23,11,6118,7353,2702,12922,15522,2663,93,31323,1413,5590,1757,8760,499,185,684
2019-07-23,12,6476,7646,2803,13238,16557,2729,101,32749,1436,5885,1764,9085,480,209,689
2019-07-23,13,6797,7946,2917,13668,17642,2820,108,34363,1447,6126,1755,9328,467,254,721
2019-07-23,14,7077,8176,3029,14387,18755,2953,113,36339,1444,6169,1751,9364,474,354,828
2019-07-23,15,7332,8351,3109,15129,19647,3081,116,38107,1434,6130,1712,9276,547,558,1105
2019-07-23,16,7482,8496,3186,16057,20227,3243,118,39781,1408,5832,1613,8853,632,823,1455
2019-07-23,17,7463,8538,3203,16789,20555,3378,118,40974,1351,5207,1471,8029,733,1154,1887
2019-07-23,18,7434,8382,3187,17349,20541,3471,117,41610,1227,4261,1223,6711,762,1306,2068
2019-07-23,19,7340,8165,3134,17720,20093,3428,113,41487,873,2380,716,3969,754,1493,2247
2019-07-23,20,7101,7857,3010,17528,19396,3328,107,40490,218,442,148,808,755,1662,2417
2019-07-23,21,6930,7597,2865,16942,19051,3311,100,39536,2,18,0,20,784,1792,2576
2019-07-23,22,6578,7091,2743,16111,18067,3150,92,37551,0,0,0,0,806,1912,2718
2019-07-23,23,6093,6526,2517,14648,16479,2864,82,34206,0,0,0,0,824,1984,2808
2019-07-23,24,5646,6046,2265,13322,14950,2587,74,31063,0,0,0,0,812,2000,2812
2019-07-24,1,5329,5712,2028,12733,13962,2439,68,29337,0,0,0,0,763,1814,2577
2019-07-24,2,5050,5487,1902,11938,13002,2305,64,27446,0,0,0,0,717,1721,2438
2019-07-24,3,4827,5356,1824,11440,12389,2208,62,26231,0,0,0,0,694,1611,2305
2019-07-24,4,4682,5314,1788,11172,11969,2158,60,25484,0,0,0,0,688,1439,2127
2019-07-24,5,4641,5411,1817,11193,11971,2179,60,25530,0,0,0,0,680,1285,1965
2019-07-24,6,4657,5584,1938,11624,12332,2306,62,26458,0,3,0,3,643,1018,1661
2019-07-24,7,4671,5868,2112,12307,12788,2420,64,27711,163,729,131,1023,605,744,1349
2019-07-24,8,4943,6263,2289,12870,13592,2565,70,29231,881,3262,750,4893,559,509,1068
2019-07-24,9,5289,6652,2405,13092,14494,2648,77,30449,1283,5087,1292,7662,430,270,700
2019-07-24,10,5668,7017,2490,13229,15493,2693,84,31635,1396,5980,1555,8931,311,172,483
2019-07-24,11,6048,7350,2572,13531,16649,2757,92,33161,1436,6367,1717,9520,212,156,368
2019-07-24,12,6403,7614,2636,13935,17806,2831,100,34805,1451,6601,1750,9802,170,220,390
2019-07-24,13,6711,7870,2711,14564,18906,2924,108,36632,1449,6510,1726,9685,151,235,386
2019-07-24,14,7000,8063,2780,15501,19921,3058,113,38724,1444,6410,1733,9587,156,302,458
2019-07-24,15,7259,8216,2847,16283,20719,3204,116,40448,1427,6384,1701,9512,224,582,806
2019-07-24,16,7426,8313,2893,17215,21272,3330,118,42064,1382,6062,1627,9071,332,1121,1453
2019-07-24,17,7431,8286,2937,18027,21567,3461,120,43303,1334,5442,1459,8235,493,1693,2186
2019-07-24,18,7435,8190,2987,18571,21438,3528,117,43783,1221,4467,1244,6932,575,1879,2454
2019-07-24,19,7325,7936,2947,18888,20866,3485,113,43483,776,2449,728,3953,628,2014,2642
2019-07-24,20,7103,7642,2859,18725,20049,3379,106,42391,190,453,158,801,686,2121,2807
2019-07-24,21,6938,7446,2755,18089,19679,3348,99,41345,1,14,0,15,730,2184,2914
2019-07-24,22,6588,6999,2639,17232,18575,3192,90,39219,0,0,0,0,759,2215,2974
2019-07-24,23,6117,6455,2409,15641,16930,2899,81,35678,0,0,0,0,775,2238,3013
2019-07-24,24,5682,5991,2181,14176,15293,2622,73,32289,0,0,0,0,778,2147,2925
2019-07-25,1,5382,5548,2053,12713,13821,2462,68,29196,0,0,0,0,727,1991,2718
2019-07-25,2,5088,5332,1951,11873,12905,2328,64,27298,0,0,0,0,722,1897,2619
2019-07-25,3,4870,5192,1883,11377,12234,2230,61,26029,0,0,0,0,717,1796,2513
2019-07-25,4,4723,5147,1847,11100,11682,2174,60,25143,0,0,0,0,701,1689,2390
2019-07-25,5,4687,5243,1877,11092,11604,2195,60,25078,0,0,0,0,689,1591,2280
2019-07-25,6,4708,5416,2004,11445,11882,2318,62,25834,0,2,0,2,663,1451,2114
2019-07-25,7,4718,5665,2183,12075,12311,2458,64,27035,125,619,103,847,630,1232,1862
2019-07-25,8,4985,6058,2360,12614,13066,2589,71,28466,754,2855,648,4257,628,1072,1700
2019-07-25,9,5330,6435,2469,13152,14479,2670,78,30514,1114,4617,1083,6814,518,990,1508
2019-07-25,10,5711,6779,2556,13301,15447,2713,85,31682,1238,5336,1381,7955,410,924,1334
2019-07-25,11,6083,7088,2637,13588,16617,2774,93,33206,1277,5735,1533,8545,324,869,1193
2019-07-25,12,6431,7336,2715,14037,17756,2842,101,34867,1265,6112,1574,8951,307,687,994
2019-07-25,13,6723,7591,2816,14563,18796,2927,108,36524,1232,6127,1577,8936,312,547,859
2019-07-25,14,6989,7794,2919,15327,19882,3047,113,38499,1184,6214,1574,8972,355,505,860
2019-07-25,15,7225,7941,3010,16100,20742,3178,116,40271,1182,6088,1481,8751,432,782,1214
2019-07-25,16,7357,8057,3093,16901,21376,3298,118,41828,1169,5871,1500,8540,528,1123,1651
2019-07-25,17,7368,8040,3154,17592,21587,3378,117,42804,1151,5268,1328,7747,622,1451,2073
2019-07-25,18,7312,7953,3191,18114,21276,3435,115,43069,1027,4353,1172,6552,680,1704,2384
2019-07-25,19,7217,7719,3155,18281,20529,3380,112,42432,693,2377,695,3765,699,1895,2594
2019-07-25,20,6990,7467,3056,18062,19640,3322,105,41259,155,411,161,727,735,2021,2756
2019-07-25,21,6845,7245,2925,17455,19140,3278,99,40101,1,3,0,4,792,1997,2789
2019-07-25,22,6515,6802,2784,16590,18102,3131,90,38043,0,0,0,0,836,1963,2799
2019-07-25,23,6062,6269,2519,15123,16499,2859,81,34695,0,0,0,0,868,1908,2776
2019-07-25,24,5636,5826,2267,13803,14924,2591,73,31529,0,0,0,0,891,1943,2834
2019-07-26,1,5237,5434,2141,12463,13484,2559,67,28699,0,0,0,0,974,2251,3225
2019-07-26,2,4954,5214,2015,11709,12574,2419,63,26891,0,0,0,0,953,2205,3158
2019-07-26,3,4742,5086,1933,11198,11887,2317,60,25588,0,0,0,0,901,2094,2995
2019-07-26,4,4624,5053,1896,10885,11434,2255,58,24757,0,0,0,0,843,1975,2818
2019-07-26,5,4588,5143,1921,10888,11385,2267,58,24724,0,0,0,0,782,1838,2620
2019-07-26,6,4598,5301,2029,11233,11653,2400,59,25472,0,2,0,2,732,1549,2281
2019-07-26,7,4611,5561,2182,11900,12009,2546,62,26642,122,683,111,916,676,1369,2045
2019-07-26,8,4893,5937,2376,12443,12750,2701,67,28088,781,3275,713,4769,604,1149,1753
2019-07-26,9,5236,6304,2512,12629,13520,2811,73,29159,1154,5314,1280,7748,513,981,1494
2019-07-26,10,5603,6638,2626,12764,14523,2816,80,30309,1259,6192,1573,9024,439,759,1198
2019-07-26,11,5970,6927,2729,13033,15671,2855,88,31773,1294,6653,1732,9679,343,628,971
2019-07-26,12,6352,7159,2827,13422,16780,2912,96,33338,1358,6920,1772,10050,317,778,1095
2019-07-26,13,6695,7400,2939,13990,17792,3020,103,35033,1404,6964,1786,10154,307,1059,1366
2019-07-26,14,6975,7577,3053,14729,18875,3154,108,36997,1431,6932,1788,10151,324,1377,1701
2019-07-26,15,7220,7710,3148,15531,19756,3297,111,38822,1419,6824,1784,10027,371,1818,2189
2019-07-26,16,7357,7782,3228,16392,20434,3473,113,40539,1405,6612,1749,9766,447,2234,2681
2019-07-26,17,7331,7800,3294,17080,20665,3508,114,41493,1365,6030,1608,9003,541,2598,3139
2019-07-26,18,7283,7704,3293,17535,20438,3504,112,41716,1253,5050,1370,7673,609,2730,3339
2019-07-26,19,7136,7444,3210,17719,19781,3395,108,41130,890,2897,821,4608,668,2804,3472
2019-07-26,20,6906,7128,3076,17479,18927,3345,102,39979,218,509,201,928,724,2819,3543
2019-07-26,21,6763,6938,2920,16975,18587,3297,95,39082,3,8,15,26,762,2847,3609
2019-07-26,22,6463,6599,2804,16212,17658,3180,87,37265,0,0,0,0,783,2865,3648
2019-07-26,23,6056,6140,2576,14896,16250,2961,79,34311,0,0,0,0,799,2849,3648
2019-07-26,24,5657,5710,2324,13658,14783,2722,71,31359,0,0,0,0,790,2764,3554
2019-07-27,1,5378,5320,2110,12942,13527,2530,68,29198,0,0,0,0,779,2517,3296
2019-07-27,2,5080,5104,1965,12139,12564,2378,64,27276,0,0,0,0,766,2424,3190
2019-07-27,3,4853,4973,1869,11625,11872,2286,61,25975,0,0,0,0,731,2260,2991
2019-07-27,4,4686,4906,1813,11259,11342,2218,59,25010,0,0,0,0,702,2070,2772
2019-07-27,5,4567,4908,1813,11127,11166,2183,59,24660,0,0,0,0,665,1901,2566
2019-07-27,6,4467,4931,1845,11226,11198,2223,59,24832,0,2,0,2,628,1591,2219
2019-07-27,7,4416,5051,1887,11291,11174,2231,61,24883,147,928,122,1197,577,1282,1859
2019-07-27,8,4665,5341,2013,11459,11400,2282,66,25333,868,3874,755,5497,520,993,1513
2019-07-27,9,5076,5702,2179,11615,11705,2384,73,25912,1286,6051,1342,8679,371,656,1027
2019-07-27,10,5517,6009,2321,11928,12586,2419,81,27151,1393,6774,1620,9787,243,378,621
2019-07-27,11,5949,6285,2432,12386,13684,2480,90,28776,1428,7226,1766,10420,159,233,392
2019-07-27,12,6325,6535,2526,12912,14851,2540,98,30521,1443,7433,1799,10675,133,222,355
2019-07-27,13,6658,6746,2614,13683,15976,2620,105,32516,1441,7410,1803,10654,115,262,377
2019-07-27,14,6952,6884,2693,14576,17068,2751,110,34641,1440,7390,1803,10633,116,359,475
2019-07-27,15,7193,7024,2771,15534,18028,2892,113,36696,1432,7302,1799,10533,140,696,836
2019-07-27,16,7356,7138,2833,16578,18715,3058,115,38593,1420,6966,1753,10139,185,1187,1372
2019-07-27,17,7404,7219,2907,17516,19037,3146,117,39943,1389,6397,1618,9404,254,1755,2009
2019-07-27,18,7394,7215,2908,18097,19025,3229,116,40594,1283,5443,1378,8104,342,2127,2469
2019-07-27,19,7229,7010,2868,18351,18499,3254,112,40344,918,3122,824,4864,444,2371,2815
2019-07-27,20,6961,6777,2776,18160,17724,3191,105,39307,218,568,199,985,497,2517,3014
2019-07-27,21,6764,6605,2656,17537,17226,3173,98,38161,3,9,15,27,523,2571,3094
2019-07-27,22,6435,6274,2561,16743,16450,3047,90,36456,0,0,0,0,536,2575,3111
2019-07-27,23,6055,5859,2369,15459,15328,2837,81,33834,0,0,0,0,563,2529,3092
2019-07-27,24,5643,5465,2158,14168,14090,2608,74,31068,0,0,0,0,575,2436,3011
2019-07-28,1,5301,5228,1973,13262,13056,2580,68,29095,0,0,0,0,546,2287,2833
2019-07-28,2,5005,5027,1852,12369,12177,2402,64,27140,0,0,0,0,528,2152,2680
2019-07-28,3,4759,4898,1780,11820,11518,2263,61,25791,0,0,0,0,509,2032,2541
2019-07-28,4,4581,4824,1737,11359,11025,2163,59,24733,0,0,0,0,465,1921,2386
2019-07-28,5,4451,4791,1722,11149,10832,2137,58,24303,0,0,0,0,431,1793,2224
2019-07-28,6,4377,4758,1737,11197,10695,2164,58,24241,0,3,0,3,375,1546,1921
2019-07-28,7,4273,4830,1762,11156,10508,2163,60,24014,135,748,117,1000,328,1266,1594
2019-07-28,8,4481,5174,1871,11150,10843,2206,65,24392,843,3463,733,5039,311,1029,1340
2019-07-28,9,4878,5506,2009,11356,11403,2280,73,25239,1276,5605,1315,8196,268,759,1027
2019-07-28,10,5355,5824,2154,11720,12269,2325,82,26523,1387,6293,1573,9253,244,505,749
2019-07-28,11,5818,6112,2270,12243,13360,2386,91,28206,1423,6748,1714,9885,202,312,514
2019-07-28,12,6241,6426,2370,12986,14526,2459,99,30196,1437,6938,1748,10123,187,379,566
2019-07-28,13,6638,6686,2461,13970,15699,2552,107,32462,1428,6811,1729,9968,213,536,749
2019-07-28,14,6984,6922,2543,15006,16842,2690,113,34784,1424,6711,1728,9863,276,729,1005
2019-07-28,15,7287,7130,2629,16037,17859,2837,117,36980,1418,6538,1717,9673,375,1160,1535
2019-07-28,16,7470,7305,2719,17047,18687,2992,121,38975,1365,6094,1645,9104,490,1685,2175
2019-07-28,17,7558,7382,2805,18133,19205,3106,122,40696,1331,5618,1523,8472,610,2174,2784
2019-07-28,18,7502,7358,2892,19019,19263,3199,121,41731,1212,4598,1284,7094,688,2338,3026
2019-07-28,19,7337,7169,2866,19458,18925,3231,117,41861,813,2519,759,4091,717,2334,3051
2019-07-28,20,7064,6938,2795,19251,18038,3168,110,40692,189,424,167,780,787,2311,3098
2019-07-28,21,6859,6765,2691,18506,17526,3158,102,39416,2,5,0,7,878,2423,3301
2019-07-28,22,6512,6379,2583,17281,16632,3023,93,37152,0,0,0,0,933,2513,3446
2019-07-28,23,6050,5906,2352,15618,15248,2784,84,33861,0,0,0,0,996,2569,3565
2019-07-28,24,5601,5502,2119,13962,13828,2547,76,30539,0,0,0,0,1028,2512,3540
2019-07-29,1,5264,5227,1953,12411,12790,2315,70,27714,0,0,0,0,1008,2233,3241
2019-07-29,2,4960,5059,1847,11655,11968,2188,65,26012,0,0,0,0,986,2176,3162
2019-07-29,3,4721,4959,1785,11221,11397,2107,63,24922,0,0,0,0,979,2041,3020
2019-07-29,4,4546,4960,1766,10966,11083,2072,61,24318,0,0,0,0,975,1904,2879
2019-07-29,5,4500,5089,1812,11018,11160,2119,61,24491,0,0,0,0,947,1764,2711
2019-07-29,6,4496,5288,1946,11511,11676,2240,63,25617,0,1,0,1,907,1628,2535
2019-07-29,7,4528,5610,2129,12227,12213,2362,65,26995,107,716,102,925,887,1484,2371
2019-07-29,8,4763,5972,2330,12788,13003,2486,72,28479,760,3342,695,4797,840,1329,2169
2019-07-29,9,5125,6336,2455,12834,13745,2571,80,29359,1205,5434,1292,7931,796,1167,1963
2019-07-29,10,5533,6666,2562,12693,14502,2618,89,30029,1351,6088,1554,8993,708,989,1697
2019-07-29,11,5958,6977,2663,12748,15395,2636,97,31002,1398,6491,1713,9602,637,820,1457
2019-07-29,12,6405,7261,2752,12948,16273,2659,105,32110,1418,6734,1764,9916,627,970,1597
2019-07-29,13,6841,7545,2864,13286,17153,2712,113,33389,1411,6766,1753,9930,605,1157,1762
2019-07-29,14,7236,7760,2965,13883,18180,2808,119,35117,1410,6712,1751,9873,630,1397,2027
2019-07-29,15,7573,7937,3055,14459,19028,2911,122,36648,1403,6544,1739,9686,710,1723,2433
2019-07-29,16,7743,8068,3119,15127,19709,3046,124,38134,1387,6106,1701,9194,798,1992,2790
2019-07-29,17,7728,8091,3171,15718,20294,3166,125,39430,1355,5532,1558,8445,908,2243,3151
2019-07-29,18,7663,7963,3200,16348,20340,3263,122,40194,1237,4579,1335,7151,964,2367,3331
2019-07-29,19,7523,7752,3150,16558,19673,3259,117,39736,840,2551,786,4177,975,2426,3401
2019-07-29,20,7227,7476,3046,16290,18954,3186,110,38671,203,435,183,821,984,2439,3423
2019-07-29,21,6981,7257,2914,15802,18425,3164,103,37625,2,0,13,15,1007,2519,3526
2019-07-29,22,6578,6789,2769,15019,17417,3015,94,35673,0,0,0,0,1032,2559,3591
2019-07-29,23,6104,6234,2506,13737,15928,2738,84,32616,0,0,0,0,1030,2571,3601
2019-07-29,24,5634,5777,2250,12553,14373,2483,76,29612,0,0,0,0,1018,2518,3536
2019-07-30,1,5190,5567,2065,11652,12705,2302,68,26864,0,0,0,0,936,2240,3176
2019-07-30,2,4877,5365,1942,11063,11888,2174,64,25327,0,0,0,0,939,2138,3077
2019-07-30,3,4651,5246,1866,10707,11316,2101,61,24317,0,0,0,0,901,1989,2890
2019-07-30,4,4486,5221,1833,10517,11014,2052,60,23774,0,0,0,0,869,1854,2723
2019-07-30,5,4428,5333,1862,10607,11069,2078,60,23946,0,0,0,0,841,1726,2567
2019-07-30,6,4432,5531,1991,11064,11566,2202,62,25025,0,0,0,0,825,1479,2304
2019-07-30,7,4449,5785,2168,11810,12084,2321,63,26406,115,526,97,738,793,1227,2020
2019-07-30,8,4706,6160,2354,12296,12773,2454,70,27724,804,2707,693,4204,749,998,1747
2019-07-30,9,5062,6521,2466,12343,13382,2534,77,28472,1253,4568,1304,7125,703,713,1416
2019-07-30,10,5450,6864,2561,12247,14023,2560,85,29048,1378,5345,1578,8301,622,432,1054
2019-07-30,11,5862,7190,2648,12286,14770,2591,93,29867,1418,5773,1728,8919,564,275,839
2019-07-30,12,6268,7466,2737,12348,15560,2629,101,30765,1433,5945,1775,9153,543,285,828
2019-07-30,13,6648,7754,2840,12620,16376,2680,108,31910,1426,5850,1764,9040,525,360,885
2019-07-30,14,6992,7970,2936,13164,17339,2774,113,33517,1419,5680,1761,8860,544,469,1013
2019-07-30,15,7328,8140,3009,13788,18186,2897,117,35119,1412,5474,1756,8642,604,674,1278
2019-07-30,16,7558,8259,3075,14527,18881,3025,119,36684,1398,5010,1692,8100,674,949,1623
2019-07-30,17,7598,8250,3151,15218,19301,3151,121,37920,1363,4610,1534,7507,771,1272,2043
2019-07-30,18,7553,8210,3152,15784,19341,3246,118,38622,1240,3683,1293,6216,855,1394,2249
2019-07-30,19,7447,7947,3106,16057,18915,3223,114,38440,809,1892,722,3423,898,1454,2352
2019-07-30,20,7166,7662,3007,15881,18142,3159,108,37425,189,299,158,646,931,1480,2411
2019-07-30,21,6933,7385,2886,15513,17709,3159,102,36615,3,0,0,3,955,1542,2497
2019-07-30,22,6518,6910,2750,14789,16738,3009,93,34761,0,0,0,0,997,1621,2618
2019-07-30,23,6030,6360,2494,13566,15241,2749,83,31773,0,0,0,0,992,1684,2676
2019-07-30,24,5578,5887,2243,12414,13837,2490,75,28953,0,0,0,0,970,1584,2554
2019-07-31,1,5449,5400,2075,11742,12532,2253,67,26717,0,0,0,0,931,1322,2253
2019-07-31,2,5174,5188,1960,11161,11740,2135,64,25217,0,0,0,0,894,1227,2121
2019-07-31,3,4973,5079,1882,10767,11184,2064,61,24195,0,0,0,0,821,1097,1918
2019-07-31,4,4835,5064,1849,10574,10865,2022,59,23632,0,0,0,0,741,1015,1756
2019-07-31,5,4790,5179,1877,10636,10838,2048,59,23701,0,0,0,0,677,940,1617
2019-07-31,6,4828,5398,2006,11085,11308,2177,61,24756,0,0,0,0,630,725,1355
2019-07-31,7,4826,5671,2181,11740,11781,2303,63,26011,106,447,82,635,585,566,1151
2019-07-31,8,5054,5990,2361,12307,12453,2426,69,27382,758,2529,637,3924,564,439,1003
2019-07-31,9,5374,6305,2478,12359,13050,2492,76,28113,1206,4288,1254,6748,505,329,834
2019-07-31,10,5705,6603,2568,12388,13672,2501,83,28779,1353,5242,1547,8142,406,279,685
2019-07-31,11,6042,6875,2662,12475,14321,2505,91,29525,1401,5755,1703,8859,290,274,564
2019-07-31,12,6334,7093,2748,12652,15052,2512,98,30447,1414,6087,1754,9255,221,326,547
2019-07-31,13,6554,7314,2855,12940,15799,2541,104,31514,1421,6250,1768,9439,181,420,601
2019-07-31,14,6742,7461,2957,13557,16582,2626,108,33005,1418,6339,1767,9524,185,549,734
2019-07-31,15,6899,7561,3056,14228,17510,2740,112,34719,1412,6341,1762,9515,255,717,972
2019-07-31,16,7034,7627,3135,14870,18209,2847,114,36169,1411,6451,1739,9601,353,929,1282
2019-07-31,17,7071,7596,3207,15564,18654,2972,115,37434,1370,5933,1597,8900,498,1145,1643
2019-07-31,18,7065,7457,3233,16119,18726,3074,112,38160,1255,4963,1358,7576,612,1222,1834
2019-07-31,19,6956,7291,3180,16466,18258,3075,108,38037,856,2674,794,4324,712,1258,1970
2019-07-31,20,6790,7015,3078,16409,17515,3031,103,37188,197,419,192,808,758,1332,2090
2019-07-31,21,6661,6836,2950,16048,17148,3031,97,36454,4,0,13,17,777,1401,2178
2019-07-31,22,6317,6398,2809,15341,16321,2903,88,34777,0,0,0,0,814,1470,2284
2019-07-31,23,5901,5944,2535,14094,14990,2655,79,31943,0,0,0,0,795,1514,2309
2019-07-31,24,5512,5566,2283,12946,13688,2416,71,29245,0,0,0,0,765,1387,2152
2019-08-01,1,5352,5368,2142,11838,12542,2204,66,26775,0,0,0,0,878,1123,2001
2019-08-01,2,5058,5186,2030,11226,11809,2090,62,25311,0,0,0,0,876,999,1875
2019-08-01,3,4834,5067,1956,10786,11280,2020,59,24270,0,0,0,0,855,865,1720
2019-08-01,4,4689,5039,1920,10549,10991,1983,57,23707,0,0,0,0,827,764,1591
2019-08-01,5,4646,5145,1949,10681,11063,2009,57,23936,0,0,0,0,814,693,1507
2019-08-01,6,4663,5338,2066,11155,11562,2133,59,25035,0,0,0,0,753,539,1292
2019-08-01,7,4686,5547,2216,11798,12043,2267,60,26294,111,650,96,857,702,397,1099
2019-08-01,8,4935,5885,2386,12198,12668,2387,66,27443,786,3370,690,4846,643,287,930
2019-08-01,9,5270,6221,2500,12308,13103,2449,73,28050,1257,5756,1298,8311,559,189,748
2019-08-01,10,5644,6545,2614,12275,13634,2447,81,28550,1386,6689,1578,9653,512,150,662
2019-08-01,11,6014,6839,2722,12318,14330,2452,89,29304,1428,7212,1735,10375,432,169,601
2019-08-01,12,6370,7073,2817,12460,15075,2488,97,30238,1442,7441,1776,10659,386,253,639
2019-08-01,13,6658,7342,2940,12728,15927,2552,104,31425,1438,7435,1777,10650,398,375,773
2019-08-01,14,6924,7540,3070,13282,16903,2632,108,33041,1432,7384,1778,10594,438,543,981
2019-08-01,15,7135,7698,3166,13923,17847,2743,111,34744,1422,7245,1772,10439,530,688,1218
2019-08-01,16,7297,7806,3237,14635,18659,2861,112,36381,1417,6933,1738,10088,654,835,1489
2019-08-01,17,7327,7824,3319,15329,19048,2990,112,37599,1380,6323,1595,9298,791,1013,1804
2019-08-01,18,7285,7697,3309,15887,19005,3103,110,38231,1258,5216,1343,7817,883,1133,2016
2019-08-01,19,7101,7450,3248,16242,18463,3082,106,38019,847,2790,776,4413,901,1314,2215
2019-08-01,20,6854,7200,3129,16284,17510,3026,100,37044,195,445,170,810,918,1544,2462
2019-08-01,21,6720,7049,2992,15961,17213,3038,94,36431,4,0,13,17,948,1672,2620
2019-08-01,22,6363,6599,2849,15297,16228,2908,86,34644,0,0,0,0,962,1792,2754
2019-08-01,23,5935,6083,2585,14006,14845,2655,77,31708,0,0,0,0,963,1855,2818
2019-08-01,24,5526,5672,2337,12855,13519,2418,70,28984,0,0,0,0,956,1800,2756
2019-08-02,1,5030,5284,2155,12105,12940,2321,65,27555,0,0,0,0,985,1613,2598
2019-08-02,2,4741,5116,2025,11534,12188,2200,61,26107,0,0,0,0,948,1572,2520
2019-08-02,3,4524,5002,1940,11090,11593,2110,58,24977,0,0,0,0,919,1429,2348
2019-08-02,4,4366,4991,1900,10886,11288,2071,56,24427,0,0,0,0,896,1283,2179
2019-08-02,5,4320,5102,1924,10976,11342,2090,56,24590,0,0,0,0,850,1107,1957
2019-08-02,6,4308,5286,2029,11425,11757,2201,58,25566,0,0,0,0,783,890,1673
2019-08-02,7,4369,5500,2158,12071,12256,2303,59,26814,116,746,99,961,745,688,1433
2019-08-02,8,4627,5841,2332,12519,12935,2424,65,28067,784,3463,696,4943,678,448,1126
2019-08-02,9,4980,6173,2465,12797,13438,2509,71,28944,1248,5686,1297,8231,574,250,824
2019-08-02,10,5364,6484,2586,12843,14151,2528,78,29730,1374,6535,1580,9489,463,167,630
2019-08-02,11,5726,6781,2697,12955,15060,2550,86,30777,1410,7032,1721,10163,384,156,540
2019-08-02,12,6101,7045,2786,13099,16013,2583,94,31915,1425,7265,1766,10456,343,205,548
2019-08-02,13,6459,7339,2892,13388,17057,2659,100,33329,1422,7148,1771,10341,323,278,601
2019-08-02,14,6773,7570,3004,14066,18292,2773,105,35360,1417,7063,1771,10251,356,372,728
2019-08-02,15,7092,7740,3082,14821,19308,2919,108,37282,1413,6936,1763,10112,422,514,936
2019-08-02,16,7306,7848,3137,15675,20212,3055,110,39178,1402,6533,1745,9680,506,754,1260
2019-08-02,17,7356,7821,3196,16542,20688,3187,112,40654,1366,5887,1599,8852,613,1041,1654
2019-08-02,18,7344,7754,3173,17101,20595,3277,110,41208,1241,4787,1340,7368,683,1359,2042
2019-08-02,19,7158,7449,3093,17367,19853,3228,106,40680,847,2557,772,4176,690,1693,2383
2019-08-02,20,6824,7170,2967,17188,18693,3117,99,39224,189,392,184,765,725,1950,2675
2019-08-02,21,6633,6960,2829,16829,18318,3138,93,38505,4,0,13,17,785,1977,2762
2019-08-02,22,6270,6546,2723,16040,17225,3004,85,36479,0,0,0,0,817,1930,2747
2019-08-02,23,5874,6055,2513,14800,15923,2778,77,33702,0,0,0,0,842,1895,2737
2019-08-02,24,5450,5634,2290,13588,14556,2552,70,30891,0,0,0,0,855,1784,2639
2019-08-03,1,5117,5407,2122,12418,13036,2369,63,28013,0,0,0,0,825,1613,2438
2019-08-03,2,4805,5213,1992,11704,12189,2227,58,26303,0,0,0,0,788,1548,2336
2019-08-03,3,4574,5075,1907,11184,11548,2130,56,25044,0,0,0,0,726,1419,2145
2019-08-03,4,4394,5013,1858,10885,11128,2070,55,24263,0,0,0,0,691,1273,1964
2019-08-03,5,4284,5017,1844,10749,10913,2051,54,23893,0,0,0,0,672,1095,1767
2019-08-03,6,4196,5049,1871,10865,11009,2093,55,24146,0,0,0,0,606,870,1476
2019-08-03,7,4132,5122,1892,10931,10914,2096,55,24121,94,536,82,712,552,695,1247
2019-08-03,8,4365,5473,2011,11075,11246,2156,59,24661,676,2778,596,4050,471,470,941
2019-08-03,9,4764,5874,2158,11477,11943,2212,65,25822,1107,4819,1155,7081,368,283,651
2019-08-03,10,5199,6241,2306,11711,12717,2239,73,26864,1254,5729,1434,8417,275,185,460
2019-08-03,11,5639,6584,2435,11970,13681,2258,81,28115,1289,6264,1590,9143,208,170,378
2019-08-03,12,6076,6857,2534,12303,14690,2304,90,29511,1267,6507,1626,9400,154,211,365
2019-08-03,13,6488,7120,2632,12795,15776,2398,98,31191,1268,6518,1668,9454,143,273,416
2019-08-03,14,6883,7312,2733,13492,16822,2489,103,33032,1253,6526,1665,9444,158,367,525
2019-08-03,15,7244,7483,2821,14293,17832,2616,108,34975,1237,6382,1662,9281,231,513,744
2019-08-03,16,7549,7641,2905,15211,18655,2787,111,36889,1212,5973,1640,8825,362,722,1084
2019-08-03,17,7743,7722,2989,16012,19166,2942,115,38360,1175,5362,1479,8016,487,1033,1520
2019-08-03,18,7725,7649,3043,16631,19232,3068,113,39170,1021,4316,1177,6514,574,1241,1815
2019-08-03,19,7482,7379,2998,16981,18725,3090,109,39031,652,2216,645,3513,599,1425,2024
2019-08-03,20,7095,7105,2897,16731,17712,3015,100,37683,146,307,129,582,671,1613,2284
2019-08-03,21,6837,6915,2775,16287,17320,3042,92,36868,1,0,6,7,749,1669,2418
2019-08-03,22,6452,6499,2651,15505,16361,2922,84,34998,0,0,0,0,805,1672,2477
2019-08-03,23,6015,6048,2426,14364,15181,2719,76,32465,0,0,0,0,849,1644,2493
2019-08-03,24,5584,5646,2220,13211,13989,2503,68,29897,0,0,0,0,889,1569,2458
2019-08-04,1,5318,5417,2097,12319,12434,2479,63,27422,0,0,0,0,917,1432,2349
2019-08-04,2,5000,5219,1972,11562,11658,2320,60,25726,0,0,0,0,894,1304,2198
2019-08-04,3,4759,5102,1897,10996,11059,2198,57,24437,0,0,0,0,863,1300,2163
2019-08-04,4,4559,5043,1852,10638,10664,2117,55,23599,0,0,0,0,842,1196,2038
2019-08-04,5,4437,5024,1839,10396,10469,2100,55,23145,0,0,0,0,813,1147,1960
2019-08-04,6,4348,5051,1841,10354,10431,2095,55,23061,0,0,0,0,778,965,1743
2019-08-04,7,4217,5091,1841,10261,10196,2103,55,22740,94,564,105,763,758,773,1531
2019-08-04,8,4419,5436,1945,10268,10379,2181,60,23012,719,3027,658,4404,709,541,1250
2019-08-04,9,4800,5780,2119,10419,10858,2200,66,23668,1211,5277,1274,7762,608,346,954
2019-08-04,10,5270,6108,2290,10540,11580,2211,73,24529,1370,6130,1567,9067,513,257,770
2019-08-04,11,5721,6426,2421,10767,12450,2311,81,25734,1405,6695,1708,9808,465,266,731
2019-08-04,12,6153,6755,2531,11153,13418,2357,90,27143,1420,6861,1749,10030,436,348,784
2019-08-04,13,6563,7064,2649,11694,14505,2378,97,28801,1406,6848,1731,9985,431,443,874
2019-08-04,14,6967,7342,2766,12311,15635,2531,103,30707,1402,6862,1732,9996,465,572,1037
2019-08-04,15,7350,7552,2876,13030,16738,2673,107,32674,1393,6725,1718,9836,534,732,1266
2019-08-04,16,7671,7711,2970,13747,17648,2855,111,34488,1338,6338,1647,9323,630,926,1556
2019-08-04,17,7785,7765,3065,14642,18252,3043,114,36178,1275,5738,1495,8508,717,1128,1845
2019-08-04,18,7773,7671,3136,15466,18426,3175,115,37307,1064,4614,1237,6915,759,1305,2064
2019-08-04,19,7555,7390,3109,15930,18000,3211,111,37378,680,2359,671,3710,789,1482,2271
2019-08-04,20,7209,7128,3018,15921,17120,3146,103,36416,157,333,127,617,826,1649,2475
2019-08-04,21,6980,6995,2901,15599,16825,3172,95,35817,3,0,5,8,873,1834,2707
2019-08-04,22,6563,6563,2759,14981,15881,3017,86,34091,0,0,0,0,905,1833,2738
2019-08-04,23,6076,6073,2496,13751,14614,2746,77,31314,0,0,0,0,914,1815,2729
2019-08-04,24,5617,5681,2257,12554,13343,2495,68,28586,0,0,0,0,925,1659,2584
2019-08-05,1,5273,5326,2151,11428,12086,2271,63,25975,0,0,0,0,904,1531,2435
2019-08-05,2,4955,5169,2037,10867,11468,2155,59,24676,0,0,0,0,885,1482,2367
2019-08-05,3,4714,5071,1959,10468,11003,2090,57,23745,0,0,0,0,850,1351,2201
2019-08-05,4,4548,5075,1920,10291,10778,2061,56,23312,0,0,0,0,824,1191,2015
2019-08-05,5,4476,5201,1959,10401,10926,2097,57,23609,0,0,0,0,811,1024,1835
2019-08-05,6,4505,5428,2091,10948,11516,2229,59,24879,0,0,0,0,779,911,1690
2019-08-05,7,4518,5668,2255,11676,12092,2366,61,26321,69,601,72,742,751,792,1543
2019-08-05,8,4791,6041,2438,12230,12727,2502,67,27651,561,3117,540,4218,663,597,1260
2019-08-05,9,5189,6404,2593,12489,13388,2596,73,28671,1015,5366,1066,7447,555,417,972
2019-08-05,10,5644,6751,2734,12618,14098,2630,80,29550,1163,6169,1367,8699,458,330,788
2019-08-05,11,6105,7082,2872,12832,15005,2671,89,30721,1191,6699,1514,9404,386,328,714
2019-08-05,12,6563,7375,2994,13105,15960,2750,98,32038,1219,6915,1563,9697,338,450,788
2019-08-05,13,7006,7674,3137,13549,16957,2851,106,33588,1216,6938,1624,9778,315,551,866
2019-08-05,14,7406,7887,3275,14269,17996,2981,112,35484,1198,6891,1616,9705,333,705,1038
2019-08-05,15,7766,8030,3378,15028,18973,3100,117,37344,1171,6660,1594,9425,403,876,1279
2019-08-05,16,8024,8106,3447,15742,19779,3232,120,38998,1149,6118,1581,8848,490,1048,1538
2019-08-05,17,8060,8130,3498,16500,20244,3375,121,40367,1072,5514,1423,8009,571,1225,1796
2019-08-05,18,8011,7927,3538,16975,20282,3461,120,40966,932,4373,1170,6475,616,1374,1990
2019-08-05,19,7861,7680,3469,17139,19732,3401,116,40517,585,2196,678,3459,661,1534,2195
2019-08-05,20,7540,7454,3356,16816,18779,3309,108,39140,126,295,148,569,726,1683,2409
2019-08-05,21,7265,7240,3202,16418,18386,3309,99,38340,1,0,14,15,781,1789,2570
2019-08-05,22,6794,6745,3025,15497,17266,3118,90,36098,0,0,0,0,837,1774,2611
2019-08-05,23,6253,6179,2730,14078,15663,2824,80,32768,0,0,0,0,881,1810,2691
2019-08-05,24,5750,5748,2464,12830,14185,2544,72,29757,0,0,0,0,897,1676,2573
2019-08-06,1,5333,5515,2303,11915,12733,2297,66,27138,0,0,0,0,820,1698,2518
2019-08-06,2,5011,5326,2172,11269,11954,2169,62,25580,0,0,0,0,803,1572,2375
2019-08-06,3,4771,5202,2084,10829,11403,2088,60,24506,0,0,0,0,800,1423,2223
2019-08-06,4,4607,5174,2038,10623,11113,2045,58,23966,0,0,0,0,804,1305,2109
2019-08-06,5,4538,5292,2048,10714,11125,2056,59,24081,0,0,0,0,785,1207,1992
2019-08-06,6,4561,5500,2174,11232,11627,2171,61,25218,0,0,0,0,767,1053,1820
2019-08-06,7,4551,5727,2335,11927,12174,2332,63,26621,69,347,73,489,718,936,1654
2019-08-06,8,4799,6087,2507,12378,12743,2438,69,27754,539,1966,552,3057,680,736,1416
2019-08-06,9,5164,6440,2646,12712,13533,2507,75,28956,966,3605,1098,5669,614,488,1102
2019-08-06,10,5582,6794,2782,12817,14171,2499,83,29698,1089,4461,1376,6926,537,356,893
2019-08-06,11,6004,7124,2914,12964,14950,2511,92,30644,1131,4935,1515,7581,467,335,802
2019-08-06,12,6435,7404,3054,13232,15926,2514,101,31900,1139,5197,1543,7879,407,405,812
2019-08-06,13,6834,7712,3208,13651,16833,2585,108,33304,1189,5253,1575,8017,401,462,863
2019-08-06,14,7215,7940,3359,14388,17848,2699,114,35177,1200,5209,1585,7994,433,582,1015
2019-08-06,15,7540,8117,3468,15175,18709,2803,118,36932,1202,5166,1575,7943,511,682,1193
2019-08-06,16,7769,8245,3544,15894,19441,2923,120,38505,1187,4976,1544,7707,640,791,1431
2019-08-06,17,7744,8246,3611,16594,19807,3017,122,39666,1126,4573,1399,7098,737,945,1682
2019-08-06,18,7675,8063,3626,16957,19814,3151,119,40166,989,3695,1185,5869,786,1047,1833
2019-08-06,19,7521,7793,3561,17240,19227,3140,114,39848,664,1873,665,3202,848,1190,2038
2019-08-06,20,7220,7514,3439,17156,18340,3091,107,38822,148,232,143,523,893,1415,2308
2019-08-06,21,7007,7286,3287,16737,17994,3071,99,38020,1,0,12,13,921,1542,2463
2019-08-06,22,6590,6791,3096,15999,16923,2938,90,36076,0,0,0,0,948,1648,2596
2019-08-06,23,6088,6249,2795,14368,15456,2680,81,32711,0,0,0,0,978,1704,2682
2019-08-06,24,5617,5809,2520,13071,14044,2432,73,29747,0,0,0,0,989,1610,2599
2019-08-07,1,5259,5473,2302,12301,12638,2277,66,27418,0,0,0,0,974,1344,2318
2019-08-07,2,4977,5275,2163,11615,11857,2154,62,25819,0,0,0,0,978,1265,2243
2019-08-07,3,4771,5163,2072,11129,11300,2072,60,24693,0,0,0,0,981,1170,2151
2019-08-07,4,4631,5141,2025,10901,10997,2041,58,24126,0,0,0,0,982,1089,2071
2019-08-07,5,4588,5258,2033,10951,10964,2073,59,24173,0,0,0,0,971,958,1929
2019-08-07,6,4618,5470,2157,11437,11467,2214,61,25307,0,0,0,0,956,842,1798
2019-08-07,7,4616,5705,2310,12132,11977,2359,62,26659,81,389,78,548,928,751,1679
2019-08-07,8,4839,6023,2478,12566,12513,2474,68,27749,675,2261,614,3550,886,580,1466
2019-08-07,9,5151,6355,2619,12677,13105,2516,74,28499,1185,4180,1206,6571,843,395,1238
2019-08-07,10,5521,6685,2752,12734,13706,2512,82,29161,1325,5110,1356,7791,792,320,1112
2019-08-07,11,5889,6993,2889,12843,14449,2506,90,30013,1368,5672,1501,8541,738,329,1067
2019-08-07,12,6232,7235,3017,13013,15245,2529,98,31010,1385,5926,1542,8853,712,426,1138
2019-08-07,13,6546,7495,3161,13363,16067,2587,105,32229,1394,5971,1541,8906,716,526,1242
2019-08-07,14,6828,7688,3306,13950,17031,2679,110,33884,1392,5950,1546,8888,761,704,1465
2019-08-07,15,7031,7807,3413,14636,17866,2796,114,35520,1388,5791,1539,8718,819,851,1670
2019-08-07,16,7171,7872,3495,15254,18532,2915,114,36926,1388,5412,1542,8342,892,985,1877
2019-08-07,17,7152,7806,3517,15903,18847,3050,113,38036,1353,4897,1406,7656,963,1117,2080
2019-08-07,18,7093,7632,3537,16414,18898,3143,111,38693,1233,3987,1290,6510,986,1191,2177
2019-08-07,19,6953,7356,3463,16564,18310,3130,107,38235,832,2136,758,3726,1006,1325,2331
2019-08-07,20,6732,7099,3320,16274,17544,3075,101,37119,171,272,163,606,1016,1519,2535
2019-08-07,21,6601,6980,3186,15987,17212,3088,95,36510,4,0,14,18,1043,1648,2691
2019-08-07,22,6252,6528,3012,15192,16271,2929,87,34606,0,0,0,0,1059,1726,2785
2019-08-07,23,5798,6031,2738,13896,14904,2668,78,31673,0,0,0,0,1064,1777,2841
2019-08-07,24,5391,5625,2470,12715,13525,2425,71,28864,0,0,0,0,1048,1777,2825
2019-08-08,1,5033,5284,2246,11854,12319,2236,65,26608,0,0,0,0,1049,1603,2652
2019-08-08,2,4772,5087,2108,11253,11566,2122,61,25134,0,0,0,0,1038,1564,2602
2019-08-08,3,4572,4979,2014,10823,11051,2040,59,24105,0,0,0,0,1021,1469,2490
2019-08-08,4,4444,4958,1963,10616,10780,2008,57,23594,0,0,0,0,994,1390,2384
2019-08-08,5,4423,5072,1973,10716,10885,2038,57,23828,0,0,0,0,957,1290,2247
2019-08-08,6,4473,5288,2102,11226,11393,2171,59,24981,0,0,0,0,910,1163,2073
2019-08-08,7,4479,5496,2260,11958,11923,2312,60,26383,65,481,82,628,887,1045,1932
2019-08-08,8,4733,5812,2419,12385,12502,2411,66,27493,659,3040,649,4348,871,794,1665
2019-08-08,9,5034,6126,2556,12411,12882,2462,72,27938,1210,5634,1280,8124,804,519,1323
2019-08-08,10,5378,6427,2687,12347,13362,2461,80,28368,1367,6660,1582,9609,737,351,1088
2019-08-08,11,5711,6695,2813,12300,14008,2458,88,28976,1403,7154,1732,10289,685,315,1000
2019-08-08,12,6062,6905,2922,12361,14737,2482,96,29800,1418,7406,1776,10600,678,440,1118
2019-08-08,13,6370,7124,3054,12581,15523,2537,103,30869,1420,7473,1781,10674,689,572,1261
2019-08-08,14,6642,7283,3180,13070,16366,2632,107,32297,1419,7489,1784,10692,743,779,1522
2019-08-08,15,6855,7401,3272,13658,17239,2746,110,33864,1414,7381,1779,10574,850,961,1811
2019-08-08,16,6982,7514,3343,14321,18012,2866,111,35424,1386,7067,1753,10206,916,1178,2094
2019-08-08,17,6987,7416,3371,15019,18434,2994,112,36681,1341,6515,1610,9466,990,1359,2349
2019-08-08,18,6909,7247,3366,15515,18329,3090,109,37170,1198,5289,1342,7829,1008,1454,2462
2019-08-08,19,6756,7011,3284,15843,17814,3075,104,36963,740,2533,724,3997,1023,1610,2633
2019-08-08,20,6524,6802,3162,15747,17013,3030,98,36011,140,289,137,566,1009,1806,2815
2019-08-08,21,6400,6693,3036,15554,16725,3053,92,35543,0,0,11,11,1035,1883,2918
2019-08-08,22,6050,6267,2889,14927,15763,2889,84,33787,0,0,0,0,1041,1957,2998
2019-08-08,23,5617,5802,2633,13710,14464,2633,75,31008,0,0,0,0,1041,1974,3015
2019-08-08,24,5216,5418,2378,12564,13142,2396,68,28301,0,0,0,0,1033,1896,2929
2019-08-09,1,4742,5005,2120,11481,11793,2187,62,25652,0,0,0,0,994,1935,2929
2019-08-09,2,4497,4832,1987,10874,11099,2075,58,24236,0,0,0,0,981,1795,2776
2019-08-09,3,4307,4736,1891,10531,10588,1998,56,23300,0,0,0,0,968,1588,2556
2019-08-09,4,4174,4734,1848,10331,10322,1972,54,22808,0,0,0,0,960,1471,2431
2019-08-09,5,4145,4840,1869,10439,10348,1982,54,22948,0,0,0,0,920,1362,2282
2019-08-09,6,4166,5029,1981,10927,10816,2076,56,24000,0,0,0,0,894,1256,2150
2019-08-09,7,4234,5235,2120,11578,11412,2213,57,25380,62,500,77,639,876,1176,2052
2019-08-09,8,4455,5532,2284,12095,11900,2339,62,26526,597,3195,617,4409,846,1008,1854
2019-08-09,9,4752,5827,2415,12260,12352,2383,68,27184,1144,5747,1247,8138,795,804,1599
2019-08-09,10,5084,6095,2532,12226,12755,2292,74,27468,1357,6575,1594,9526,743,671,1414
2019-08-09,11,5399,6343,2637,12260,13275,2244,81,27986,1393,7049,1736,10178,705,627,1332
2019-08-09,12,5732,6543,2716,12325,13790,2241,88,28566,1411,7266,1779,10456,672,732,1404
2019-08-09,13,6037,6768,2807,12483,14331,2278,94,29308,1420,7360,1787,10567,690,857,1547
2019-08-09,14,6295,6936,2897,12949,15162,2371,98,30706,1419,7354,1790,10563,725,1037,1762
2019-08-09,15,6545,7083,2966,13532,15981,2451,101,32195,1415,7284,1785,10484,786,1340,2126
2019-08-09,16,6725,7155,3020,14178,16749,2560,103,33720,1398,6944,1766,10108,843,1637,2480
2019-08-09,17,6741,7131,3020,14746,17085,2657,104,34723,1363,6383,1632,9378,891,1913,2804
2019-08-09,18,6674,7029,2979,15198,17063,2775,102,35266,1240,5217,1363,7820,894,2168,3062
2019-08-09,19,6488,6894,2906,15442,16550,2788,98,35007,797,2452,739,3988,886,2369,3255
2019-08-09,20,6211,6630,2789,15328,15772,2783,92,34104,144,263,139,546,862,2340,3202
2019-08-09,21,6043,6476,2706,15111,15420,2805,86,33551,0,0,14,14,832,2349,3181
2019-08-09,22,5729,6105,2603,14512,14626,2722,79,32067,0,0,0,0,816,2363,3179
2019-08-09,23,5354,5663,2403,13474,13633,2535,71,29843,0,0,0,0,781,2407,3188
2019-08-09,24,4982,5274,2184,12469,12525,2324,65,27513,0,0,0,0,740,2487,3227
2019-08-10,1,4614,4916,1916,11385,11348,2197,57,25107,0,0,0,0,675,2324,2999
2019-08-10,2,4358,4762,1799,10745,10748,2068,53,23734,0,0,0,0,621,2247,2868
2019-08-10,3,4164,4666,1722,10345,10242,1981,51,22740,0,0,0,0,583,2236,2819
2019-08-10,4,4025,4634,1678,10112,9947,1941,50,22173,0,0,0,0,550,2193,2743
2019-08-10,5,3963,4676,1669,10081,9867,1929,49,22057,0,0,0,0,545,2140,2685
2019-08-10,6,3928,4736,1712,10260,9997,1948,50,22386,0,0,0,0,518,2075,2593
2019-08-10,7,3831,4820,1748,10473,9949,1957,49,22560,71,496,80,647,498,1955,2453
2019-08-10,8,3970,5073,1866,10653,10091,2004,53,22926,716,3217,660,4593,476,1765,2241
2019-08-10,9,4259,5381,2006,10849,10409,2054,58,23492,1253,5844,1305,8402,460,1573,2033
2019-08-10,10,4578,5667,2110,10914,10735,2036,64,23870,1374,6795,1603,9772,425,1331,1756
2019-08-10,11,4892,5938,2185,11025,11179,2002,70,24396,1409,7255,1752,10416,420,1247,1667
2019-08-10,12,5189,6160,2255,11143,11684,1972,77,24995,1424,7463,1787,10674,458,1364,1822
2019-08-10,13,5463,6380,2305,11294,12219,1995,82,25710,1422,7503,1789,10714,416,1538,1954
2019-08-10,14,5717,6550,2348,11605,12860,2060,86,26731,1419,7486,1790,10695,447,1846,2293
2019-08-10,15,5966,6717,2387,12027,13554,2157,90,27949,1414,7384,1783,10581,502,2126,2628
2019-08-10,16,6203,6871,2404,12662,14267,2291,92,29431,1393,7054,1730,10177,562,2382,2944
2019-08-10,17,6349,6928,2391,13340,14831,2417,96,30802,1359,6529,1594,9482,626,2586,3212
2019-08-10,18,6338,6860,2427,13941,15099,2598,94,31853,1231,5339,1319,7889,671,2683,3354
2019-08-10,19,6140,6701,2377,14247,14913,2692,91,32065,784,2522,708,4014,719,2647,3366
2019-08-10,20,5879,6483,2300,14215,14338,2694,84,31453,144,274,130,548,719,2623,3342
2019-08-10,21,5731,6314,2278,14107,14164,2722,79,31194,2,0,12,14,705,2625,3330
2019-08-10,22,5425,5930,2216,13683,13651,2656,72,30183,0,0,0,0,702,2622,3324
2019-08-10,23,5086,5529,2074,12784,12762,2490,65,28219,0,0,0,0,690,2583,3273
2019-08-10,24,4753,5167,1916,11874,11803,2286,59,26140,0,0,0,0,672,2534,3206
2019-08-11,1,4603,4827,1797,11281,10936,2169,55,24570,0,0,0,0,640,2679,3319
2019-08-11,2,4366,4658,1704,10623,10391,2045,52,23239,0,0,0,0,607,2597,3204
2019-08-11,3,4193,4553,1643,10172,9939,1977,50,22263,0,0,0,0,572,2525,3097
2019-08-11,4,4060,4505,1612,9898,9660,1934,49,21666,0,0,0,0,545,2449,2994
2019-08-11,5,3978,4490,1611,9798,9556,1919,49,21445,0,0,0,0,514,2317,2831
2019-08-11,6,3937,4479,1633,9832,9580,1946,49,21531,0,0,0,0,493,2104,2597
2019-08-11,7,3811,4501,1634,9743,9408,1957,49,21281,71,467,79,617,432,1891,2323
2019-08-11,8,3963,4713,1725,9754,9542,1979,52,21454,714,3160,654,4528,355,1505,1860
2019-08-11,9,4286,4997,1899,9939,9807,2016,58,21942,1261,5815,1307,8383,244,1096,1340
2019-08-11,10,4627,5254,2026,9980,10194,1992,63,22357,1382,6844,1608,9834,161,758,919
2019-08-11,11,4922,5489,2092,10060,10685,1949,69,22886,1419,7317,1757,10493,116,532,648
2019-08-11,12,5259,5747,2139,10247,11266,1941,75,23649,1433,7548,1790,10771,88,485,573
2019-08-11,13,5568,5937,2183,10593,11919,1972,80,24685,1433,7592,1792,10817,77,510,587
2019-08-11,14,5868,6107,2234,11152,12690,2052,85,26100,1432,7586,1792,10810,85,591,676
2019-08-11,15,6180,6267,2304,11881,13474,2153,88,27715,1423,7525,1788,10736,114,858,972
2019-08-11,16,6489,6415,2356,12739,14277,2314,92,29542,1400,7190,1760,10350,185,1187,1372
2019-08-11,17,6632,6489,2427,13748,14889,2494,95,31347,1359,6641,1630,9630,329,1578,1907
2019-08-11,18,6671,6415,2488,14508,15266,2653,96,32645,1220,5404,1347,7971,441,1942,2383
2019-08-11,19,6489,6192,2495,14959,15081,2741,94,32996,752,2467,713,3932,506,2175,2681
2019-08-11,20,6231,6097,2436,14909,14557,2752,87,32427,135,265,121,521,553,2289,2842
2019-08-11,21,6064,5978,2401,14906,14380,2804,81,32293,2,0,12,14,562,2270,2832
2019-08-11,22,5711,5629,2303,14270,13873,2668,74,31007,0,0,0,0,568,2211,2779
2019-08-11,23,5275,5223,2098,12988,12814,2449,66,28440,0,0,0,0,601,2107,2708
2019-08-11,24,4874,4885,1914,11901,11756,2241,59,26084,0,0,0,0,615,1885,2500
2019-08-12,1,4570,4705,1817,11141,11118,2097,55,24530,0,0,0,0,624,1860,2484
2019-08-12,2,4305,4559,1747,10600,10660,2009,52,23441,0,0,0,0,628,1643,2271
2019-08-12,3,4123,4484,1703,10241,10303,1959,50,22675,0,0,0,0,605,1441,2046
2019-08-12,4,3991,4493,1693,10080,10154,1934,49,22335,0,0,0,0,541,1276,1817
2019-08-12,5,3965,4656,1746,10191,10342,1981,50,22683,0,0,0,0,457,1123,1580
2019-08-12,6,4027,4906,1903,10710,10956,2100,53,23938,0,0,0,0,365,982,1347
2019-08-12,7,4078,5127,2115,11461,11543,2252,55,25424,68,466,78,612,359,838,1197
2019-08-12,8,4288,5402,2261,12086,12025,2354,60,26646,707,3219,651,4577,323,587,910
2019-08-12,9,4619,5660,2357,12319,12509,2388,64,27398,1257,5963,1312,8532,229,323,552
2019-08-12,10,4998,5892,2434,12396,12988,2372,70,27943,1381,6931,1612,9924,152,160,312
2019-08-12,11,5377,6106,2499,12611,13596,2350,76,28751,1417,7402,1759,10578,103,114,217
2019-08-12,12,5745,6279,2554,13016,14217,2361,83,29794,1428,7642,1794,10864,81,113,194
2019-08-12,13,6093,6456,2643,13535,14923,2422,89,31082,1430,7664,1795,10889,74,126,200
2019-08-12,14,6452,6586,2731,14244,15789,2525,93,32751,1427,7662,1796,10885,100,136,236
2019-08-12,15,6778,6708,2808,14960,16615,2633,97,34407,1423,7597,1794,10814,161,167,328
2019-08-12,16,7088,6823,2863,15737,17384,2754,99,36075,1407,7280,1765,10452,263,239,502
2019-08-12,17,7241,6838,2909,16461,17904,2898,100,37468,1374,6714,1630,9718,383,402,785
2019-08-12,18,7214,6777,2961,17056,17958,2995,101,38219,1245,5478,1341,8064,472,651,1123
2019-08-12,19,7080,6547,2922,17350,17538,2979,98,38082,769,2484,715,3968,505,1002,1507
2019-08-12,20,6801,6404,2825,17095,16874,2951,92,37130,135,255,126,516,514,1428,1942
2019-08-12,21,6547,6264,2753,16593,16411,2969,85,36176,2,0,14,16,526,1553,2079
2019-08-12,22,6103,5841,2589,15635,15387,2817,76,34032,0,0,0,0,556,1588,2144
2019-08-12,23,5601,5364,2330,14131,14063,2555,68,30937,0,0,0,0,584,1597,2181
2019-08-12,24,5142,5009,2113,12857,12765,2319,61,28124,0,0,0,0,608,1420,2028
2019-08-13,1,4696,4864,2010,11833,12020,2213,58,26243,0,0,0,0,640,1165,1805
2019-08-13,2,4413,4725,1921,11233,11411,2093,55,24911,0,0,0,0,600,1019,1619
2019-08-13,3,4222,4649,1862,10797,10959,2021,53,23951,0,0,0,0,522,893,1415
2019-08-13,4,4081,4664,1833,10534,10751,1979,52,23438,0,0,0,0,464,789,1253
2019-08-13,5,4043,4813,1867,10624,10872,2006,53,23675,0,0,0,0,415,683,1098
2019-08-13,6,4109,5060,2012,11119,11456,2127,55,24876,0,0,0,0,359,531,890
2019-08-13,7,4121,5264,2194,11970,12049,2253,57,26442,63,454,76,593,342,383,725
2019-08-13,8,4368,5517,2346,12527,12558,2379,62,27627,703,3195,648,4546,281,192,473
2019-08-13,9,4708,5757,2437,12683,12995,2434,67,28279,1256,5963,1313,8532,178,104,282
2019-08-13,10,5096,5985,2512,12772,13494,2375,73,28814,1382,6944,1622,9948,114,95,209
2019-08-13,11,5500,6229,2580,13007,14131,2378,80,29695,1417,7405,1769,10591,64,102,166
2019-08-13,12,5912,6446,2668,13345,14881,2430,87,30843,1428,7653,1802,10883,43,119,162
2019-08-13,13,6303,6706,2776,13948,15716,2548,94,32405,1430,7678,1801,10909,44,140,184
2019-08-13,14,6678,6919,2885,14859,16691,2684,99,34433,1426,7676,1802,10904,67,187,254
2019-08-13,15,7037,7114,2979,15843,17708,2828,102,36581,1423,7613,1802,10838,84,250,334
2019-08-13,16,7318,7272,3054,16753,18503,2935,105,38396,1408,7310,1781,10499,126,353,479
2019-08-13,17,7407,7329,3121,17498,18881,3058,106,39643,1376,6742,1640,9758,189,496,685
2019-08-13,18,7360,7247,3155,17951,18910,3179,105,40244,1247,5480,1346,8073,267,633,900
2019-08-13,19,7216,7088,3103,18088,18391,3176,101,39858,766,2471,710,3947,324,841,1165
2019-08-13,20,6934,6868,3000,17792,17634,3128,94,38757,133,248,121,502,354,1140,1494
2019-08-13,21,6695,6658,2907,17414,17246,3107,87,37963,2,0,12,14,388,1268,1656
2019-08-13,22,6254,6168,2728,16276,16154,2996,78,35616,0,0,0,0,421,1263,1684
2019-08-13,23,5747,5653,2447,14642,14678,2753,70,32260,0,0,0,0,442,1247,1689
2019-08-13,24,5262,5254,2208,13271,13332,2515,64,29300,0,0,0,0,434,1137,1571
2019-08-14,1,4813,5009,2075,12235,12196,2215,60,26837,0,0,0,0,423,901,1324
2019-08-14,2,4518,4847,1968,11522,11447,2088,57,25246,0,0,0,0,384,802,1186
2019-08-14,3,4315,4754,1898,11087,10968,2008,55,24255,0,0,0,0,335,735,1070
2019-08-14,4,4165,4760,1867,10805,10677,1969,54,23642,0,0,0,0,296,680,976
2019-08-14,5,4115,4896,1900,10858,10738,1991,55,23776,0,0,0,0,279,623,902
2019-08-14,6,4181,5153,2039,11343,11274,2109,57,24919,0,0,0,0,222,535,757
2019-08-14,7,4185,5371,2214,12120,11837,2229,59,26388,60,432,71,563,203,426,629
2019-08-14,8,4414,5645,2369,12665,12353,2336,64,27553,701,3198,633,4532,168,286,454
2019-08-14,9,4749,5911,2473,12974,12938,2397,70,28511,1254,6051,1304,8609,109,188,297
2019-08-14,10,5145,6180,2561,13217,13604,2400,76,29431,1381,7027,1616,10024,72,151,223
2019-08-14,11,5567,6445,2656,13722,14449,2450,84,30824,1414,7489,1763,10666,56,152,208
2019-08-14,12,5985,6672,2750,14315,15407,2552,92,32479,1426,7738,1793,10957,41,182,223
2019-08-14,13,6398,6942,2864,15131,16493,2690,99,34526,1432,7750,1795,10977,33,209,242
2019-08-14,14,6803,7164,2979,16288,17726,2852,104,37082,1428,7741,1796,10965,37,242,279
2019-08-14,15,7166,7354,3081,17377,18795,3002,107,39395,1426,7675,1796,10897,56,321,377
2019-08-14,16,7429,7494,3157,18408,19705,3165,110,41500,1411,7373,1767,10551,109,497,606
2019-08-14,17,7480,7528,3224,19219,20076,3278,111,42796,1380,6808,1634,9822,217,734,951
2019-08-14,18,7427,7488,3229,19829,20060,3396,109,43507,1246,5517,1332,8095,299,963,1262
2019-08-14,19,7286,7209,3170,20066,19423,3314,105,43023,759,2450,696,3905,354,1177,1531
2019-08-14,20,7013,6994,3051,19716,18569,3232,98,41732,132,248,118,498,401,1488,1889
2019-08-14,21,6781,6772,2961,19162,17969,3197,90,40538,3,0,1,4,390,1639,2029
2019-08-14,22,6334,6280,2784,18036,16817,3031,82,38085,0,0,0,0,419,1713,2132
2019-08-14,23,5811,5755,2506,16324,15208,2755,73,34482,0,0,0,0,464,1771,2235
2019-08-14,24,5336,5354,2260,14746,13689,2484,66,31115,0,0,0,0,482,1725,2207
2019-08-15,1,4941,5106,2084,13220,12352,2279,62,28046,0,0,0,0,500,1751,2251
2019-08-15,2,4647,4931,1963,12402,11576,2144,58,26325,0,0,0,0,459,1643,2102
2019-08-15,3,4417,4832,1885,11933,11025,2059,56,25224,0,0,0,0,392,1562,1954
2019-08-15,4,4260,4830,1851,11612,10789,2024,54,24632,0,0,0,0,370,1485,1855
2019-08-15,5,4214,4959,1884,11625,10848,2049,55,24715,0,0,0,0,356,1359,1715
2019-08-15,6,4251,5210,2025,12117,11344,2172,58,25826,0,0,0,0,305,1203,1508
2019-08-15,7,4281,5417,2199,12965,11878,2319,60,27355,56,420,64,540,270,1070,1340
2019-08-15,8,4502,5711,2351,13514,12477,2427,64,28617,700,3143,628,4471,225,847,1072
2019-08-15,9,4865,5995,2452,13663,12914,2494,70,29292,1253,6008,1299,8560,156,612,768
2019-08-15,10,5275,6281,2554,14017,13515,2529,77,30293,1383,6977,1610,9970,111,440,551
2019-08-15,11,5701,6551,2650,14510,14393,2574,86,31714,1421,7436,1763,10620,81,343,424
2019-08-15,12,6153,6774,2735,15165,15289,2640,94,33323,1432,7676,1795,10903,57,367,424
2019-08-15,13,6587,7038,2841,16035,16353,2728,102,35352,1435,7696,1795,10926,52,447,499
2019-08-15,14,7000,7250,2944,17187,17593,2847,108,37869,1431,7685,1794,10910,68,578,646
2019-08-15,15,7361,7427,3028,18227,18630,2999,111,40100,1427,7628,1791,10846,117,892,1009
2019-08-15,16,7598,7573,3105,19207,19426,3131,114,42012,1414,7327,1766,10507,219,1280,1499
2019-08-15,17,7589,7611,3123,20241,19865,3265,115,43619,1382,6756,1633,9771,333,1667,2000
2019-08-15,18,7522,7415,3114,20887,19809,3344,113,44286,1238,5452,1320,8010,408,2021,2429
2019-08-15,19,7363,7191,3057,20972,19190,3291,108,43696,734,2342,675,3751,450,2136,2586
2019-08-15,20,7090,7005,2940,20391,18357,3235,101,42225,120,213,113,446,500,2112,2612
2019-08-15,21,6851,6766,2867,19670,17771,3208,93,40881,2,0,1,3,526,2161,2687
2019-08-15,22,6398,6287,2705,18469,16623,3017,84,38327,0,0,0,0,557,2225,2782
2019-08-15,23,5886,5789,2452,16639,15040,2724,75,34611,0,0,0,0,603,2295,2898
2019-08-15,24,5391,5386,2219,14930,13558,2458,68,31150,0,0,0,0,626,2346,2972
2019-08-16,1,4971,5046,2042,13391,12154,2238,62,28021,0,0,0,0,631,2304,2935
2019-08-16,2,4672,4866,1924,12517,11380,2109,59,26228,0,0,0,0,591,2190,2781
2019-08-16,3,4455,4768,1845,11980,10845,2039,56,25084,0,0,0,0,544,2087,2631
2019-08-16,4,4297,4758,1810,11653,10578,2002,55,24451,0,0,0,0,515,2013,2528
2019-08-16,5,4245,4873,1836,11616,10649,2026,56,24511,0,0,0,0,493,1929,2422
2019-08-16,6,4303,5101,1954,12018,11109,2129,58,25476,0,0,0,0,445,1768,2213
2019-08-16,7,4293,5314,2112,12766,11666,2265,60,26910,52,421,52,525,428,1656,2084
2019-08-16,8,4498,5569,2262,13331,12230,2371,64,28151,674,3150,614,4438,352,1403,1755
2019-08-16,9,4852,5874,2384,13782,12767,2440,70,29192,1238,6016,1283,8537,275,1188,1463
2019-08-16,10,5244,6154,2475,14118,13263,2440,76,30031,1375,6979,1612,9966,206,1091,1297
2019-08-16,11,5639,6399,2565,14479,13968,2437,84,31102,1415,7441,1764,10620,157,1047,1204
2019-08-16,12,6043,6590,2635,14980,14708,2442,93,32358,1427,7686,1793,10906,136,1133,1269
2019-08-16,13,6478,6794,2713,15700,15528,2494,100,33955,1430,7712,1794,10936,124,1293,1417
2019-08-16,14,6870,6972,2798,16666,16682,2586,106,36174,1425,7705,1793,10923,129,1501,1630
2019-08-16,15,7224,7120,2865,17522,17657,2702,111,38126,1420,7639,1788,10847,227,1704,1931
2019-08-16,16,7446,7195,2912,18619,18423,2833,114,40123,1407,7338,1768,10513,333,1859,2192
2019-08-16,17,7432,7190,2964,19459,18788,2951,115,41448,1375,6756,1627,9758,483,1989,2472
2019-08-16,18,7381,7069,2938,19978,18753,3052,113,42029,1228,5428,1310,7966,560,2020,2580
2019-08-16,19,7188,6883,2850,19974,18099,3018,107,41344,691,2313,651,3655,612,1918,2530
2019-08-16,20,6902,6620,2721,19566,17234,2976,100,40035,105,209,104,418,689,1962,2651
2019-08-16,21,6663,6445,2655,19012,16701,2964,92,38920,1,0,0,1,748,1979,2727
2019-08-16,22,6252,6048,2528,17681,15835,2821,83,36570,0,0,0,0,789,1967,2756
2019-08-16,23,5802,5617,2331,15900,14568,2601,75,33294,0,0,0,0,827,2002,2829
2019-08-16,24,5360,5240,2132,14340,13260,2380,67,30204,0,0,0,0,844,1937,2781
2019-08-17,1,5040,5024,1977,12660,11675,2155,61,26716,0,0,0,0,842,1842,2684
2019-08-17,2,4746,4831,1871,11839,10973,2021,57,25049,0,0,0,0,830,1759,2589
2019-08-17,3,4516,4713,1798,11279,10468,1949,55,23909,0,0,0,0,826,1705,2531
2019-08-17,4,4333,4653,1755,10884,10175,1908,53,23178,0,0,0,0,835,1643,2478
2019-08-17,5,4236,4669,1748,10741,10161,1905,53,23026,0,0,0,0,820,1602,2422
2019-08-17,6,4207,4729,1790,10844,10406,1944,54,23410,0,0,0,0,763,1498,2261
2019-08-17,7,4108,4796,1830,11100,10527,1993,54,23836,47,394,50,491,719,1360,2079
2019-08-17,8,4259,5044,1934,11276,10669,2042,56,24208,651,3085,607,4343,675,1132,1807
2019-08-17,9,4607,5339,2094,11588,11088,2071,62,24966,1229,5954,1280,8463,599,922,1521
2019-08-17,10,5018,5646,2201,11857,11496,2059,70,25629,1373,6933,1612,9918,533,852,1385
2019-08-17,11,5406,5933,2282,12185,11959,2024,78,26385,1415,7414,1767,10596,475,832,1307
2019-08-17,12,5813,6182,2368,12455,12469,2003,86,27147,1427,7654,1803,10884,449,894,1343
2019-08-17,13,6176,6419,2439,12807,13026,2039,93,28116,1430,7669,1801,10900,466,1009,1475
2019-08-17,14,6517,6594,2515,13408,13776,2085,99,29520,1427,7662,1799,10888,531,1162,1693
2019-08-17,15,6810,6780,2596,14045,14525,2168,103,30984,1424,7596,1795,10815,629,1373,2002
2019-08-17,16,7047,6923,2682,14766,15266,2320,106,32615,1409,7273,1769,10451,742,1559,2301
2019-08-17,17,7144,7000,2771,15541,15842,2475,110,34126,1375,6655,1631,9661,844,1704,2548
2019-08-17,18,7117,6930,2811,15895,15978,2622,107,34760,1223,5291,1307,7821,891,1723,2614
2019-08-17,19,6896,6779,2753,15968,15542,2690,102,34462,676,2206,636,3518,934,1676,2610
2019-08-17,20,6619,6551,2641,15599,14958,2713,94,33524,92,190,94,376,977,1721,2698
2019-08-17,21,6392,6363,2581,15160,14712,2728,87,32845,1,0,2,3,996,1718,2714
2019-08-17,22,5995,5988,2430,14539,14010,2608,79,31393,0,0,0,0,1007,1685,2692
2019-08-17,23,5560,5574,2221,13486,13000,2420,71,29135,0,0,0,0,1012,1679,2691
2019-08-17,24,5142,5224,2041,12455,12000,2232,64,26917,0,0,0,0,993,1601,2594
2019-08-18,1,4761,4954,1908,7834,10995,2030,58,21078,0,0,0,0,884,1601,2485
2019-08-18,2,4478,4779,1816,7403,10391,1915,55,19924,0,0,0,0,854,1492,2346
2019-08-18,3,4258,4660,1750,7123,9938,1857,52,19136,0,0,0,0,815,1347,2162
2019-08-18,4,4086,4586,1709,6938,9669,1820,50,18645,0,0,0,0,762,1254,2016
2019-08-18,5,3992,4574,1702,6849,9546,1811,50,18423,0,0,0,0,712,1129,1841
2019-08-18,6,3953,4594,1727,6921,9584,1847,51,18569,0,0,0,0,639,949,1588
2019-08-18,7,3832,4644,1749,6998,9464,1875,51,18555,43,330,38,411,588,786,1374
2019-08-18,8,3964,4891,1836,6941,9474,1891,54,18527,611,2750,532,3893,559,556,1115
2019-08-18,9,4296,5156,1991,6984,9719,1914,60,18840,1210,5492,1220,7922,475,375,850
2019-08-18,10,4665,5480,2098,6943,9982,1860,66,19011,1366,6471,1570,9407,396,291,687
2019-08-18,11,5054,5772,2209,6930,10264,1787,73,19213,1408,6958,1731,10097,348,280,628
2019-08-18,12,5419,6093,2310,6979,10750,1754,80,19725,1418,7219,1773,10410,345,360,705
2019-08-18,13,5781,6371,2405,7158,11364,1767,86,20536,1424,7277,1770,10471,384,472,856
2019-08-18,14,6138,6638,2507,7477,12140,1831,91,21703,1419,7256,1770,10445,449,623,1072
2019-08-18,15,6470,6890,2612,7910,12970,1916,95,23051,1415,7136,1765,10316,556,813,1369
2019-08-18,16,6742,7093,2717,8490,13849,2084,100,24681,1400,6748,1729,9877,672,1058,1730
2019-08-18,17,6855,7208,2817,9098,14497,2274,103,26132,1366,6071,1590,9027,773,1308,2081
2019-08-18,18,6868,7206,2886,9639,14868,2450,103,27213,1212,4715,1264,7191,825,1379,2204
2019-08-18,19,6677,6990,2852,9985,14712,2562,99,27514,647,1965,588,3200,875,1497,2372
2019-08-18,20,6428,6777,2755,9976,14290,2616,92,27133,89,165,75,329,902,1574,2476
2019-08-18,21,6222,6576,2696,9843,14127,2649,86,26864,1,0,0,1,919,1608,2527
2019-08-18,22,5832,6124,2524,9336,13431,2523,78,25527,0,0,0,0,941,1580,2521
2019-08-18,23,5366,5651,2279,8539,12396,2314,69,23478,0,0,0,0,958,1536,2494
2019-08-18,24,4951,5272,2063,7712,11415,2129,61,21479,0,0,0,0,946,1458,2404
2019-08-19,1,4615,5001,1929,10665,10954,2063,55,23894,0,0,0,0,839,1373,2212
2019-08-19,2,4355,4845,1835,10215,10392,1959,52,22777,0,0,0,0,801,1375,2176
2019-08-19,3,4157,4776,1777,9929,10097,1927,50,22164,0,0,0,0,761,1311,2072
2019-08-19,4,4023,4792,1760,9826,9941,1906,49,21887,0,0,0,0,717,1249,1966
2019-08-19,5,3981,4941,1810,10019,10119,1948,51,22303,0,0,0,0,671,1166,1837
2019-08-19,6,4078,5225,1958,10618,10738,2075,54,23648,0,0,0,0,608,885,1493
2019-08-19,7,4092,5450,2149,11485,11385,2244,56,25334,37,363,36,436,545,878,1423
2019-08-19,8,4285,5761,2315,12080,11906,2346,60,26554,564,3076,526,4166,494,641,1135
2019-08-19,9,4604,6078,2429,12219,12324,2388,65,27161,1157,6075,1219,8451,408,432,840
2019-08-19,10,4966,6391,2528,12185,12727,2359,70,27505,1345,7060,1579,9984,327,311,638
2019-08-19,11,5338,6692,2630,12202,13225,2317,77,27984,1387,7519,1727,10633,276,278,554
2019-08-19,12,5719,6974,2719,12267,13825,2312,84,28645,1399,7742,1771,10912,255,352,607
2019-08-19,13,6102,7255,2824,12467,14513,2365,90,29594,1405,7791,1771,10967,264,440,704
2019-08-19,14,6462,7479,2929,13002,15412,2452,95,31120,1404,7786,1767,10957,302,571,873
2019-08-19,15,6775,7666,3013,13600,16350,2566,99,32779,1398,7713,1765,10876,356,722,1078
2019-08-19,16,7013,7802,3077,14260,17195,2677,102,34395,1391,7406,1738,10535,404,892,1296
2019-08-19,17,7085,7823,3133,14859,17800,2807,103,35727,1357,6822,1598,9777,471,1068,1539
2019-08-19,18,7039,7664,3181,15345,17891,2902,103,36401,1198,5441,1275,7914,557,1251,1808
2019-08-19,19,6894,7413,3103,15532,17338,2901,99,36032,638,2264,602,3504,620,1462,2082
2019-08-19,20,6666,7205,2988,15383,16682,2911,93,35230,80,201,75,356,656,1638,2294
2019-08-19,21,6421,6937,2915,15232,16256,2917,85,34651,1,2,0,3,722,1725,2447
2019-08-19,22,5980,6401,2712,14385,15234,2746,77,32602,0,0,0,0,752,1710,2462
2019-08-19,23,5485,5856,2435,13123,13881,2490,68,29721,0,0,0,0,770,1687,2457
2019-08-19,24,5023,5443,2201,12054,12621,2264,61,27159,0,0,0,0,784,1586,2370
2019-08-20,1,4697,5189,2090,11139,11432,2169,57,24952,0,0,0,0,920,1518,2438
2019-08-20,2,4419,5009,1985,10635,10783,2063,54,23674,0,0,0,0,910,1462,2372
2019-08-20,3,4227,4902,1912,10297,10386,1988,52,22860,0,0,0,0,883,1381,2264
2019-08-20,4,4080,4883,1878,10168,10186,1963,51,22505,0,0,0,0,859,1234,2093
2019-08-20,5,4037,5019,1908,10312,10358,1993,52,22851,0,0,0,0,847,1121,1968
2019-08-20,6,4116,5287,2046,10858,10950,2122,55,24123,0,0,0,0,822,934,1756
2019-08-20,7,4134,5489,2233,11689,11727,2285,57,25899,35,354,37,426,809,818,1627
2019-08-20,8,4355,5778,2385,12195,12188,2387,62,26979,613,3059,544,4216,778,635,1413
2019-08-20,9,4680,6092,2491,12355,12709,2423,66,27717,1215,6097,1253,8565,703,492,1195
2019-08-20,10,5052,6402,2589,12291,13195,2419,72,28139,1367,7061,1590,10018,646,393,1039
2019-08-20,11,5442,6692,2683,12234,13843,2423,79,28741,1406,7544,1737,10687,594,350,944
2019-08-20,12,5847,6944,2789,12255,14553,2446,86,29503,1418,7784,1767,10969,535,408,943
2019-08-20,13,6234,7214,2908,12457,15413,2511,93,30636,1418,7796,1765,10979,503,496,999
2019-08-20,14,6606,7432,3031,13016,16480,2615,98,32369,1413,7789,1760,10962,522,647,1169
2019-08-20,15,6943,7616,3132,13653,17492,2750,102,34157,1408,7714,1758,10880,636,911,1547
2019-08-20,16,7181,7750,3211,14320,18349,2887,105,35821,1397,7407,1728,10532,702,1265,1967
2019-08-20,17,7232,7798,3290,15038,18786,3027,106,37117,1362,6798,1584,9744,803,1537,2340
2019-08-20,18,7177,7654,3314,15425,18707,3122,105,37519,1202,5404,1256,7862,786,1817,2603
2019-08-20,19,7044,7398,3241,15613,18185,3099,101,37159,631,2209,581,3421,812,2131,2943
2019-08-20,20,6809,7187,3107,15479,17418,3082,94,36234,74,192,66,332,886,2308,3194
2019-08-20,21,6575,6927,3036,15309,17003,3064,87,35622,1,2,0,3,883,2356,3239
2019-08-20,22,6129,6399,2814,14474,15919,2876,78,33506,0,0,0,0,886,2386,3272
2019-08-20,23,5617,5867,2529,13202,14394,2598,70,30422,0,0,0,0,906,2361,3267
2019-08-20,24,5157,5460,2270,12112,12993,2351,63,27676,0,0,0,0,883,2266,3149
2019-08-21,1,4707,5224,2034,11267,11734,2231,58,25445,0,0,0,0,842,2323,3165
2019-08-21,2,4431,5042,1912,10733,11036,2113,56,24095,0,0,0,0,808,2252,3060
2019-08-21,3,4224,4926,1838,10394,10554,2032,54,23192,0,0,0,0,788,2225,3013
2019-08-21,4,4085,4906,1804,10215,10308,2000,53,22734,0,0,0,0,773,2134,2907
2019-08-21,5,4040,5038,1840,10340,10423,2029,54,23003,0,0,0,0,766,2064,2830
2019-08-21,6,4111,5294,1986,10880,10982,2154,57,24230,0,0,0,0,709,1849,2558
2019-08-21,7,4126,5502,2172,11706,11641,2311,59,25871,34,351,35,420,685,1781,2466
2019-08-21,8,4339,5789,2318,12142,12125,2416,63,26889,599,3053,540,4192,607,1495,2102
2019-08-21,9,4671,6118,2417,12220,12573,2450,68,27451,1211,6102,1254,8567,503,1071,1574
2019-08-21,10,5055,6442,2504,12274,13043,2476,74,28008,1362,7065,1594,10021,420,735,1155
2019-08-21,11,5465,6747,2594,12393,13656,2503,82,28767,1401,7554,1739,10694,341,590,931
2019-08-21,12,5904,7011,2674,12619,14391,2552,90,29785,1413,7795,1766,10974,283,624,907
2019-08-21,13,6325,7298,2771,13072,15230,2647,97,31182,1408,7807,1766,10981,288,675,963
2019-08-21,14,6738,7552,2870,13820,16286,2766,102,33129,1405,7795,1761,10961,327,885,1212
2019-08-21,15,7107,7758,2957,14674,17317,2918,106,35165,1400,7714,1758,10872,422,1254,1676
2019-08-21,16,7368,7902,2972,15578,18127,3064,109,37033,1387,7402,1732,10521,502,1706,2208
2019-08-21,17,7421,7959,2988,16516,18683,3207,111,38672,1350,6799,1591,9740,601,2228,2829
2019-08-21,18,7343,7806,2952,17073,18733,3287,109,39358,1187,5408,1252,7847,712,2515,3227
2019-08-21,19,7180,7552,2878,17380,18201,3236,105,39079,604,2194,566,3364,773,2646,3419
2019-08-21,20,6937,7322,2783,17240,17521,3210,97,38225,70,192,59,321,836,2729,3565
2019-08-21,21,6668,7047,2762,16867,17011,3163,89,37287,3,2,0,5,841,2740,3581
2019-08-21,22,6218,6503,2608,15854,15854,2967,80,34912,0,0,0,0,862,2737,3599
2019-08-21,23,5695,5958,2364,14310,14345,2679,71,31561,0,0,0,0,863,2725,3588
2019-08-21,24,5211,5531,2149,12995,12978,2411,64,28603,0,0,0,0,842,2679,3521
2019-08-22,1,4870,5161,1955,12038,11950,2214,59,26513,0,0,0,0,773,2676,3449
2019-08-22,2,4564,4975,1863,11404,11220,2093,56,25016,0,0,0,0,738,2573,3311
2019-08-22,3,4352,4871,1796,10970,10713,2018,54,23995,0,0,0,0,674,2463,3137
2019-08-22,4,4208,4859,1766,10756,10459,1983,53,23489,0,0,0,0,649,2379,3028
2019-08-22,5,4153,4996,1801,10870,10553,2013,54,23729,0,0,0,0,603,2150,2753
2019-08-22,6,4223,5273,1953,11432,11115,2145,57,24991,0,0,0,0,558,1892,2450
2019-08-22,7,4238,5503,2165,12317,11723,2321,59,26646,29,324,30,383,493,1733,2226
2019-08-22,8,4428,5750,2291,12869,12304,2429,63,27817,543,2961,516,4020,449,1540,1989
2019-08-22,9,4763,6059,2375,13038,12695,2482,69,28428,1173,5970,1227,8370,342,1160,1502
2019-08-22,10,5155,6359,2452,13191,13164,2491,76,29062,1320,6876,1570,9766,252,910,1162
2019-08-22,11,5568,6639,2511,13497,13827,2491,83,30044,1362,7371,1714,10447,182,872,1054
2019-08-22,12,5988,6884,2557,13903,14586,2504,91,31222,1374,7608,1750,10732,132,901,1033
2019-08-22,13,6402,7142,2623,14413,15434,2546,98,32626,1343,7569,1741,10653,123,1115,1238
2019-08-22,14,6797,7356,2692,15198,16481,2625,104,34541,1342,7533,1739,10614,130,1305,1435
2019-08-22,15,7140,7525,2752,15910,17394,2739,108,36286,1340,7407,1727,10474,174,1530,1704
2019-08-22,16,7373,7649,2804,16868,18186,2847,110,38146,1332,7046,1682,10060,237,1719,1956
2019-08-22,17,7400,7672,2841,17553,18631,2972,112,39402,1289,6414,1531,9234,323,1828,2151
2019-08-22,18,7309,7484,2875,17881,18542,3054,109,39721,1128,5009,1202,7339,429,1877,2306
2019-08-22,19,7151,7209,2824,17930,17938,3037,104,39144,572,2015,549,3136,503,1793,2296
2019-08-22,20,6910,7041,2725,17690,17177,3038,97,38136,64,167,55,286,575,1772,2347
2019-08-22,21,6644,6823,2704,17196,16739,2997,90,37158,3,2,0,5,640,1794,2434
2019-08-22,22,6199,6329,2537,16217,15636,2831,81,34900,0,0,0,0,676,1763,2439
2019-08-22,23,5692,5822,2294,14644,14168,2575,72,31595,0,0,0,0,689,1726,2415
2019-08-22,24,5229,5408,2094,13317,12823,2338,65,28787,0,0,0,0,704,1604,2308
2019-08-23,1,4766,5013,1991,12446,11885,2242,60,26767,0,0,0,0,696,1687,2383
2019-08-23,2,4481,4816,1904,11745,11183,2142,56,25259,0,0,0,0,675,1512,2187
2019-08-23,3,4274,4721,1839,11228,10761,2059,54,24236,0,0,0,0,598,1340,1938
2019-08-23,4,4141,4703,1809,10954,10528,2023,53,23692,0,0,0,0,561,1215,1776
2019-08-23,5,4099,4826,1839,10992,10628,2037,54,23844,0,0,0,0,543,1066,1609
2019-08-23,6,4159,5074,1975,11460,11179,2142,56,24971,0,0,0,0,501,865,1366
2019-08-23,7,4175,5280,2177,12110,11758,2304,58,26363,29,305,29,363,485,686,1171
2019-08-23,8,4363,5544,2303,12644,12270,2435,62,27545,561,2896,501,3958,462,470,932
2019-08-23,9,4710,5820,2405,12766,12616,2483,67,28168,1188,5883,1231,8302,393,312,705
2019-08-23,10,5101,6098,2487,13122,13022,2369,73,28823,1357,7019,1609,9985,320,252,572
2019-08-23,11,5483,6341,2550,13385,13499,2316,81,29493,1398,7484,1753,10635,282,253,535
2019-08-23,12,5870,6538,2614,13750,14156,2291,88,30493,1406,7718,1785,10909,260,306,566
2019-08-23,13,6271,6741,2692,14326,14928,2323,95,31863,1401,7756,1785,10942,268,364,632
2019-08-23,14,6667,6937,2783,15155,15913,2379,100,33743,1394,7750,1780,10924,312,460,772
2019-08-23,15,7021,7097,2869,15870,16701,2526,104,35384,1389,7659,1778,10826,409,565,974
2019-08-23,16,7276,7193,2945,16546,17434,2605,107,36856,1384,7348,1751,10483,503,706,1209
2019-08-23,17,7328,7189,3009,17115,17857,2694,108,37909,1345,6778,1599,9722,614,871,1485
2019-08-23,18,7267,7071,3018,17489,17710,2848,107,38314,1185,5302,1266,7753,728,963,1691
2019-08-23,19,7097,6869,2957,17451,17167,2873,102,37727,600,2105,550,3255,815,1046,1861
2019-08-23,20,6829,6638,2829,17037,16445,2862,95,36573,62,179,55,296,867,1112,1979
2019-08-23,21,6537,6445,2773,16632,15940,2862,88,35660,3,7,0,10,890,1078,1968
2019-08-23,22,6121,6026,2593,15581,14978,2777,79,33562,0,0,0,0,909,1011,1920
2019-08-23,23,5672,5599,2353,14387,13834,2592,71,31021,0,0,0,0,926,924,1850
2019-08-23,24,5242,5225,2137,13261,12697,2413,64,28570,0,0,0,0,911,778,1689
2019-08-24,1,4844,4876,1972,12192,11648,2173,58,26206,0,0,0,0,909,568,1477
2019-08-24,2,4566,4722,1861,11516,10992,2045,54,24741,0,0,0,0,877,505,1382
2019-08-24,3,4348,4621,1790,11025,10493,1972,52,23677,0,0,0,0,836,467,1303
2019-08-24,4,4192,4591,1750,10710,10195,1928,51,23019,0,0,0,0,802,437,1239
2019-08-24,5,4100,4621,1747,10650,10129,1931,52,22896,0,0,0,0,773,371,1144
2019-08-24,6,4076,4714,1789,10659,10303,1978,53,23126,0,0,0,0,729,292,1021
2019-08-24,7,3993,4779,1844,10842,10326,2034,54,23389,28,293,29,350,707,240,947
2019-08-24,8,4129,4994,1943,11021,10485,2073,57,23770,547,2821,512,3880,626,178,804
2019-08-24,9,4480,5267,2083,11323,10846,2099,62,24464,1173,5748,1256,8177,489,148,637
2019-08-24,10,4889,5538,2187,11560,11282,2092,68,25135,1354,6855,1610,9819,378,168,546
2019-08-24,11,5311,5829,2285,11852,11851,2061,75,25973,1391,7367,1755,10513,314,211,525
2019-08-24,12,5750,6093,2370,12288,12484,2048,83,27037,1398,7612,1785,10795,311,256,567
2019-08-24,13,6160,6350,2448,12761,13335,2083,90,28403,1395,7719,1782,10896,319,285,604
2019-08-24,14,6551,6581,2528,13413,14257,2137,96,30036,1391,7716,1778,10885,353,347,700
2019-08-24,15,6889,6817,2616,14170,15216,2236,101,31858,1389,7639,1776,10804,415,417,832
2019-08-24,16,7155,7014,2707,15074,16051,2393,105,33759,1383,7296,1752,10431,488,554,1042
2019-08-24,17,7308,7127,2769,15734,16697,2558,107,35231,1339,6702,1594,9635,554,697,1251
2019-08-24,18,7265,7086,2778,16272,16851,2712,108,36078,1163,5168,1249,7580,613,763,1376
2019-08-24,19,7036,6880,2728,16472,16401,2780,103,35889,585,2010,532,3127,646,864,1510
2019-08-24,20,6753,6686,2608,16349,15849,2816,95,35243,60,243,50,353,708,1032,1740
2019-08-24,21,6464,6451,2556,15966,15417,2816,87,34420,3,11,0,14,749,1143,1892
2019-08-24,22,6046,6004,2385,15216,14546,2674,78,32648,0,0,0,0,785,1229,2014
2019-08-24,23,5617,5572,2182,14061,13517,2485,69,30266,0,0,0,0,811,1261,2072
2019-08-24,24,5190,5207,2001,12931,12476,2297,62,27901,0,0,0,0,823,1184,2007
2019-08-25,1,4932,4900,1860,12248,12026,2239,59,26706,0,0,0,0,797,1078,1875
2019-08-25,2,4660,4736,1764,11566,11308,2120,55,25182,0,0,0,0,761,1127,1888
2019-08-25,3,4448,4636,1698,11071,10742,2041,54,24042,0,0,0,0,726,1160,1886
2019-08-25,4,4297,4581,1661,10745,10352,1990,53,23273,0,0,0,0,681,1184,1865
2019-08-25,5,4186,4595,1654,10588,10179,1971,53,22925,0,0,0,0,641,1197,1838
2019-08-25,6,4156,4654,1688,10654,10182,2000,54,23023,0,0,0,0,581,1138,1719
2019-08-25,7,4075,4693,1730,10729,10046,2040,54,23003,26,303,26,355,551,1041,1592
2019-08-25,8,4220,4888,1809,10691,10031,2065,58,22979,560,2912,499,3971,506,896,1402
2019-08-25,9,4565,5170,1948,10814,10423,2117,63,23554,1197,5957,1248,8402,402,655,1057
2019-08-25,10,4990,5450,2047,11009,10945,2130,69,24299,1352,6903,1599,9854,335,541,876
2019-08-25,11,5417,5713,2131,11344,11688,2148,77,25391,1395,7369,1740,10504,277,538,815
2019-08-25,12,5845,6019,2224,11828,12593,2205,85,26846,1400,7592,1776,10768,240,682,922
2019-08-25,13,6250,6288,2302,12522,13583,2290,93,28621,1397,7521,1770,10688,255,827,1082
2019-08-25,14,6664,6547,2376,13312,14596,2396,99,30537,1390,7502,1764,10656,277,1063,1340
2019-08-25,15,7049,6774,2451,14154,15585,2541,103,32518,1388,7399,1761,10548,329,1317,1646
2019-08-25,16,7345,6978,2534,15187,16513,2729,107,34671,1385,7042,1737,10164,392,1570,1962
2019-08-25,17,7500,7071,2643,15992,17121,2910,110,36267,1343,6411,1577,9331,458,1856,2314
2019-08-25,18,7442,6965,2667,16598,17288,3051,110,37181,1149,4888,1229,7266,472,1961,2433
2019-08-25,19,7210,6754,2655,16897,16924,3100,106,37161,563,1920,514,2997,491,2036,2527
2019-08-25,20,6962,6612,2574,16742,16370,3120,98,36464,57,233,46,336,555,2093,2648
2019-08-25,21,6688,6354,2533,16387,15920,3102,90,35633,4,11,1,16,623,2110,2733
2019-08-25,22,6259,5899,2365,15467,14993,2917,81,33591,0,0,0,0,674,2227,2901
2019-08-25,23,5758,5433,2153,14064,13741,2656,71,30667,0,0,0,0,716,2232,2948
2019-08-25,24,5315,5062,1960,12783,12625,2414,63,28019,0,0,0,0,713,2160,2873
2019-08-26,1,5137,4744,1857,12066,12119,2349,59,26727,0,0,0,0,726,2107,2833
2019-08-26,2,4855,4579,1783,11380,11370,2221,56,25161,0,0,0,0,713,2050,2763
2019-08-26,3,4644,4508,1731,10894,10882,2152,55,24115,0,0,0,0,700,1997,2697
2019-08-26,4,4487,4508,1715,10654,10697,2121,54,23659,0,0,0,0,699,1933,2632
2019-08-26,5,4415,4668,1764,10752,10840,2165,55,23946,0,0,0,0,662,1770,2432
2019-08-26,6,4490,4968,1919,11288,11459,2307,58,25247,0,0,0,0,504,1557,2061
2019-08-26,7,4534,5200,2143,12180,12208,2502,61,27092,23,232,21,276,439,1322,1761
2019-08-26,8,4750,5441,2296,12788,12742,2623,66,28368,442,2141,407,2990,369,1021,1390
2019-08-26,9,5125,5699,2398,13000,13454,2704,71,29364,1001,4578,1059,6638,282,610,892
2019-08-26,10,5560,5960,2482,13189,14151,2733,77,30284,1200,5768,1438,8406,201,349,550
2019-08-26,11,6009,6181,2553,13520,15013,2758,86,31511,1261,6359,1597,9217,160,235,395
2019-08-26,12,6446,6358,2623,13891,15885,2819,94,32824,1285,6668,1651,9604,129,203,332
2019-08-26,13,6883,6519,2714,14419,16786,2902,102,34342,1261,6829,1669,9759,132,241,373
2019-08-26,14,7267,6666,2802,15581,17723,3020,108,36566,1253,6840,1666,9759,160,271,431
2019-08-26,15,7593,6791,2880,16658,18562,3139,113,38605,1233,6726,1661,9620,260,356,616
2019-08-26,16,7809,6892,2946,17608,19262,3256,116,40376,1206,6288,1621,9115,351,521,872
2019-08-26,17,7825,6929,3019,18283,19585,3365,117,41483,1148,5619,1453,8220,509,800,1309
2019-08-26,18,7755,6762,3027,18727,19511,3430,115,41917,956,4263,1115,6334,570,1252,1822
2019-08-26,19,7606,6528,3001,18832,19111,3383,111,41571,477,1706,457,2640,652,1630,2282
2019-08-26,20,7382,6438,2905,18545,18383,3356,103,40522,47,176,38,261,751,1832,2583
2019-08-26,21,7085,6219,2832,17982,17870,3289,95,39369,1,8,0,9,809,1900,2709
2019-08-26,22,6594,5740,2613,16618,16867,3077,85,36781,0,0,0,0,859,1909,2768
2019-08-26,23,6058,5296,2344,14924,15544,2766,75,33443,0,0,0,0,893,1902,2795
2019-08-26,24,5584,4960,2127,13483,14123,2493,67,30304,0,0,0,0,913,1813,2726
2019-08-27,1,5227,4737,2053,12627,12731,2380,65,27937,0,0,0,0,884,1786,2670
2019-08-27,2,4922,4603,1964,11911,11913,2250,62,26270,0,0,0,0,868,1652,2520
2019-08-27,3,4699,4540,1900,11407,11437,2157,60,25195,0,0,0,0,833,1528,2361
2019-08-27,4,4535,4551,1867,11094,11151,2119,58,24556,0,0,0,0,790,1392,2182
2019-08-27,5,4475,4704,1897,11107,11246,2149,59,24694,0,0,0,0,756,1221,1977
2019-08-27,6,4533,5000,2045,11539,11876,2289,62,25900,0,0,0,0,685,969,1654
2019-08-27,7,4561,5204,2252,12414,12595,2478,64,27685,28,323,25,376,625,717,1342
2019-08-27,8,4766,5399,2404,12932,13268,2581,69,28996,508,2907,472,3887,567,449,1016
2019-08-27,9,5139,5604,2496,13308,13957,2648,75,30142,1172,5996,1213,8381,443,245,688
2019-08-27,10,5578,5814,2579,13543,14675,2697,83,31152,1345,7021,1587,9953,334,151,485
2019-08-27,11,6057,6010,2658,13871,15449,2729,92,32291,1384,7475,1731,10590,277,155,432
2019-08-27,12,6538,6192,2758,14410,16296,2763,101,33703,1389,7685,1766,10840,244,186,430
2019-08-27,13,7019,6413,2868,15010,17154,2834,110,35242,1385,7699,1762,10846,242,214,456
2019-08-27,14,7476,6637,2986,15964,18215,2938,116,37366,1373,7689,1756,10818,297,238,535
2019-08-27,15,7877,6846,3093,17045,19134,3075,121,39509,1368,7603,1756,10727,411,259,670
2019-08-27,16,8134,7034,3184,18067,19778,3195,123,41297,1356,7258,1739,10353,553,359,912
2019-08-27,17,8129,7092,3277,18910,20138,3310,124,42616,1313,6676,1582,9571,684,553,1237
2019-08-27,18,8023,7028,3289,19349,19933,3381,122,42919,1110,4856,1234,7200,690,781,1471
2019-08-27,19,7852,6809,3253,19543,19259,3336,116,42389,519,1817,508,2844,742,1193,1935
2019-08-27,20,7599,6632,3144,19345,18312,3323,108,41222,57,225,47,329,806,1555,2361
2019-08-27,21,7277,6386,3042,18837,17728,3256,100,40054,5,11,1,17,879,1606,2485
2019-08-27,22,6767,5872,2799,17424,16568,3035,90,37251,0,0,0,0,935,1649,2584
2019-08-27,23,6222,5390,2497,15568,14865,2737,80,33384,0,0,0,0,970,1646,2616
2019-08-27,24,5719,5038,2252,14083,13430,2477,72,30196,0,0,0,0,971,1555,2526
2019-08-28,1,5267,4924,2156,12692,12830,2466,66,28188,0,0,0,0,954,1233,2187
2019-08-28,2,4965,4782,2051,11980,11997,2359,63,26533,0,0,0,0,939,1062,2001
2019-08-28,3,4741,4709,1977,11476,11510,2254,60,25435,0,0,0,0,922,937,1859
2019-08-28,4,4584,4729,1942,11194,11144,2200,59,24731,0,0,0,0,904,879,1783
2019-08-28,5,4526,4878,1969,11232,11184,2228,60,24837,0,0,0,0,896,817,1713
2019-08-28,6,4583,5172,2110,11707,11651,2313,63,25867,0,0,0,0,876,638,1514
2019-08-28,7,4622,5377,2309,12671,12404,2542,65,27821,27,309,26,362,847,467,1314
2019-08-28,8,4801,5594,2465,13234,12930,2648,70,29037,538,2818,489,3845,812,312,1124
2019-08-28,9,5162,5842,2570,13450,13494,2719,76,29908,1194,5902,1244,8340,717,196,913
2019-08-28,10,5604,6089,2677,13587,14123,2697,84,30663,1354,6932,1606,9892,617,170,787
2019-08-28,11,6066,6363,2783,13877,14787,2729,93,31660,1391,7400,1749,10540,554,219,773
2019-08-28,12,6543,6635,2896,14248,15638,2763,102,32929,1398,7613,1779,10790,532,305,837
2019-08-28,13,7009,6950,3025,14794,16573,2834,110,34508,1394,7609,1773,10776,589,415,1004
2019-08-28,14,7444,7241,3166,15629,17709,2938,115,36541,1387,7593,1768,10748,657,557,1214
2019-08-28,15,7818,7508,3292,16569,18631,3075,119,38528,1384,7479,1768,10631,762,727,1489
2019-08-28,16,8042,7729,3386,17485,19325,3195,122,40261,1380,7156,1750,10286,854,918,1772
2019-08-28,17,7977,7806,3482,18132,19753,3310,123,41451,1338,6543,1595,9476,926,1099,2025
2019-08-28,18,7867,7723,3474,18472,19652,3381,120,41759,1135,4983,1236,7354,965,1208,2173
2019-08-28,19,7665,7465,3419,18473,18959,3336,113,41015,532,1886,512,2930,1003,1357,2360
2019-08-28,20,7432,7249,3302,17972,18186,3323,105,39721,56,249,47,352,1034,1569,2603
2019-08-28,21,7135,6917,3188,17393,17555,3256,98,38436,5,14,1,20,1050,1682,2732
2019-08-28,22,6658,6339,2949,16257,16332,3035,88,35847,0,0,0,0,1066,1808,2874
2019-08-28,23,6127,5803,2637,14618,14738,2737,79,32305,0,0,0,0,1076,1838,2914
2019-08-28,24,5655,5399,2374,13279,13317,2477,71,29277,0,0,0,0,1077,1769,2846
2019-08-29,1,5244,5106,2167,12465,12335,2375,65,27374,0,0,0,0,1039,1626,2665
2019-08-29,2,4932,4943,2044,11724,11563,2253,61,25735,0,0,0,0,1033,1569,2602
2019-08-29,3,4706,4857,1964,11308,11073,2155,59,24729,0,0,0,0,1030,1515,2545
2019-08-29,4,4548,4866,1925,11049,10813,2116,57,24169,0,0,0,0,1008,1426,2434
2019-08-29,5,4489,5022,1948,11050,10913,2147,58,24302,0,0,0,0,985,1292,2277
2019-08-29,6,4542,5338,2101,11600,11509,2279,61,25587,0,0,0,0,947,1189,2136
2019-08-29,7,4578,5562,2318,12334,12375,2466,63,27373,29,286,26,341,921,1096,2017
2019-08-29,8,4746,5784,2447,12821,12968,2576,68,28566,536,2856,491,3883,891,915,1806
2019-08-29,9,5106,6078,2554,12993,13620,2640,74,29472,1198,5860,1248,8306,812,711,1523
2019-08-29,10,5519,6374,2675,13017,14336,2682,81,30255,1357,6872,1614,9843,739,574,1313
2019-08-29,11,5957,6678,2783,13158,15203,2728,90,31317,1394,7339,1757,10490,690,510,1200
2019-08-29,12,6415,6958,2883,13402,16160,2789,99,32589,1402,7559,1786,10747,662,599,1261
2019-08-29,13,6854,7270,3000,13693,17146,2884,107,33963,1397,7602,1780,10779,682,767,1449
2019-08-29,14,7273,7539,3123,14242,18371,2999,112,35858,1390,7610,1777,10777,722,937,1659
2019-08-29,15,7618,7778,3214,14754,19298,3160,116,37462,1387,7533,1774,10694,784,1244,2028
2019-08-29,16,7822,7948,3278,15349,20245,3295,118,39142,1383,7223,1754,10360,832,1585,2417
2019-08-29,17,7754,7996,3297,16040,20579,3424,119,40296,1342,6619,1595,9556,882,1971,2853
2019-08-29,18,7624,7817,3299,16365,20340,3494,116,40449,1139,4988,1237,7364,929,2236,3165
2019-08-29,19,7426,7553,3229,16541,19638,3436,110,39860,529,1854,507,2890,969,2282,3251
2019-08-29,20,7197,7337,3134,16441,18893,3423,103,38995,55,242,45,342,998,2347,3345
2019-08-29,21,6900,7026,3042,16090,18260,3351,96,37931,5,12,1,18,999,2386,3385
2019-08-29,22,6438,6466,2832,15246,17064,3133,86,35664,0,0,0,0,1004,2402,3406
2019-08-29,23,5942,5916,2558,13924,15464,2825,77,32425,0,0,0,0,1006,2401,3407
2019-08-29,24,5464,5498,2316,12796,14061,2557,69,29617,0,0,0,0,1001,2330,3331
2019-08-30,1,5076,5171,2154,11572,12867,2364,63,27000,0,0,0,0,970,2239,3209
2019-08-30,2,4777,4989,2026,11058,12086,2243,60,25582,0,0,0,0,946,2163,3109
2019-08-30,3,4549,4887,1933,10704,11528,2157,57,24579,0,0,0,0,911,2077,2988
2019-08-30,4,4390,4883,1884,10451,11227,2113,56,23981,0,0,0,0,877,1975,2852
2019-08-30,5,4330,5010,1907,10535,11298,2140,57,24163,0,0,0,0,838,1856,2694
2019-08-30,6,4366,5290,2036,11032,11827,2258,59,25310,0,0,0,0,778,1701,2479
2019-08-30,7,4407,5507,2219,11902,12522,2442,62,27063,29,285,25,339,730,1520,2250
2019-08-30,8,4576,5759,2374,12342,13092,2556,66,28190,533,2853,483,3869,677,1266,1943
2019-08-30,9,4920,6071,2494,12259,13554,2635,71,28653,1196,5853,1243,8292,563,962,1525
2019-08-30,10,5311,6383,2616,12183,14215,2662,78,29271,1358,6865,1611,9834,470,808,1278
2019-08-30,11,5715,6675,2720,12208,15012,2686,86,30126,1395,7347,1756,10498,400,744,1144
2019-08-30,12,6122,6935,2810,12266,15858,2717,94,31069,1402,7571,1782,10755,326,850,1176
2019-08-30,13,6544,7205,2906,12554,16811,2784,102,32385,1397,7600,1776,10773,290,1062,1352
2019-08-30,14,6948,7457,3007,13170,17827,2883,107,34122,1389,7589,1773,10751,280,1305,1585
2019-08-30,15,7297,7665,3077,13831,18769,3027,111,35872,1386,7511,1773,10670,329,1567,1896
2019-08-30,16,7515,7785,3135,14464,19585,3161,114,37459,1381,7191,1751,10323,395,1875,2270
2019-08-30,17,7517,7779,3186,15203,19962,3278,115,38693,1339,6552,1586,9477,501,2106,2607
2019-08-30,18,7416,7694,3166,15570,19773,3351,114,38941,1135,4897,1209,7241,612,2210,2822
2019-08-30,19,7184,7356,3084,15636,19050,3288,108,38217,521,1817,485,2823,688,2323,3011
2019-08-30,20,6920,7137,2978,15433,18310,3268,101,37246,53,232,44,329,777,2450,3227
2019-08-30,21,6607,6821,2875,15049,17624,3195,93,36095,5,12,1,18,832,2444,3276
2019-08-30,22,6177,6335,2692,14251,16444,3019,84,33931,0,0,0,0,868,2411,3279
2019-08-30,23,5730,5862,2459,13129,15102,2782,75,31221,0,0,0,0,895,2370,3265
2019-08-30,24,5296,5454,2235,12080,13813,2547,67,28641,0,0,0,0,905,2221,3126
2019-08-31,1,4906,5249,2029,11940,12997,2445,61,27615,0,0,0,0,815,2205,3020
2019-08-31,2,4595,5046,1901,11319,12129,2289,57,25953,0,0,0,0,776,2102,2878
2019-08-31,3,4367,4915,1820,10905,11445,2201,55,24766,0,0,0,0,735,2022,2757
2019-08-31,4,4199,4851,1774,10654,11037,2141,54,24042,0,0,0,0,711,1924,2635
2019-08-31,5,4089,4868,1763,10630,10811,2135,54,23787,0,0,0,0,670,1827,2497
2019-08-31,6,4055,4987,1813,10932,10917,2167,55,24210,0,0,0,0,601,1697,2298
2019-08-31,7,4000,5053,1896,11023,10989,2237,56,24439,28,319,24,371,564,1520,2084
2019-08-31,8,4126,5276,2009,11266,11222,2279,59,24960,529,2842,461,3832,515,1257,1772
2019-08-31,9,4476,5626,2133,11546,11769,2326,65,25841,1189,5855,1227,8271,408,898,1306
2019-08-31,10,4899,5977,2248,11715,12488,2376,72,26786,1355,6895,1601,9851,309,682,991
2019-08-31,11,5330,6301,2357,11963,13379,2416,81,27981,1395,7374,1742,10511,218,639,857
2019-08-31,12,5801,6597,2441,12332,14349,2479,89,29393,1400,7590,1777,10767,164,773,937
2019-08-31,13,6251,6872,2516,12800,15472,2576,97,31105,1389,7602,1773,10764,142,1034,1176
2019-08-31,14,6693,7110,2594,13478,16548,2674,103,32953,1382,7584,1772,10738,140,1309,1449
2019-08-31,15,7084,7326,2672,14292,17586,2816,108,34964,1381,7489,1771,10641,180,1596,1776
2019-08-31,16,7387,7492,2740,15207,18393,2986,112,36833,1378,7179,1747,10304,259,1760,2019
2019-08-31,17,7546,7549,2813,16072,18907,3137,114,38364,1333,6560,1577,9470,359,1932,2291
2019-08-31,18,7496,7509,2848,16708,18956,3258,113,39170,1112,4888,1192,7192,457,2044,2501
2019-08-31,19,7210,7234,2802,17086,18397,3257,108,38986,496,1822,469,2787,510,2064,2574
2019-08-31,20,6907,7067,2726,17081,17558,3261,99,38136,49,230,43,322,618,2135,2753
2019-08-31,21,6551,6762,2643,16589,16861,3184,91,36864,5,13,1,19,694,2110,2804
2019-08-31,22,6086,6277,2460,15776,15888,3010,82,34895,0,0,0,0,732,2097,2829
2019-08-31,23,5612,5808,2243,14578,14618,2773,73,32182,0,0,0,0,784,2079,2863
2019-08-31,24,5191,5408,2050,13467,13442,2551,65,29673,0,0,0,0,811,1915,2726
2019-09-01,1,4814,5103,1875,12522,12521,2415,62,27653,0,0,0,0,709,1656,2365
2019-09-01,2,4523,4914,1779,11761,11839,2263,58,26056,0,0,0,0,680,1465,2145
2019-09-01,3,4283,4783,1715,11201,11242,2169,56,24802,0,0,0,0,658,1351,2009
2019-09-01,4,4117,4703,1677,10807,10819,2105,54,23919,0,0,0,0,653,1198,1851
2019-09-01,5,4006,4695,1667,10607,10544,2079,54,23419,0,0,0,0,636,1055,1691
2019-09-01,6,3959,4792,1694,10613,10478,2098,54,23378,0,0,0,0,602,823,1425
2019-09-01,7,3837,4876,1749,10632,10384,2096,55,23301,26,288,23,337,555,592,1147
2019-09-01,8,3968,5077,1821,10744,10545,2128,58,23610,500,2616,446,3562,495,460,955
2019-09-01,9,4357,5406,1964,10967,11100,2206,66,24473,1168,5504,1209,7881,393,288,681
2019-09-01,10,4828,5757,2068,11186,11894,2269,73,25563,1347,6583,1576,9506,307,219,526
2019-09-01,11,5345,6068,2179,11609,13000,2339,82,27194,1393,7085,1722,10200,272,198,470
2019-09-01,12,5862,6411,2288,12275,14223,2471,92,29213,1397,7323,1761,10481,246,208,454
2019-09-01,13,6341,6730,2380,13035,15578,2619,101,31467,1384,7365,1750,10499,233,258,491
2019-09-01,14,6811,7056,2472,13874,16885,2732,108,33734,1375,7350,1747,10472,263,338,601
2019-09-01,15,7211,7341,2552,14739,18066,2895,114,35948,1373,7215,1742,10330,316,449,765
2019-09-01,16,7540,7560,2641,15686,18943,3089,117,37969,1357,6917,1700,9974,392,577,969
2019-09-01,17,7657,7702,2750,16434,19436,3243,118,39365,1309,6274,1528,9111,488,735,1223
2019-09-01,18,7598,7535,2761,17081,19366,3385,117,40083,1086,4613,1130,6829,561,888,1449
2019-09-01,19,7328,7245,2746,17392,18820,3409,111,39866,466,1622,428,2516,610,1026,1636
2019-09-01,20,7096,7123,2695,17168,18291,3416,104,39113,46,216,37,299,714,1283,1997
2019-09-01,21,6734,6795,2644,16644,17582,3380,95,37837,3,10,0,13,756,1314,2070
2019-09-01,22,6289,6290,2439,15795,16580,3255,86,35855,0,0,0,0,779,1290,2069
2019-09-01,23,5835,5777,2201,14368,15251,2964,77,32794,0,0,0,0,794,1299,2093
2019-09-01,24,5393,5394,1993,12993,13823,2650,70,29670,0,0,0,0,830,1266,2096
2019-09-02,1,5002,5115,1830,11728,12579,2448,65,26954,0,0,0,0,783,1278,2061
2019-09-02,2,4724,4924,1737,11061,11748,2311,62,25315,0,0,0,0,782,1130,1912
2019-09-02,3,4511,4807,1678,10639,11209,2227,60,24270,0,0,0,0,762,1039,1801
2019-09-02,4,4358,4750,1644,10378,10869,2161,59,23601,0,0,0,0,734,877,1611
2019-09-02,5,4288,4773,1638,10293,10731,2157,59,23374,0,0,0,0,711,713,1424
2019-09-02,6,4260,4826,1684,10435,10771,2182,59,23581,0,0,0,0,687,563,1250
2019-09-02,7,4160,4859,1742,10732,10815,2237,60,23979,21,231,20,272,664,451,1115
2019-09-02,8,4245,5071,1819,10923,10873,2281,63,24290,457,2272,398,3127,622,302,924
2019-09-02,9,4582,5479,1977,11584,11416,2358,67,25579,1105,5036,1151,7292,514,173,687
2019-09-02,10,5038,5839,2099,12516,12282,2442,76,27473,1253,6182,1550,8985,419,137,556
2019-09-02,11,5508,6170,2223,13066,13450,2535,86,29297,1313,6645,1623,9581,383,141,524
2019-09-02,12,5935,6495,2335,13584,14728,2668,96,31244,1327,6821,1673,9821,354,192,546
2019-09-02,13,6328,6798,2433,14093,16045,2814,105,33208,1240,6706,1650,9596,361,271,632
2019-09-02,14,6665,7082,2527,14735,17189,2977,111,35147,1212,6660,1654,9526,390,369,759
2019-09-02,15,6971,7356,2616,15385,18135,3133,116,36903,1217,6589,1660,9466,464,463,927
2019-09-02,16,7137,7562,2715,16272,18806,3299,118,38629,1224,6218,1603,9045,570,632,1202
2019-09-02,17,7210,7706,2818,16971,19279,3422,120,39926,1203,5491,1423,8117,678,852,1530
2019-09-02,18,7156,7575,2853,17291,19328,3512,118,40383,979,3923,1033,5935,745,1060,1805
2019-09-02,19,6909,7324,2821,17333,18801,3480,112,39860,433,1374,384,2191,774,1215,1989
2019-09-02,20,6749,7193,2781,17034,18358,3491,105,39123,40,171,33,244,825,1362,2187
2019-09-02,21,6508,6895,2735,16642,17914,3415,97,38202,1,8,0,9,852,1458,2310
2019-09-02,22,6067,6327,2505,15447,16788,3189,87,35646,0,0,0,0,870,1560,2430
2019-09-02,23,5629,5803,2245,13867,15270,2874,77,32223,0,0,0,0,896,1658,2554
2019-09-02,24,5177,5388,2028,12599,13872,2609,70,29284,0,0,0,0,904,1621,2525
2019-09-03,1,4814,5020,1948,11808,12866,2548,65,27455,0,0,0,0,906,1449,2355
2019-09-03,2,4552,4841,1853,11170,12074,2417,62,25958,0,0,0,0,903,1290,2193
2019-09-03,3,4354,4748,1785,10752,11533,2324,60,24898,0,0,0,0,919,1274,2193
2019-09-03,4,4233,4736,1754,10515,11166,2277,59,24242,0,0,0,0,903,1122,2025
2019-09-03,5,4181,4890,1786,10631,11300,2305,59,24497,0,0,0,0,887,947,1834
2019-09-03,6,4257,5236,1929,11128,11802,2446,62,25622,0,0,0,0,834,708,1542
2019-09-03,7,4324,5480,2148,12047,12584,2674,64,27563,23,220,20,263,798,493,1291
2019-09-03,8,4493,5662,2289,12627,13380,2818,67,29028,466,2143,402,3011,705,308,1013
2019-09-03,9,4814,5928,2384,12750,14210,2929,73,30099,1126,4729,1175,7030,566,185,751
2019-09-03,10,5174,6190,2460,12915,15060,3034,79,31223,1321,6130,1597,9048,499,122,621
2019-09-03,11,5565,6433,2537,13173,16115,3156,87,32668,1365,6691,1663,9719,441,104,545
2019-09-03,12,5971,6658,2633,13549,17183,3284,95,34245,1368,6965,1700,10033,397,125,522
2019-09-03,13,6381,6913,2741,14092,18182,3420,102,35931,1361,6831,1699,9891,378,146,524
2019-09-03,14,6765,7134,2854,14833,19271,3573,108,37918,1347,6669,1694,9710,402,187,589
2019-09-03,15,7112,7322,2940,15465,20079,3719,112,39509,1343,6417,1693,9453,477,282,759
2019-09-03,16,7342,7468,2999,16340,20729,3869,113,41186,1342,5984,1663,8989,597,500,1097
2019-09-03,17,7373,7532,3066,17110,21049,3977,114,42384,1294,5327,1480,8101,679,831,1510
2019-09-03,18,7239,7319,3048,17472,20821,3990,111,42527,1065,3716,1091,5872,671,1061,1732
2019-09-03,19,7001,7048,3003,17497,20168,3858,104,41761,445,1283,410,2138,739,1324,2063
2019-09-03,20,6848,6964,2926,17247,19812,3868,98,41160,40,155,36,231,805,1492,2297
2019-09-03,21,6541,6629,2846,16675,19142,3722,91,39769,2,5,0,7,842,1474,2316
2019-09-03,22,6114,6072,2603,15537,17945,3462,82,37165,0,0,0,0,853,1421,2274
2019-09-03,23,5654,5566,2332,14015,16256,3110,74,33591,0,0,0,0,880,1363,2243
2019-09-03,24,5220,5191,2106,12736,14677,2797,68,30411,0,0,0,0,920,1228,2148
2019-09-04,1,4906,5152,1986,11726,13412,2662,66,28032,0,0,0,0,860,1204,2064
2019-09-04,2,4615,4985,1890,11127,12532,2512,62,26393,0,0,0,0,841,1082,1923
2019-09-04,3,4410,4871,1818,10767,11896,2398,60,25285,0,0,0,0,825,937,1762
2019-09-04,4,4266,4844,1786,10595,11530,2338,59,24689,0,0,0,0,768,751,1519
2019-09-04,5,4209,4990,1819,10717,11611,2367,59,24920,0,0,0,0,680,592,1272
2019-09-04,6,4262,5315,1961,11268,12146,2504,62,26146,0,0,0,0,596,388,984
2019-09-04,7,4334,5562,2177,12195,12902,2715,64,28055,21,211,19,251,583,255,838
2019-09-04,8,4502,5770,2318,12727,13431,2853,68,29264,443,2174,390,3007,513,182,695
2019-09-04,9,4842,6067,2421,12772,14260,2971,73,30260,1034,4924,1110,7068,431,135,566
2019-09-04,10,5237,6366,2497,12890,15123,3102,80,31381,1226,6098,1514,8838,335,114,449
2019-09-04,11,5663,6636,2580,13103,16218,3244,89,32843,1279,6560,1598,9437,278,135,413
2019-09-04,12,6115,6876,2672,13413,17376,3392,97,34469,1275,6778,1659,9712,233,197,430
2019-09-04,13,6571,7150,2771,13928,18494,3567,105,36290,1265,6487,1659,9411,200,267,467
2019-09-04,14,7029,7401,2875,14677,19646,3745,111,38347,1252,6312,1655,9219,210,368,578
2019-09-04,15,7436,7616,2970,15331,20622,3913,115,40130,1240,6144,1632,9016,250,472,722
2019-09-04,16,7715,7749,3032,16142,21389,4080,118,41862,1230,5814,1588,8632,331,676,1007
2019-09-04,17,7763,7803,3099,16998,21615,4198,118,43062,1184,4985,1379,7548,408,905,1313
2019-09-04,18,7630,7593,3098,17312,21293,4191,115,43042,955,3574,1010,5539,472,921,1393
2019-09-04,19,7376,7340,3051,17570,20590,4033,108,42441,403,1207,378,1988,508,834,1342
2019-09-04,20,7193,7227,2990,17506,20078,4020,102,41851,34,94,31,159,609,740,1349
2019-09-04,21,6830,6860,2902,17059,19443,3854,94,40598,1,0,0,1,687,692,1379
2019-09-04,22,6354,6307,2653,16062,18232,3585,85,38114,0,0,0,0,739,678,1417
2019-09-04,23,5856,5783,2377,14583,16531,3215,77,34568,0,0,0,0,800,746,1546
2019-09-04,24,5381,5391,2147,13271,14923,2879,69,31318,0,0,0,0,847,686,1533
2019-09-05,1,5057,5236,2033,11862,13713,2607,65,28399,0,0,0,0,864,454,1318
2019-09-05,2,4769,5047,1931,11264,12894,2467,61,26822,0,0,0,0,859,356,1215
2019-09-05,3,4552,4941,1859,10864,12269,2354,59,25689,0,0,0,0,858,304,1162
2019-09-05,4,4405,4923,1825,10633,11954,2291,58,25089,0,0,0,0,821,249,1070
2019-09-05,5,4340,5067,1858,10706,11987,2323,58,25220,0,0,0,0,813,228,1041
2019-09-05,6,4414,5397,2002,11293,12533,2458,61,26478,0,0,0,0,797,144,941
2019-09-05,7,4475,5650,2219,12274,13227,2673,63,28368,17,180,17,214,788,142,930
2019-09-05,8,4622,5865,2359,12698,13879,2805,67,29576,403,1879,359,2641,720,175,895
2019-09-05,9,4956,6167,2460,12732,14652,2918,73,30563,982,4235,1078,6295,629,104,733
2019-09-05,10,5334,6476,2546,12825,15554,3026,79,31674,1198,5400,1503,8101,564,123,687
2019-09-05,11,5737,6764,2636,12945,16745,3141,87,33110,1265,5918,1580,8763,528,151,679
2019-09-05,12,6155,7019,2734,13157,17930,3261,96,34647,1275,6243,1618,9136,512,166,678
2019-09-05,13,6562,7304,2846,13524,18965,3399,103,36183,1262,6237,1602,9101,549,198,747
2019-09-05,14,6963,7561,2964,14111,20084,3558,109,38055,1247,5997,1590,8834,594,253,847
2019-09-05,15,7319,7758,3043,14796,20973,3716,113,39782,1239,5787,1582,8608,678,273,951
2019-09-05,16,7577,7890,3108,15426,21635,3856,115,41206,1225,5416,1529,8170,734,354,1088
2019-09-05,17,7582,7929,3138,16025,21804,3966,116,42102,1144,4806,1327,7277,802,482,1284
2019-09-05,18,7458,7692,3136,16441,21377,3972,113,42084,884,3373,948,5205,846,615,1461
2019-09-05,19,7213,7410,3081,16451,20547,3841,106,41090,364,1130,340,1834,892,760,1652
2019-09-05,20,7061,7268,3024,16203,20022,3843,100,40303,31,94,26,151,925,896,1821
2019-09-05,21,6738,6919,2940,15774,19192,3687,93,38880,0,0,0,0,934,999,1933
2019-09-05,22,6288,6395,2695,14867,18023,3439,84,36551,0,0,0,0,939,1081,2020
2019-09-05,23,5807,5882,2425,13519,16395,3085,76,33210,0,0,0,0,954,1221,2175
2019-09-05,24,5353,5484,2193,12381,14797,2778,69,30159,0,0,0,0,961,1272,2233
2019-09-06,1,4967,5199,2058,11579,13652,2623,64,28045,0,0,0,0,956,1234,2190
2019-09-06,2,4704,5003,1944,11066,12833,2475,61,26561,0,0,0,0,951,1191,2142
2019-09-06,3,4484,4898,1865,10709,12221,2369,59,25484,0,0,0,0,934,1150,2084
2019-09-06,4,4350,4877,1828,10503,11876,2315,57,24878,0,0,0,0,916,1059,1975
2019-09-06,5,4310,5004,1853,10581,11890,2337,58,24992,0,0,0,0,892,952,1844
2019-09-06,6,4374,5301,1982,11109,12415,2470,59,26180,0,0,0,0,855,844,1699
2019-09-06,7,4436,5547,2182,12011,13102,2665,62,27965,9,151,9,169,818,776,1594
2019-09-06,8,4604,5770,2327,12489,13782,2789,65,29250,402,2171,379,2952,761,656,1417
2019-09-06,9,4923,6069,2446,12567,14567,2894,70,30226,1038,5088,1168,7294,663,465,1128
2019-09-06,10,5297,6355,2547,12574,15533,3004,76,31314,1257,6347,1605,9209,553,391,944
2019-09-06,11,5659,6599,2643,12603,16671,3124,83,32608,1304,6812,1672,9788,452,355,807
2019-09-06,12,6008,6803,2737,12819,17858,3247,91,34142,1308,7017,1710,10035,390,469,859
2019-09-06,13,6350,7026,2834,13252,18898,3380,98,35756,1346,6984,1717,10047,344,654,998
2019-09-06,14,6706,7221,2933,13825,19958,3546,103,37560,1329,6910,1715,9954,339,918,1257
2019-09-06,15,7034,7383,3004,14481,20908,3700,107,39323,1325,6791,1716,9832,393,1274,1667
2019-09-06,16,7289,7473,3049,15107,21574,3844,109,40761,1333,6396,1698,9427,434,1653,2087
2019-09-06,17,7356,7536,3101,15813,21913,3948,109,41909,1277,5676,1487,8440,518,2041,2559
2019-09-06,18,7259,7278,3085,16131,21445,3944,107,41751,1032,3849,1059,5940,657,2273,2930
2019-09-06,19,6950,6998,3008,16073,20643,3793,101,40738,380,1129,333,1842,681,2453,3134
2019-09-06,20,6759,6877,2930,15848,19826,3755,94,39651,15,82,14,111,750,2450,3200
2019-09-06,21,6412,6553,2834,15366,18917,3608,88,38107,0,0,0,0,814,2497,3311
2019-09-06,22,6018,6135,2617,14533,17674,3401,80,35817,0,0,0,0,824,2554,3378
2019-09-06,23,5625,5700,2388,13372,16191,3126,72,32898,0,0,0,0,861,2607,3468
2019-09-06,24,5229,5328,2164,12327,14724,2834,66,30078,0,0,0,0,882,2578,3460
2019-09-07,1,4799,5020,1930,11397,13047,2562,58,27191,0,0,0,0,911,2513,3424
2019-09-07,2,4527,4820,1816,10851,12239,2399,55,25668,0,0,0,0,930,2372,3302
2019-09-07,3,4320,4694,1742,10506,11628,2298,53,24610,0,0,0,0,960,2211,3171
2019-09-07,4,4164,4628,1700,10286,11198,2235,51,23896,0,0,0,0,982,2106,3088
2019-09-07,5,4057,4653,1692,10243,11067,2217,51,23704,0,0,0,0,971,2003,2974
2019-09-07,6,4028,4770,1737,10412,11182,2249,52,24020,0,0,0,0,953,1861,2814
2019-09-07,7,3984,4867,1825,10743,11338,2310,53,24569,8,163,9,180,928,1746,2674
2019-09-07,8,4080,5053,1928,10845,11502,2341,56,24870,379,2310,385,3074,913,1575,2488
2019-09-07,9,4441,5323,2070,11137,12021,2418,60,25762,1021,5315,1191,7527,874,1374,2248
2019-09-07,10,4851,5620,2162,11154,12625,2469,66,26439,1188,6539,1623,9350,847,1169,2016
2019-09-07,11,5283,5882,2259,11169,13412,2525,74,27304,1234,7040,1699,9973,824,1188,2012
2019-09-07,12,5704,6132,2348,11130,14032,2611,82,27981,1236,7272,1720,10228,851,1398,2249
2019-09-07,13,6110,6363,2423,11238,14731,2721,90,28905,1235,7307,1707,10249,876,1663,2539
2019-09-07,14,6517,6557,2501,11539,15599,2828,96,30188,1214,7273,1692,10179,911,1841,2752
2019-09-07,15,6862,6774,2572,11932,16404,2979,101,31542,1199,7148,1684,10031,979,2042,3021
2019-09-07,16,7098,6932,2634,12490,17077,3156,104,32953,1207,6751,1672,9630,1011,2234,3245
2019-09-07,17,7197,7010,2671,12970,17387,3283,105,33871,1154,6028,1448,8630,1053,2463,3516
2019-09-07,18,7072,6941,2661,13443,17317,3352,101,34340,936,4112,1029,6077,1068,2643,3711
2019-09-07,19,6728,6698,2611,13752,16756,3313,94,34041,354,1176,326,1856,1082,2620,3702
2019-09-07,20,6494,6578,2553,13862,16269,3341,87,33685,12,73,12,97,1087,2762,3849
2019-09-07,21,6152,6267,2483,13824,15672,3217,80,32919,0,0,0,0,1068,2954,4022
2019-09-07,22,5754,5877,2297,13305,14799,3036,74,31339,0,0,0,0,1055,3075,4130
2019-09-07,23,5367,5480,2120,12466,13724,2798,66,29180,0,0,0,0,1035,3177,4212
2019-09-07,24,5008,5116,1944,11649,12715,2562,60,27112,0,0,0,0,986,3223,4209
2019-09-08,1,4658,4657,1741,10666,11698,2374,55,24919,0,0,0,0,850,3160,4010
2019-09-08,2,4389,4483,1650,10246,11074,2217,52,23715,0,0,0,0,762,3148,3910
2019-09-08,3,4196,4375,1590,9918,10581,2135,49,22808,0,0,0,0,663,3136,3799
2019-09-08,4,4054,4317,1559,9705,10239,2070,48,22187,0,0,0,0,589,3096,3685
2019-09-08,5,3945,4327,1555,9639,10130,2053,48,21996,0,0,0,0,536,3083,3619
2019-09-08,6,3888,4401,1592,9707,10144,2078,48,22103,0,0,0,0,482,3097,3579
2019-09-08,7,3797,4465,1658,9911,10114,2103,49,22302,8,155,9,172,442,3098,3540
2019-09-08,8,3791,4631,1733,9891,10101,2112,50,22279,388,2296,383,3067,396,3042,3438
2019-09-08,9,4069,4809,1880,9959,10372,2170,56,22682,1047,5344,1188,7579,335,2956,3291
2019-09-08,10,4367,5027,1991,9947,10680,2210,62,23026,1276,6600,1625,9501,282,2858,3140
2019-09-08,11,4727,5240,2043,9924,11003,2190,69,23337,1330,7116,1707,10153,217,2794,3011
2019-09-08,12,5085,5504,2091,9904,11342,2215,75,23703,1332,7354,1737,10423,178,2847,3025
2019-09-08,13,5412,5699,2131,10070,11701,2300,79,24295,1337,7518,1730,10585,162,2980,3142
2019-09-08,14,5730,5880,2158,10389,12390,2413,85,25404,1326,7495,1727,10548,210,3068,3278
2019-09-08,15,5949,6051,2185,10965,13170,2554,88,26903,1327,7374,1727,10428,304,3193,3497
2019-09-08,16,6116,6185,2226,11669,13991,2710,90,28586,1325,6994,1680,9999,408,3297,3705
2019-09-08,17,6149,6257,2287,12512,14683,2833,91,30245,1272,6252,1488,9012,532,3380,3912
2019-09-08,18,6030,6120,2296,13265,14982,2922,88,31384,1007,4248,1048,6303,634,3412,4046
2019-09-08,19,5791,5911,2305,13719,14881,2928,83,31737,345,1162,319,1826,690,3398,4088
2019-09-08,20,5684,5933,2321,13938,14750,3025,78,31919,11,76,12,99,776,3377,4153
2019-09-08,21,5465,5668,2312,13834,14406,2933,73,31382,0,0,0,0,808,3285,4093
2019-09-08,22,5130,5340,2146,13161,13604,2765,67,29733,0,0,0,0,835,3148,3983
2019-09-08,23,4773,4977,1975,12201,12536,2525,60,27448,0,0,0,0,855,3020,3875
2019-09-08,24,4425,4709,1812,11227,11592,2306,55,25305,0,0,0,0,887,2891,3778
2019-09-09,1,4093,4456,1658,10197,10393,2188,49,22952,0,0,0,0,828,2713,3541
2019-09-09,2,3874,4361,1590,9825,9977,2091,46,22076,0,0,0,0,806,2642,3448
2019-09-09,3,3712,4320,1553,9588,9680,2026,44,21531,0,0,0,0,769,2547,3316
2019-09-09,4,3638,4347,1550,9561,9540,2002,44,21372,0,0,0,0,739,2417,3156
2019-09-09,5,3647,4522,1612,9765,9752,2044,45,21830,0,0,0,0,729,2294,3023
2019-09-09,6,3753,4868,1792,10331,10398,2167,47,23173,0,0,0,0,658,2128,2786
2019-09-09,7,3847,5120,2067,11276,11229,2382,51,25172,7,152,8,167,607,1950,2557
2019-09-09,8,3939,5275,2220,11880,11635,2472,53,26239,394,2296,387,3077,576,1723,2299
2019-09-09,9,4208,5450,2263,11996,11997,2513,57,26691,1102,5326,1174,7602,485,1508,1993
2019-09-09,10,4490,5610,2321,11909,12355,2521,63,26974,1308,6604,1607,9519,442,1387,1829
2019-09-09,11,4781,5745,2365,11794,12878,2519,69,27385,1344,7122,1719,10185,384,1458,1842
2019-09-09,12,5085,5866,2394,11748,13394,2534,74,27876,1344,7363,1735,10442,372,1728,2100
2019-09-09,13,5400,6030,2433,11853,13942,2593,79,28592,1336,7415,1727,10478,381,1966,2347
2019-09-09,14,5714,6194,2466,12224,14690,2673,84,29797,1321,7408,1721,10450,427,2168,2595
2019-09-09,15,6015,6390,2478,12748,15369,2776,88,31107,1323,7290,1724,10337,553,2414,2967
2019-09-09,16,6253,6535,2496,13160,15965,2910,92,32253,1323,6926,1710,9959,717,2616,3333
2019-09-09,17,6338,6608,2514,13699,16387,3024,93,33329,1281,6171,1481,8933,859,2730,3589
2019-09-09,18,6245,6540,2518,14080,16318,3090,91,33705,1004,4146,1037,6187,928,2841,3769
2019-09-09,19,6020,6307,2502,14254,15904,3049,86,33419,332,1080,308,1720,956,2905,3861
2019-09-09,20,5941,6243,2506,14340,15717,3163,82,33427,9,59,10,78,964,2970,3934
2019-09-09,21,5654,5978,2475,14104,15257,3050,76,32613,0,0,0,0,991,2959,3950
2019-09-09,22,5292,5553,2302,13299,14348,2852,69,30704,0,0,0,0,1005,2950,3955
2019-09-09,23,4923,5144,2098,12268,13074,2573,63,28103,0,0,0,0,1013,2940,3953
2019-09-09,24,4565,4830,1912,11266,11978,2333,57,25759,0,0,0,0,978,2889,3867
2019-09-10,1,4280,4535,1764,10540,11042,2215,49,24088,0,0,0,0,833,2776,3609
2019-09-10,2,4052,4419,1693,10125,10540,2099,46,23050,0,0,0,0,741,2712,3453
2019-09-10,3,3888,4372,1653,9848,10163,2030,45,22322,0,0,0,0,690,2642,3332
2019-09-10,4,3798,4405,1645,9765,9991,1979,45,22013,0,0,0,0,655,2566,3221
2019-09-10,5,3785,4577,1702,9953,10170,1997,46,22401,0,0,0,0,612,2487,3099
2019-09-10,6,3884,4927,1888,10461,10774,2120,49,23649,0,0,0,0,553,2351,2904
2019-09-10,7,3983,5165,2172,11358,11691,2324,52,25682,7,145,8,160,472,2216,2688
2019-09-10,8,4066,5286,2315,11869,12107,2442,54,26737,384,2262,377,3023,420,2019,2439
2019-09-10,9,4287,5428,2318,11970,12456,2471,57,27154,1063,5421,1164,7648,353,1799,2152
2019-09-10,10,4523,5565,2337,11802,12785,2462,60,27299,1285,6708,1627,9620,282,1633,1915
2019-09-10,11,4762,5697,2352,11652,13071,2453,64,27430,1326,7232,1704,10262,232,1550,1782
2019-09-10,12,5006,5825,2381,11490,13340,2451,70,27546,1327,7474,1713,10514,220,1777,1997
2019-09-10,13,5250,6001,2410,11385,13768,2476,75,27908,1332,7527,1713,10572,210,2128,2338
2019-09-10,14,5518,6166,2438,11667,14346,2555,79,28859,1316,7522,1718,10556,236,2375,2611
2019-09-10,15,5765,6346,2451,12035,14837,2677,83,29855,1322,7432,1729,10483,291,2570,2861
2019-09-10,16,5967,6481,2475,12529,15290,2797,86,30935,1318,7048,1702,10068,371,2761,3132
2019-09-10,17,6068,6590,2484,13065,15518,2913,88,31831,1275,6290,1483,9048,461,2930,3391
2019-09-10,18,5976,6387,2497,13608,15385,2981,86,32310,994,4208,1019,6221,550,2961,3511
2019-09-10,19,5755,6215,2488,13901,14983,2950,80,32168,322,1075,299,1696,576,2845,3421
2019-09-10,20,5673,6169,2493,14111,14918,3075,76,32409,9,60,9,78,614,2778,3392
2019-09-10,21,5452,5923,2451,13976,14553,2987,71,31846,0,0,0,0,610,2787,3397
2019-09-10,22,5117,5504,2277,13281,13811,2791,64,30205,0,0,0,0,651,2796,3447
2019-09-10,23,4743,5101,2072,12271,12682,2524,58,27790,0,0,0,0,632,2846,3478
2019-09-10,24,4377,4782,1895,11330,11730,2297,53,25656,0,0,0,0,607,2875,3482
2019-09-11,1,4033,4334,1796,10751,11135,2107,49,24246,0,0,0,0,536,2933,3469
2019-09-11,2,3826,4227,1728,10415,10567,2017,46,23244,0,0,0,0,462,3005,3467
2019-09-11,3,3680,4191,1688,10121,10157,1955,45,22473,0,0,0,0,416,2888,3304
2019-09-11,4,3600,4224,1682,9985,9934,1923,45,22096,0,0,0,0,399,2542,2941
2019-09-11,5,3585,4398,1741,10112,10102,1953,47,22433,0,0,0,0,364,2308,2672
2019-09-11,6,3694,4751,1932,10642,10712,2092,50,23725,0,0,0,0,299,1932,2231
2019-09-11,7,3777,4985,2218,11581,11646,2316,53,25841,7,142,7,156,250,1716,1966
2019-09-11,8,3848,5075,2357,11965,12051,2395,55,26704,392,2286,380,3058,191,1318,1509
2019-09-11,9,4032,5171,2352,11993,12493,2400,56,27189,1118,5521,1183,7822,131,800,931
2019-09-11,10,4245,5262,2365,11910,12694,2375,59,27277,1239,6851,1681,9771,92,426,518
2019-09-11,11,4448,5341,2387,11868,12970,2349,64,27489,1274,7377,1730,10381,63,269,332
2019-09-11,12,4639,5388,2408,11892,13312,2342,68,27828,1272,7613,1745,10630,43,191,234
2019-09-11,13,4863,5473,2442,12007,13757,2369,73,28415,1264,7653,1742,10659,38,233,271
2019-09-11,14,5119,5546,2479,12501,14421,2450,76,29653,1253,7634,1738,10625,41,232,273
2019-09-11,15,5367,5644,2511,13078,15115,2578,80,31054,1254,7541,1746,10541,51,228,279
2019-09-11,16,5584,5736,2533,13858,15786,2696,82,32628,1256,7180,1737,10173,71,240,311
2019-09-11,17,5693,5782,2569,14608,16176,2823,83,33895,1299,6414,1521,9234,113,264,377
2019-09-11,18,5666,5792,2581,15263,16211,2898,83,34673,1004,4229,1036,6269,172,320,492
2019-09-11,19,5496,5658,2574,15586,15741,2883,78,34511,308,1043,289,1640,263,424,687
2019-09-11,20,5452,5681,2585,15566,15432,3020,76,34329,8,67,8,83,324,715,1039
2019-09-11,21,5234,5481,2523,15172,15039,2928,70,33444,0,0,0,0,324,706,1030
2019-09-11,22,4891,5151,2311,14363,14182,2734,64,31576,0,0,0,0,348,569,917
2019-09-11,23,4501,4809,2094,13046,13008,2480,58,28816,0,0,0,0,374,481,855
2019-09-11,24,4171,4554,1924,11917,11963,2258,52,26405,0,0,0,0,386,399,785
2019-09-12,1,3911,4316,1872,11073,11202,2147,48,24605,0,0,0,0,364,281,645
2019-09-12,2,3712,4232,1800,10618,10669,2054,45,23529,0,0,0,0,331,273,604
2019-09-12,3,3575,4215,1756,10312,10260,1981,44,22750,0,0,0,0,273,281,554
2019-09-12,4,3495,4263,1742,10172,10058,1936,44,22364,0,0,0,0,241,296,537
2019-09-12,5,3495,4453,1794,10266,10164,1966,46,22596,0,0,0,0,208,315,523
2019-09-12,6,3613,4823,1975,10715,10693,2098,49,23710,0,0,0,0,163,327,490
2019-09-12,7,3716,5059,2254,11573,11523,2323,53,25625,6,137,6,149,139,342,481
2019-09-12,8,3817,5124,2389,12069,11954,2409,54,26640,390,2303,368,3061,117,347,464
2019-09-12,9,4038,5182,2390,12391,12343,2425,55,27433,1123,5612,1193,7928,81,399,480
2019-09-12,10,4280,5249,2438,12449,12799,2420,59,27947,1333,6909,1669,9911,63,460,523
2019-09-12,11,4526,5321,2467,12501,13358,2429,63,28574,1369,7421,1712,10502,49,526,575
2019-09-12,12,4796,5377,2501,12653,14046,2456,69,29439,1365,7637,1726,10728,34,515,549
2019-09-12,13,5060,5493,2559,13010,14889,2518,75,30681,1350,7648,1717,10715,27,502,529
2019-09-12,14,5340,5619,2633,13942,15891,2622,80,32722,1338,7632,1710,10680,22,449,471
2019-09-12,15,5629,5763,2691,14724,16854,2763,84,34617,1342,7535,1722,10599,22,374,396
2019-09-12,16,5890,5897,2757,15593,17646,2908,87,36424,1348,7148,1717,10213,27,306,333
2019-09-12,17,6047,5936,2812,16493,18013,3040,89,37788,1296,6362,1499,9157,39,247,286
2019-09-12,18,6001,5905,2820,17035,17948,3111,88,38314,997,4128,1015,6140,55,200,255
2019-09-12,19,5833,5801,2785,17293,17413,3063,83,37986,301,1011,274,1586,145,193,338
2019-09-12,20,5752,5770,2761,17320,16973,3177,79,37680,7,45,8,60,247,211,458
2019-09-12,21,5485,5489,2680,16883,16428,3068,72,36591,0,0,0,0,242,237,479
2019-09-12,22,5111,5101,2454,15877,15376,2863,65,34335,0,0,0,0,264,259,523
2019-09-12,23,4675,4765,2208,14407,14078,2588,58,31285,0,0,0,0,266,323,589
2019-09-12,24,4298,4529,2005,13110,12805,2355,53,28459,0,0,0,0,263,356,619
2019-09-13,1,4010,4360,1858,11813,11855,2255,48,26109,0,0,0,0,192,315,507
2019-09-13,2,3797,4277,1775,11279,11151,2152,46,24781,0,0,0,0,172,314,486
2019-09-13,3,3644,4250,1719,10872,10667,2071,45,23796,0,0,0,0,138,311,449
2019-09-13,4,3565,4290,1695,10639,10433,2031,45,23281,0,0,0,0,112,307,419
2019-09-13,5,3561,4452,1729,10628,10535,2061,46,23402,0,0,0,0,100,295,395
2019-09-13,6,3670,4786,1873,11002,11042,2185,48,24410,0,0,0,0,75,270,345
2019-09-13,7,3773,5023,2101,11825,11755,2395,52,26160,5,128,6,139,73,242,315
2019-09-13,8,3892,5108,2242,12488,12351,2504,53,27529,370,2194,367,2931,67,184,251
2019-09-13,9,4137,5192,2310,12618,12890,2553,55,28270,1089,5467,1135,7691,44,137,181
2019-09-13,10,4412,5273,2377,12873,13445,2583,59,29113,1303,6802,1572,9677,33,126,159
2019-09-13,11,4714,5348,2413,13148,14268,2632,65,30267,1343,7330,1726,10399,24,138,162
2019-09-13,12,5025,5417,2446,13488,15118,2703,71,31535,1340,7530,1738,10608,22,128,150
2019-09-13,13,5300,5562,2500,13978,16140,2801,77,33139,1302,7547,1729,10578,24,124,148
2019-09-13,14,5610,5707,2560,14838,17321,2942,83,35317,1289,7509,1726,10524,38,119,157
2019-09-13,15,5925,5857,2605,15799,18309,3081,88,37417,1301,7373,1738,10412,52,120,172
2019-09-13,16,6206,5983,2656,16743,19054,3228,91,39269,1290,6971,1724,9985,70,160,230
2019-09-13,17,6357,6025,2683,17581,19318,3351,92,40497,1219,6116,1501,8836,110,255,365
2019-09-13,18,6289,5962,2638,18028,19120,3393,91,40787,909,3855,1002,5766,186,439,625
2019-09-13,19,6079,5830,2571,17978,18286,3290,86,39795,267,932,261,1460,254,689,943
2019-09-13,20,5934,5745,2543,17582,17783,3338,81,38938,5,33,7,45,292,1132,1424
2019-09-13,21,5617,5503,2471,16970,16983,3212,73,37393,0,0,0,0,310,1239,1549
2019-09-13,22,5249,5167,2286,15877,15842,3028,67,34968,0,0,0,0,324,1314,1638
2019-09-13,23,4882,4812,2105,14541,14486,2777,60,32014,0,0,0,0,350,1390,1740
2019-09-13,24,4511,4537,1935,13326,13315,2536,55,29366,0,0,0,0,370,1359,1729
2019-09-14,1,4199,4418,1810,11604,12425,2370,50,26608,0,0,0,0,338,1185,1523
2019-09-14,2,3952,4318,1729,10986,11617,2232,47,25040,0,0,0,0,306,1099,1405
2019-09-14,3,3780,4262,1667,10537,11053,2136,46,23935,0,0,0,0,282,971,1253
2019-09-14,4,3657,4247,1631,10235,10679,2075,45,23202,0,0,0,0,259,843,1102
2019-09-14,5,3601,4292,1629,10137,10545,2057,46,22960,0,0,0,0,247,712,959
2019-09-14,6,3617,4430,1682,10315,10695,2087,47,23316,0,0,0,0,208,534,742
2019-09-14,7,3592,4517,1781,10713,10840,2145,48,23913,4,110,5,119,189,406,595
2019-09-14,8,3694,4650,1889,10976,11021,2181,49,24395,359,2117,326,2802,179,252,431
2019-09-14,9,3997,4838,2020,11098,11536,2253,53,25073,1108,5424,1093,7625,147,116,263
2019-09-14,10,4340,4968,2137,11421,12297,2297,57,26206,1336,6788,1551,9675,106,77,183
2019-09-14,11,4719,5079,2173,11621,13128,2365,64,27316,1371,7330,1713,10414,82,73,155
2019-09-14,12,5105,5205,2204,11916,14167,2469,71,28757,1370,7558,1731,10659,84,82,166
2019-09-14,13,5473,5380,2242,12357,15378,2611,79,30562,1352,7569,1728,10649,102,102,204
2019-09-14,14,5831,5557,2293,13052,16584,2763,86,32620,1341,7525,1721,10587,155,127,282
2019-09-14,15,6163,5757,2347,13831,17694,2953,91,34717,1349,7402,1732,10483,265,163,428
2019-09-14,16,6419,5952,2415,14767,18598,3144,96,36760,1348,6958,1695,10001,355,278,633
2019-09-14,17,6570,6065,2492,15550,19027,3274,98,38104,1284,6149,1457,8890,459,488,947
2019-09-14,18,6501,6064,2508,16046,18865,3379,96,38544,949,3826,938,5713,484,758,1242
2019-09-14,19,6261,5953,2468,16129,18191,3357,90,37925,256,842,232,1330,518,958,1476
2019-09-14,20,6070,5879,2457,15890,17564,3349,84,37040,4,18,4,26,602,1216,1818
2019-09-14,21,5754,5607,2359,15298,16766,3216,77,35513,0,0,0,0,699,1213,1912
2019-09-14,22,5390,5250,2181,14279,15706,3045,70,33256,0,0,0,0,754,1194,1948
2019-09-14,23,5012,4890,1999,13202,14596,2796,63,30814,0,0,0,0,824,1201,2025
2019-09-14,24,4656,4602,1830,12208,13378,2546,56,28347,0,0,0,0,882,1057,1939
2019-09-15,1,4328,4469,1672,11252,12359,2435,52,26270,0,0,0,0,891,685,1576
2019-09-15,2,4087,4352,1590,10605,11590,2266,49,24689,0,0,0,0,911,531,1442
2019-09-15,3,3892,4267,1535,10175,10988,2178,47,23567,0,0,0,0,922,400,1322
2019-09-15,4,3781,4233,1508,9872,10587,2112,47,22783,0,0,0,0,954,341,1295
2019-09-15,5,3712,4248,1509,9768,10395,2080,46,22380,0,0,0,0,949,320,1269
2019-09-15,6,3699,4337,1549,9814,10417,2096,47,22466,0,0,0,0,964,301,1265
2019-09-15,7,3644,4405,1632,10027,10437,2110,48,22693,3,92,3,98,972,270,1242
2019-09-15,8,3706,4547,1711,10074,10491,2140,50,22860,296,1899,279,2474,986,236,1222
2019-09-15,9,4005,4697,1842,10238,10967,2209,55,23623,910,4852,919,6681,935,209,1144
2019-09-15,10,4364,4837,1956,10398,11635,2292,60,24535,1143,5957,1285,8385,885,246,1131
2019-09-15,11,4769,5006,1980,10453,12515,2381,66,25565,1177,6603,1442,9222,819,303,1122
2019-09-15,12,5166,5253,1997,10555,13492,2499,74,26761,1189,6765,1480,9434,818,391,1209
2019-09-15,13,5513,5449,2019,10921,14648,2662,81,28449,1109,6369,1437,8915,910,532,1442
2019-09-15,14,5851,5672,2054,11377,15797,2827,88,30239,1111,6291,1392,8794,925,676,1601
2019-09-15,15,6155,5887,2089,11948,16785,3016,93,31999,1116,6054,1428,8598,979,819,1798
2019-09-15,16,6422,6087,2105,12661,17575,3213,97,33682,1156,5494,1438,8088,1035,978,2013
2019-09-15,17,6514,6235,2148,13393,17891,3372,96,34885,1094,4582,1224,6900,1098,1171,2269
2019-09-15,18,6435,6194,2177,13998,17795,3503,94,35524,805,2758,780,4343,1107,1286,2393
2019-09-15,19,6238,6125,2193,14497,17166,3511,89,35396,218,569,193,980,1118,1269,2387
2019-09-15,20,6088,6033,2244,14646,16884,3479,84,35228,3,7,3,13,1103,1250,2353
2019-09-15,21,5806,5719,2213,14450,16206,3385,76,34254,0,0,0,0,1098,1264,2362
2019-09-15,22,5472,5309,2060,13749,15084,3193,69,32229,0,0,0,0,1063,1255,2318
2019-09-15,23,5107,4917,1889,12616,13879,2896,61,29599,0,0,0,0,1002,1255,2257
2019-09-15,24,4739,4620,1730,11642,12724,2606,55,27192,0,0,0,0,924,1246,2170
2019-09-16,1,4394,4444,1611,10343,11499,2280,50,24346,0,0,0,0,817,1320,2137
2019-09-16,2,4170,4339,1551,9994,10870,2172,47,23262,0,0,0,0,745,1345,2090
2019-09-16,3,4001,4294,1521,9738,10508,2095,46,22565,0,0,0,0,668,1253,1921
2019-09-16,4,3899,4337,1523,9709,10336,2059,45,22315,0,0,0,0,591,1177,1768
2019-09-16,5,3894,4516,1591,9924,10553,2101,47,22716,0,0,0,0,499,1053,1552
2019-09-16,6,3998,4887,1783,10526,11217,2237,50,24122,0,0,0,0,457,982,1439
2019-09-16,7,4124,5169,2079,11512,12100,2467,53,26202,2,70,3,75,458,952,1410
2019-09-16,8,4243,5311,2249,12031,12599,2572,56,27362,266,1478,285,2029,473,920,1393
2019-09-16,9,4485,5485,2271,12077,13111,2639,60,28042,823,4252,940,6015,477,928,1405
2019-09-16,10,4750,5659,2295,12030,13573,2679,65,28497,1024,5673,1273,7970,516,948,1464
2019-09-16,11,5014,5814,2325,11951,14094,2700,70,28965,1110,6267,1420,8797,546,1099,1645
2019-09-16,12,5287,5967,2340,11791,14662,2753,76,29423,1125,6585,1461,9171,561,1275,1836
2019-09-16,13,5550,6127,2359,11811,15269,2832,82,30131,1147,6355,1486,8988,551,1534,2085
2019-09-16,14,5749,6262,2372,12032,15942,2926,87,31136,1138,6121,1487,8746,568,1708,2276
2019-09-16,15,5915,6392,2363,12178,16592,3054,90,32071,1132,6005,1557,8694,587,1834,2421
2019-09-16,16,6001,6482,2372,12490,17116,3175,94,33012,1133,5767,1576,8476,610,1934,2544
2019-09-16,17,5953,6509,2374,12817,17208,3266,92,33517,1037,5010,1327,7374,658,2030,2688
2019-09-16,18,5832,6376,2386,13143,16819,3315,90,33500,754,3128,884,4766,676,2115,2791
2019-09-16,19,5706,6220,2405,13286,16174,3291,84,32970,194,660,210,1064,671,2072,2743
2019-09-16,20,5695,6174,2463,13500,16105,3368,81,33189,2,11,3,16,699,2053,2752
2019-09-16,21,5503,5853,2432,13296,15592,3213,75,32313,0,0,0,0,710,2068,2778
2019-09-16,22,5195,5396,2249,12583,14563,2985,69,30334,0,0,0,0,675,2197,2872
2019-09-16,23,4856,4938,2063,11612,13340,2680,63,27842,0,0,0,0,598,2334,2932
2019-09-16,24,4536,4608,1896,10836,12256,2421,57,25735,0,0,0,0,548,2423,2971
2019-09-17,1,4116,4363,1752,10521,11214,2248,52,24216,0,0,0,0,545,2515,3060
2019-09-17,2,3910,4212,1687,10120,10633,2140,49,23126,0,0,0,0,485,2440,2925
2019-09-17,3,3770,4155,1656,9864,10248,2058,48,22405,0,0,0,0,440,2390,2830
2019-09-17,4,3677,4189,1657,9772,10055,2021,47,22083,0,0,0,0,388,2359,2747
2019-09-17,5,3676,4363,1721,9934,10095,2044,48,22308,0,0,0,0,335,2303,2638
2019-09-17,6,3778,4714,1924,10486,10715,2171,51,23602,0,0,0,0,290,2172,2462
2019-09-17,7,3882,4963,2231,11482,11581,2400,53,25701,3,91,3,97,242,2039,2281
2019-09-17,8,3934,5070,2377,11956,11923,2457,55,26569,335,2109,314,2758,201,1804,2005
2019-09-17,9,4112,5198,2359,11910,12360,2490,58,26978,1098,5519,1078,7695,153,1360,1513
2019-09-17,10,4316,5310,2350,11671,12672,2502,62,27059,1326,6900,1552,9778,122,928,1050
2019-09-17,11,4503,5360,2333,11475,13043,2501,66,27235,1362,7387,1713,10462,105,712,817
2019-09-17,12,4669,5368,2340,11304,13430,2514,70,27469,1357,7569,1729,10655,98,696,794
2019-09-17,13,4859,5410,2353,11323,13858,2560,75,27966,1344,7588,1727,10659,104,760,864
2019-09-17,14,5092,5448,2361,11635,14507,2664,78,29028,1336,7572,1719,10627,130,841,971
2019-09-17,15,5308,5502,2342,12026,15155,2798,80,30203,1344,7472,1722,10538,192,1051,1243
2019-09-17,16,5495,5558,2333,12584,15798,2936,83,31534,1346,7123,1715,10184,280,1327,1607
2019-09-17,17,5574,5582,2350,13180,16034,3039,85,32474,1283,6292,1492,9067,397,1615,2012
2019-09-17,18,5501,5519,2371,13571,15829,3107,83,32744,937,3882,968,5787,539,1923,2462
2019-09-17,19,5377,5479,2392,13985,15375,3084,78,32679,228,789,223,1240,705,2116,2821
2019-09-17,20,5325,5499,2453,14274,15375,3181,75,33061,3,18,3,24,791,2287,3078
2019-09-17,21,5102,5260,2419,14074,14942,3061,70,32304,0,0,0,0,825,2271,3096
2019-09-17,22,4781,4959,2233,13254,13998,2851,64,30324,0,0,0,0,836,2231,3067
2019-09-17,23,4419,4649,2034,12149,12882,2572,58,27820,0,0,0,0,862,2189,3051
2019-09-17,24,4090,4432,1867,11279,11866,2328,53,25698,0,0,0,0,898,2120,3018
2019-09-18,1,3875,4346,1770,10520,10825,2131,48,23690,0,0,0,0,924,2134,3058
2019-09-18,2,3688,4257,1706,10084,10313,2036,46,22649,0,0,0,0,881,2108,2989
2019-09-18,3,3559,4233,1670,9833,9971,1964,45,21994,0,0,0,0,807,2102,2909
2019-09-18,4,3489,4279,1669,9735,9826,1928,45,21720,0,0,0,0,736,2111,2847
2019-09-18,5,3493,4464,1725,9927,10001,1952,47,22110,0,0,0,0,679,2117,2796
2019-09-18,6,3614,4829,1922,10479,10620,2079,50,23417,0,0,0,0,615,2091,2706
2019-09-18,7,3724,5077,2217,11503,11477,2306,54,25533,3,91,3,97,545,2043,2588
2019-09-18,8,3799,5143,2350,12082,11676,2385,56,26377,329,2118,327,2774,480,1898,2378
2019-09-18,9,3975,5210,2346,12001,11942,2393,56,26554,1093,5586,1122,7801,448,1643,2091
2019-09-18,10,4179,5286,2341,11788,12248,2372,58,26638,1294,6947,1547,9788,448,1475,1923
2019-09-18,11,4381,5362,2339,11625,12665,2347,63,26857,1330,7449,1697,10476,492,1430,1922
2019-09-18,12,4590,5443,2346,11395,12956,2347,67,26937,1318,7632,1713,10663,501,1610,2111
2019-09-18,13,4802,5590,2362,11342,13382,2376,72,27347,1290,7621,1700,10611,523,1915,2438
2019-09-18,14,5029,5735,2375,11608,14019,2469,76,28338,1276,7603,1702,10581,588,2213,2801
2019-09-18,15,5264,5909,2368,11957,14658,2589,80,29441,1282,7500,1708,10490,652,2424,3076
2019-09-18,16,5469,6059,2357,12459,15142,2715,84,30558,1224,7158,1666,10048,671,2509,3180
2019-09-18,17,5585,6123,2361,13003,15367,2835,85,31448,1138,6312,1470,8920,705,2636,3341
2019-09-18,18,5514,6092,2383,13312,15271,2908,84,31733,794,3846,950,5590,722,2639,3361
2019-09-18,19,5389,5977,2400,13468,14808,2916,80,31429,188,731,210,1129,748,2591,3339
2019-09-18,20,5363,5911,2462,13768,14897,3021,76,31920,2,17,2,21,768,2553,3321
2019-09-18,21,5152,5607,2430,13587,14410,2911,70,31136,0,0,0,0,755,2493,3248
2019-09-18,22,4848,5211,2263,12819,13503,2725,63,29263,0,0,0,0,731,2455,3186
2019-09-18,23,4485,4817,2067,11871,12383,2461,57,26921,0,0,0,0,716,2409,3125
2019-09-18,24,4172,4537,1896,11065,11450,2239,52,24968,0,0,0,0,698,2396,3094
2019-09-19,1,3857,4322,1755,10323,10848,2074,46,23470,0,0,0,0,547,2360,2907
2019-09-19,2,3677,4229,1693,9964,10450,1980,44,22613,0,0,0,0,513,2316,2829
2019-09-19,3,3549,4197,1661,9726,10115,1926,43,21973,0,0,0,0,437,2320,2757
2019-09-19,4,3483,4234,1662,9611,9962,1898,43,21696,0,0,0,0,372,2351,2723
2019-09-19,5,3493,4402,1730,9771,10166,1931,45,22098,0,0,0,0,336,2322,2658
2019-09-19,6,3627,4751,1931,10341,10788,2061,49,23422,0,0,0,0,295,2295,2590
2019-09-19,7,3761,5001,2238,11346,11652,2293,53,25522,3,87,2,92,253,2263,2516
2019-09-19,8,3806,5082,2373,11800,11976,2445,54,26461,314,2109,266,2689,225,2253,2478
2019-09-19,9,3972,5176,2356,11619,12183,2468,55,26515,1056,5561,950,7567,161,2246,2407
2019-09-19,10,4155,5264,2342,11396,12357,2394,57,26387,1324,6938,1427,9689,122,2229,2351
2019-09-19,11,4333,5332,2331,11087,12574,2307,61,26189,1360,7429,1605,10394,107,2286,2393
2019-09-19,12,4508,5394,2324,10867,12872,2258,64,26228,1352,7613,1663,10628,88,2537,2625
2019-09-19,13,4672,5512,2332,10804,13228,2253,69,26518,1337,7623,1688,10648,90,2785,2875
2019-09-19,14,4846,5619,2343,11057,13901,2306,71,27486,1328,7605,1692,10625,88,2949,3037
2019-09-19,15,5017,5715,2336,11397,14481,2396,74,28491,1341,7518,1690,10549,92,3060,3152
2019-09-19,16,5172,5822,2338,11889,14968,2511,77,29591,1345,7181,1667,10193,104,3127,3231
2019-09-19,17,5263,5874,2356,12523,15216,2632,76,30605,1278,6343,1477,9098,122,3157,3279
2019-09-19,18,5179,5758,2368,13008,15111,2732,75,31084,927,3859,952,5738,131,3190,3321
2019-09-19,19,5053,5702,2362,13187,14706,2797,71,30918,220,715,208,1143,211,3157,3368
2019-09-19,20,5032,5651,2408,13508,14819,2933,68,31488,3,20,1,24,281,3216,3497
2019-09-19,21,4846,5346,2376,13264,14374,2831,64,30701,0,0,0,0,290,3348,3638
2019-09-19,22,4558,5042,2200,12539,13526,2656,58,28946,0,0,0,0,297,3424,3721
2019-09-19,23,4213,4723,2010,11578,12406,2412,53,26620,0,0,0,0,304,3397,3701
2019-09-19,24,3897,4484,1853,10759,11388,2204,49,24575,0,0,0,0,317,3209,3526
2019-09-20,1,3610,4262,1746,10315,10631,2061,46,23215,0,0,0,0,330,2874,3204
2019-09-20,2,3455,4170,1679,9927,10181,1972,45,22289,0,0,0,0,318,2630,2948
2019-09-20,3,3340,4139,1643,9668,9864,1913,44,21654,0,0,0,0,282,2371,2653
2019-09-20,4,3288,4179,1637,9562,9726,1884,44,21384,0,0,0,0,241,2047,2288
2019-09-20,5,3307,4349,1688,9730,9910,1910,45,21760,0,0,0,0,223,1697,1920
2019-09-20,6,3446,4685,1865,10263,10491,2024,48,22991,0,0,0,0,202,1119,1321
2019-09-20,7,3559,4929,2148,11264,11316,2230,51,25020,3,89,3,95,209,877,1086
2019-09-20,8,3630,5020,2289,11799,11681,2298,53,25993,327,2115,288,2730,217,551,768
2019-09-20,9,3772,5085,2298,11690,11993,2303,54,26180,1111,5594,961,7666,186,306,492
2019-09-20,10,3927,5145,2302,11534,12198,2250,56,26172,1344,6964,1565,9873,159,236,395
2019-09-20,11,4074,5186,2306,11353,12479,2209,58,26233,1380,7454,1716,10550,166,257,423
2019-09-20,12,4210,5190,2304,11274,12764,2198,61,26436,1368,7628,1734,10730,155,236,391
2019-09-20,13,4338,5237,2301,11326,13083,2224,65,26855,1352,7636,1723,10711,140,226,366
2019-09-20,14,4511,5277,2313,11638,13556,2307,67,27725,1342,7621,1726,10689,131,208,339
2019-09-20,15,4698,5333,2307,12154,14293,2415,70,29090,1358,7527,1729,10614,122,196,318
2019-09-20,16,4850,5376,2315,12798,14928,2549,72,30504,1358,7177,1694,10229,114,219,333
2019-09-20,17,4949,5380,2331,13562,15280,2677,74,31751,1289,6326,1491,9106,129,276,405
2019-09-20,18,4882,5338,2320,13924,15232,2803,73,32190,933,3819,952,5704,169,452,621
2019-09-20,19,4753,5353,2295,14029,14834,2790,69,31881,217,702,202,1121,218,729,947
2019-09-20,20,4708,5364,2327,14182,14464,2875,66,31745,2,19,1,22,280,1039,1319
2019-09-20,21,4529,5196,2266,13814,14037,2786,62,30856,0,0,0,0,263,1114,1377
2019-09-20,22,4295,4951,2111,13097,13345,2643,58,29301,0,0,0,0,267,1038,1305
2019-09-20,23,4035,4672,1957,12136,12408,2443,53,27199,0,0,0,0,268,947,1215
2019-09-20,24,3760,4436,1815,11241,11488,2242,49,25179,0,0,0,0,263,819,1082
2019-09-21,1,3547,4248,1716,10396,10874,2082,44,23552,0,0,0,0,279,781,1060
2019-09-21,2,3391,4162,1647,9935,10277,1975,42,22387,0,0,0,0,267,640,907
2019-09-21,3,3278,4136,1608,9596,9865,1905,42,21562,0,0,0,0,238,515,753
2019-09-21,4,3201,4148,1595,9405,9633,1851,42,21086,0,0,0,0,224,396,620
2019-09-21,5,3203,4222,1615,9380,9596,1857,43,21030,0,0,0,0,217,299,516
2019-09-21,6,3275,4383,1684,9553,9790,1906,45,21448,0,0,0,0,209,211,420
2019-09-21,7,3280,4492,1807,9929,10009,1976,47,22116,3,83,3,89,214,201,415
2019-09-21,8,3269,4585,1919,10148,9987,2006,48,22347,317,2077,313,2707,215,173,388
2019-09-21,9,3471,4681,2018,10294,10284,2046,48,22838,1106,5546,1105,7757,204,186,390
2019-09-21,10,3681,4741,2070,10306,10647,2033,48,23175,1345,6965,1556,9866,176,219,395
2019-09-21,11,3877,4771,2103,10276,11105,2006,50,23589,1383,7465,1707,10555,189,267,456
2019-09-21,12,4043,4779,2100,10317,11620,2008,53,24152,1371,7633,1728,10732,149,284,433
2019-09-21,13,4212,4817,2075,10673,12325,2052,58,25263,1354,7643,1718,10715,109,309,418
2019-09-21,14,4418,4866,2070,11168,13082,2125,62,26592,1347,7621,1719,10687,84,304,388
2019-09-21,15,4635,4947,2075,11892,13993,2258,66,28363,1362,7515,1724,10601,64,260,324
2019-09-21,16,4810,5047,2098,12760,14830,2434,69,30248,1358,7155,1691,10204,54,234,288
2019-09-21,17,4932,5127,2141,13641,15244,2612,71,31723,1285,6249,1481,9015,50,210,260
2019-09-21,18,4916,5170,2167,14182,15376,2749,71,32532,901,3633,923,5457,49,178,227
2019-09-21,19,4808,5203,2180,14371,15022,2801,68,32417,198,632,186,1016,88,171,259
2019-09-21,20,4759,5231,2246,14467,14705,2879,65,32272,2,15,1,18,145,191,336
2019-09-21,21,4589,5052,2166,14039,14190,2784,60,31229,0,0,0,0,175,176,351
2019-09-21,22,4336,4817,1982,13276,13386,2642,55,29515,0,0,0,0,193,166,359
2019-09-21,23,4086,4562,1841,12313,12457,2445,50,27419,0,0,0,0,231,173,404
2019-09-21,24,3836,4350,1709,11455,11578,2249,46,25484,0,0,0,0,256,182,438
2019-09-22,1,3587,4142,1620,10382,11100,2128,43,23808,0,0,0,0,238,171,409
2019-09-22,2,3423,4070,1553,9872,10505,2009,41,22583,0,0,0,0,216,182,398
2019-09-22,3,3295,4042,1515,9504,10057,1935,41,21691,0,0,0,0,199,182,381
2019-09-22,4,3222,4049,1503,9284,9754,1882,41,21116,0,0,0,0,178,175,353
2019-09-22,5,3190,4091,1511,9199,9633,1871,42,20901,0,0,0,0,167,179,346
2019-09-22,6,3238,4194,1558,9262,9667,1904,44,21033,0,0,0,0,135,177,312
2019-09-22,7,3194,4282,1651,9518,9683,1939,46,21342,2,73,3,78,147,174,321
2019-09-22,8,3227,4366,1751,9578,9712,1948,47,21441,294,1772,288,2354,144,155,299
2019-09-22,9,3437,4423,1847,9661,10052,1980,48,21894,1060,4910,1027,6997,111,130,241
2019-09-22,10,3689,4474,1946,9739,10551,1981,50,22471,1302,6109,1461,8872,79,136,215
2019-09-22,11,3915,4500,1996,9802,11184,1989,54,23185,1343,6541,1636,9520,58,152,210
2019-09-22,12,4141,4584,2014,9919,11960,2056,59,24149,1331,6770,1659,9760,64,137,201
2019-09-22,13,4363,4643,2009,10235,12827,2162,65,25445,1281,6498,1627,9406,85,133,218
2019-09-22,14,4554,4751,2006,10706,13747,2296,71,26974,1275,6451,1636,9362,127,138,265
2019-09-22,15,4764,4897,2009,11317,14717,2464,75,28729,1283,6280,1661,9224,212,178,390
2019-09-22,16,4955,5086,2023,12121,15574,2663,78,30593,1235,5860,1612,8707,315,331,646
2019-09-22,17,5103,5208,2055,12896,16113,2831,79,32075,1125,4964,1412,7501,368,532,900
2019-09-22,18,5125,5259,2098,13510,16168,2979,79,32892,710,2888,862,4460,439,681,1120
2019-09-22,19,5051,5286,2123,13756,15919,3037,75,32942,145,496,170,811,512,767,1279
2019-09-22,20,5007,5270,2218,13996,15769,3112,71,33105,1,7,0,8,614,953,1567
2019-09-22,21,4812,5022,2186,13587,15229,2983,65,32020,0,0,0,0,653,992,1645
2019-09-22,22,4540,4694,2016,12751,14185,2797,59,29945,0,0,0,0,702,1067,1769
2019-09-22,23,4199,4391,1839,11669,13014,2540,52,27429,0,0,0,0,757,1153,1910
2019-09-22,24,3904,4202,1699,10793,11951,2306,48,25252,0,0,0,0,771,1171,1942
2019-09-23,1,3577,4108,1618,10080,11246,2128,43,23661,0,0,0,0,604,1027,1631
2019-09-23,2,3423,4056,1571,9676,10710,2038,41,22629,0,0,0,0,537,996,1533
2019-09-23,3,3318,4039,1553,9418,10305,1975,41,21905,0,0,0,0,495,966,1461
2019-09-23,4,3275,4095,1570,9368,10136,1949,41,21658,0,0,0,0,442,988,1430
2019-09-23,5,3313,4280,1649,9547,10371,1987,43,22110,0,0,0,0,396,976,1372
2019-09-23,6,3464,4651,1859,10082,11008,2116,47,23414,0,0,0,0,322,1000,1322
2019-09-23,7,3600,4931,2186,11103,11650,2361,51,25327,2,61,3,66,285,1002,1287
2019-09-23,8,3669,5016,2363,11722,12085,2458,52,26477,270,1729,301,2300,269,933,1202
2019-09-23,9,3838,5087,2352,11828,12557,2505,54,27099,971,4945,1073,6989,228,816,1044
2019-09-23,10,4032,5153,2340,11719,13054,2499,56,27484,1268,6393,1514,9175,222,796,1018
2019-09-23,11,4244,5204,2335,11708,13614,2474,60,28012,1318,6885,1678,9881,273,838,1111
2019-09-23,12,4459,5256,2330,11783,14206,2477,64,28686,1312,7045,1705,10062,305,1062,1367
2019-09-23,13,4679,5364,2338,12010,14884,2508,69,29626,1312,7068,1685,10065,320,1360,1680
2019-09-23,14,4888,5458,2352,12555,15747,2569,73,31100,1307,7032,1688,10027,349,1714,2063
2019-09-23,15,5080,5579,2350,13282,16725,2660,77,32900,1322,6947,1693,9962,346,1900,2246
2019-09-23,16,5221,5700,2361,14051,17447,2762,79,34499,1330,6610,1632,9572,328,2096,2424
2019-09-23,17,5312,5764,2385,14823,17752,2859,81,35673,1251,5688,1418,8357,316,2235,2551
2019-09-23,18,5249,5680,2413,15276,17624,2952,79,36090,855,3258,857,4970,276,2219,2495
2019-09-23,19,5157,5666,2421,15416,17038,2978,74,35664,167,528,169,864,253,2123,2376
2019-09-23,20,5135,5606,2483,15473,16765,3057,71,35524,1,4,0,5,222,1978,2200
2019-09-23,21,4919,5312,2392,14978,16142,2919,65,34268,0,0,0,0,232,1718,1950
2019-09-23,22,4610,4904,2202,14006,15052,2722,59,32000,0,0,0,0,232,1488,1720
2019-09-23,23,4276,4542,2001,12716,13695,2447,54,29072,0,0,0,0,256,1275,1531
2019-09-23,24,3956,4324,1831,11654,12458,2226,50,26551,0,0,0,0,274,1075,1349
2019-09-24,1,3682,4219,1758,10959,11528,2187,49,24885,0,0,0,0,321,901,1222
2019-09-24,2,3531,4142,1689,10393,10905,2092,47,23602,0,0,0,0,320,834,1154
2019-09-24,3,3399,4108,1651,10046,10443,2019,47,22719,0,0,0,0,314,844,1158
2019-09-24,4,3331,4148,1645,9905,10200,1975,46,22288,0,0,0,0,295,881,1176
2019-09-24,5,3331,4331,1700,10028,10324,2004,47,22569,0,0,0,0,286,765,1051
2019-09-24,6,3433,4696,1890,10592,10935,2129,50,23873,0,0,0,0,265,671,936
2019-09-24,7,3641,4973,2198,11612,11817,2349,54,25986,2,67,2,71,242,580,822
2019-09-24,8,3722,5047,2356,12178,12204,2415,55,26998,278,1833,287,2398,232,494,726
2019-09-24,9,3894,5099,2337,12549,12743,2458,57,27967,1038,5178,1038,7254,208,441,649
2019-09-24,10,4091,5158,2355,12568,13349,2477,60,28614,1307,6666,1510,9483,190,543,733
2019-09-24,11,4304,5207,2363,12753,13962,2497,65,29436,1341,7118,1674,10133,207,672,879
2019-09-24,12,4541,5247,2381,13129,14802,2541,69,30702,1331,7300,1697,10328,195,721,916
2019-09-24,13,4783,5353,2418,13630,15671,2614,74,32150,1321,7301,1689,10311,171,790,961
2019-09-24,14,5051,5451,2456,14442,16716,2744,79,34141,1314,7269,1697,10280,137,823,960
2019-09-24,15,5314,5580,2477,15328,17601,2893,82,36064,1333,7147,1700,10180,128,766,894
2019-09-24,16,5553,5691,2528,16249,18359,3057,85,37910,1327,6699,1648,9674,121,720,841
2019-09-24,17,5664,5768,2536,17042,18662,3195,87,39145,1250,5741,1420,8411,115,715,830
2019-09-24,18,5636,5669,2539,17577,18635,3286,86,39741,834,3200,826,4860,102,904,1006
2019-09-24,19,5553,5661,2524,17673,18130,3279,82,39322,146,479,155,780,116,1123,1239
2019-09-24,20,5457,5619,2586,17488,17573,3320,77,38616,0,8,0,8,172,1156,1328
2019-09-24,21,5187,5298,2469,16729,16983,3180,71,37125,0,0,0,0,214,1086,1300
2019-09-24,22,4850,4919,2239,15560,15994,2955,64,34740,0,0,0,0,239,1029,1268
2019-09-24,23,4457,4589,2041,14048,14568,2660,58,31497,0,0,0,0,259,1012,1271
2019-09-24,24,4115,4366,1869,12821,13203,2401,53,28641,0,0,0,0,274,953,1227
2019-09-25,1,3870,4299,1766,11684,11615,2158,50,25647,0,0,0,0,283,1351,1634
2019-09-25,2,3661,4212,1691,11117,10975,2057,48,24338,0,0,0,0,268,1233,1501
2019-09-25,3,3540,4174,1645,10759,10552,1984,47,23475,0,0,0,0,272,1115,1387
2019-09-25,4,3461,4210,1636,10555,10347,1946,47,23028,0,0,0,0,276,948,1224
2019-09-25,5,3466,4381,1687,10662,10512,1984,48,23332,0,0,0,0,289,764,1053
2019-09-25,6,3588,4736,1877,11227,11182,2118,52,24689,0,0,0,0,290,522,812
2019-09-25,7,3736,5015,2188,12314,12104,2361,56,26943,1,48,2,51,278,396,674
2019-09-25,8,3831,5096,2344,12883,12506,2457,57,28013,236,1493,264,1993,271,299,570
2019-09-25,9,4018,5167,2337,12926,12890,2477,59,28500,912,4389,967,6268,261,256,517
2019-09-25,10,4247,5243,2355,13258,13333,2457,62,29258,1132,5712,1413,8257,223,252,475
2019-09-25,11,4510,5306,2375,13530,13894,2448,67,30088,1189,6183,1595,8967,221,298,519
2019-09-25,12,4805,5360,2382,13969,14459,2457,71,31103,1185,6303,1621,9109,167,309,476
2019-09-25,13,5084,5472,2405,14651,15119,2481,77,32475,1171,6202,1608,8981,118,325,443
2019-09-25,14,5384,5573,2431,15591,15972,2562,81,34350,1172,6124,1596,8892,101,307,408
2019-09-25,15,5677,5707,2448,16592,16724,2660,85,36204,1187,5943,1586,8716,91,306,397
2019-09-25,16,5934,5830,2474,17613,17359,2784,88,37986,1169,5329,1523,8021,87,294,381
2019-09-25,17,6035,5906,2472,18491,17601,2905,89,39226,1073,4444,1293,6810,85,256,341
2019-09-25,18,6007,5824,2493,19040,17393,3007,89,39669,670,2362,729,3761,81,193,274
2019-09-25,19,5901,5813,2494,19105,16852,3038,84,39220,127,327,128,582,88,204,292
2019-09-25,20,5788,5738,2550,18746,16662,3101,80,38729,0,3,0,3,111,294,405
2019-09-25,21,5508,5408,2442,17968,15957,2980,73,37133,0,0,0,0,125,287,412
2019-09-25,22,5138,5034,2236,16649,14909,2788,66,34572,0,0,0,0,154,294,448
2019-09-25,23,4724,4703,2043,14925,13520,2530,60,31173,0,0,0,0,190,369,559
2019-09-25,24,4345,4472,1871,13586,12386,2306,54,28473,0,0,0,0,242,321,563
2019-09-26,1,4036,4345,1772,11736,11679,2232,51,25799,0,0,0,0,301,304,605
2019-09-26,2,3838,4258,1698,11070,11072,2142,49,24434,0,0,0,0,310,272,582
2019-09-26,3,3708,4218,1653,10639,10679,2063,48,23532,0,0,0,0,336,250,586
2019-09-26,4,3635,4253,1642,10395,10475,2023,48,23043,0,0,0,0,370,240,610
2019-09-26,5,3641,4425,1695,10433,10663,2062,50,23311,0,0,0,0,431,216,647
2019-09-26,6,3763,4784,1889,10964,11299,2200,53,24618,0,0,0,0,528,207,735
2019-09-26,7,3911,5057,2190,12039,12252,2448,56,26897,1,38,2,41,643,207,850
2019-09-26,8,3979,5147,2351,12712,12756,2528,58,28164,255,1194,249,1698,695,209,904
2019-09-26,9,4154,5225,2338,12860,13049,2552,60,28619,1023,3597,967,5587,600,193,793
2019-09-26,10,4361,5311,2372,13033,13396,2532,63,29135,1301,5057,1443,7801,588,201,789
2019-09-26,11,4602,5383,2385,13214,13688,2505,66,29606,1334,5693,1621,8648,570,235,805
2019-09-26,12,4844,5462,2392,13463,14013,2483,71,30130,1322,6030,1658,9010,599,312,911
2019-09-26,13,5074,5603,2424,13742,14259,2478,76,30654,1314,5995,1634,8943,660,444,1104
2019-09-26,14,5316,5741,2468,14293,14811,2528,80,31812,1304,5908,1648,8860,679,649,1328
2019-09-26,15,5528,5896,2481,14849,15172,2624,83,32826,1325,5831,1649,8805,735,942,1677
2019-09-26,16,5722,6038,2505,15360,15501,2748,84,33791,1319,5554,1611,8484,797,1353,2150
2019-09-26,17,5793,6108,2517,15849,15690,2859,86,34588,1235,4726,1380,7341,853,1770,2623
2019-09-26,18,5759,6018,2493,16037,15515,2948,84,34684,801,2506,776,4083,887,1864,2751
2019-09-26,19,5650,5986,2485,15869,15080,2988,80,34116,127,361,129,617,933,1897,2830
2019-09-26,20,5576,5855,2529,15818,15157,3052,76,34205,0,12,0,12,977,1967,2944
2019-09-26,21,5321,5552,2415,15115,14759,2939,70,32986,0,0,0,0,987,2045,3032
2019-09-26,22,5008,5162,2230,14059,13921,2763,64,30908,0,0,0,0,986,2137,3123
2019-09-26,23,4635,4784,2047,12887,12806,2510,58,28371,0,0,0,0,967,2185,3152
2019-09-26,24,4275,4519,1876,11874,11795,2298,53,26119,0,0,0,0,934,2250,3184
2019-09-27,1,4058,4389,1778,11468,11011,2219,52,24868,0,0,0,0,920,2177,3097
2019-09-27,2,3845,4296,1704,10902,10539,2118,49,23709,0,0,0,0,873,2258,3131
2019-09-27,3,3699,4254,1662,10550,10201,2037,48,22937,0,0,0,0,860,2277,3137
2019-09-27,4,3612,4282,1652,10389,10033,1999,47,22576,0,0,0,0,848,2249,3097
2019-09-27,5,3602,4430,1703,10528,10152,2029,48,22887,0,0,0,0,850,2192,3042
2019-09-27,6,3695,4752,1883,11066,10758,2149,50,24150,0,0,0,0,833,2086,2919
2019-09-27,7,3840,5023,2178,12090,11656,2381,53,26303,1,49,1,51,803,1979,2782
2019-09-27,8,3914,5118,2338,12597,12002,2475,54,27251,240,1633,220,2093,766,1855,2621
2019-09-27,9,4110,5221,2350,12651,12301,2515,57,27627,992,4857,868,6717,729,1679,2408
2019-09-27,10,4334,5295,2354,12487,12429,2506,61,27586,1261,6469,1360,9090,669,1512,2181
2019-09-27,11,4562,5339,2355,12309,12596,2449,65,27521,1303,7021,1597,9921,612,1475,2087
2019-09-27,12,4787,5355,2316,12208,12727,2414,69,27519,1293,7205,1646,10144,592,1660,2252
2019-09-27,13,5020,5408,2294,12162,12885,2441,74,27664,1302,7398,1671,10371,633,1928,2561
2019-09-27,14,5262,5457,2287,12389,13261,2431,77,28256,1293,7389,1674,10356,647,2263,2910
2019-09-27,15,5493,5522,2261,12653,13698,2489,80,29022,1314,7327,1680,10321,703,2429,3132
2019-09-27,16,5672,5570,2237,13089,13902,2606,83,29776,1311,6962,1605,9878,742,2534,3276
2019-09-27,17,5753,5558,2225,13480,14158,2691,82,30508,1226,6000,1376,8602,808,2597,3405
2019-09-27,18,5671,5524,2231,13800,14071,2802,81,30870,789,3162,759,4710,836,2623,3459
2019-09-27,19,5559,5544,2234,13796,13805,2816,76,30628,110,420,115,645,874,2578,3452
2019-09-27,20,5461,5462,2280,13851,13938,2874,71,30842,0,19,0,19,896,2557,3453
2019-09-27,21,5189,5217,2220,13503,13526,2789,66,29984,0,0,0,0,850,2510,3360
2019-09-27,22,4887,4947,2076,12724,12866,2671,61,28422,0,0,0,0,826,2458,3284
2019-09-27,23,4580,4666,1939,11903,12015,2487,56,26561,0,0,0,0,775,2412,3187
2019-09-27,24,4269,4431,1810,11086,11185,2284,51,24709,0,0,0,0,709,2369,3078
2019-09-28,1,3925,4182,1784,10572,10589,2142,48,23467,0,0,0,0,819,2188,3007
2019-09-28,2,3740,4081,1723,10157,10121,2035,45,22477,0,0,0,0,762,2159,2921
2019-09-28,3,3605,4033,1693,9814,9774,1961,45,21711,0,0,0,0,733,2126,2859
2019-09-28,4,3514,4031,1687,9605,9553,1909,44,21229,0,0,0,0,693,2067,2760
2019-09-28,5,3470,4083,1717,9601,9550,1906,45,21222,0,0,0,0,649,2003,2652
2019-09-28,6,3511,4225,1798,9829,9765,1950,46,21709,0,0,0,0,621,1933,2554
2019-09-28,7,3532,4341,1932,10252,10084,2046,48,22546,1,48,1,50,612,1899,2511
2019-09-28,8,3533,4452,2070,10443,10112,2109,48,22842,191,1619,186,1996,618,1876,2494
2019-09-28,9,3727,4583,2197,10465,10466,2193,50,23301,818,4695,771,6284,577,1845,2422
2019-09-28,10,3960,4660,2244,10322,10619,2239,52,23361,1111,6208,1262,8581,538,1827,2365
2019-09-28,11,4173,4709,2248,10171,10725,2220,55,23270,1178,6767,1476,9421,470,1873,2343
2019-09-28,12,4365,4748,2216,9951,10667,2199,59,22964,1189,6982,1553,9724,398,2021,2419
2019-09-28,13,4549,4781,2174,9746,10650,2206,62,22763,1194,6981,1585,9760,339,2256,2595
2019-09-28,14,4715,4811,2130,9755,10756,2210,64,22884,1196,6909,1599,9704,301,2355,2656
2019-09-28,15,4894,4869,2098,9934,10971,2217,66,23297,1205,6850,1597,9652,264,2415,2679
2019-09-28,16,5008,4951,2090,10269,11194,2283,65,23926,1188,6497,1510,9195,251,2453,2704
2019-09-28,17,5013,5011,2125,10678,11391,2320,66,24560,1087,5487,1266,7840,285,2436,2721
2019-09-28,18,4912,5048,2167,11085,11474,2465,63,25184,669,2807,700,4176,320,2368,2688
2019-09-28,19,4788,5165,2207,11579,11582,2581,59,25902,104,368,106,578,410,2320,2730
2019-09-28,20,4739,5186,2299,11953,12001,2668,55,26797,0,15,0,15,555,2288,2843
2019-09-28,21,4571,5007,2276,11807,11810,2583,52,26358,0,0,0,0,610,2372,2982
2019-09-28,22,4340,4773,2140,11274,11332,2493,51,25258,0,0,0,0,579,2488,3067
2019-09-28,23,4076,4516,1998,10697,10693,2341,48,23887,0,0,0,0,541,2635,3176
2019-09-28,24,3816,4292,1889,10049,10096,2162,45,22463,0,0,0,0,518,2712,3230
2019-09-29,1,3492,4100,1823,9606,9749,2028,44,21540,0,0,0,0,419,2626,3045
2019-09-29,2,3316,4022,1778,9267,9342,1919,42,20687,0,0,0,0,393,2573,2966
2019-09-29,3,3192,3987,1759,9007,9034,1863,41,20065,0,0,0,0,389,2478,2867
2019-09-29,4,3116,3988,1763,8880,8817,1815,40,19670,0,0,0,0,383,2376,2759
2019-09-29,5,3081,4033,1796,8905,8783,1811,41,19663,0,0,0,0,384,2262,2646
2019-09-29,6,3141,4143,1869,9094,8885,1848,43,19990,0,0,0,0,364,2261,2625
2019-09-29,7,3106,4253,1984,9385,9065,1903,46,20501,1,43,1,45,344,2302,2646
2019-09-29,8,3071,4349,2112,9486,9021,1899,47,20552,216,1684,222,2122,322,2295,2617
2019-09-29,9,3198,4415,2253,9500,9094,1904,50,20648,899,5061,947,6907,281,2261,2542
2019-09-29,10,3360,4479,2297,9328,9149,1840,51,20464,1187,6666,1436,9289,281,2188,2469
2019-09-29,11,3496,4521,2281,9088,9275,1714,51,20223,1247,7179,1622,10048,293,2179,2472
2019-09-29,12,3578,4610,2237,8834,9323,1630,51,19933,1238,7334,1649,10221,326,2278,2604
2019-09-29,13,3690,4649,2201,8747,9404,1607,52,19905,1211,7414,1633,10258,339,2386,2725
2019-09-29,14,3802,4707,2173,8743,9641,1646,54,20175,1207,7393,1640,10240,406,2492,2898
2019-09-29,15,3883,4775,2141,8958,10017,1741,55,20863,1209,7332,1639,10180,509,2536,3045
2019-09-29,16,3958,4886,2130,9296,10400,1882,56,21731,1176,6964,1538,9678,701,2597,3298
2019-09-29,17,3942,4935,2174,9849,10731,2051,57,22783,1049,5985,1282,8316,786,2625,3411
2019-09-29,18,4010,4976,2261,10523,10943,2214,57,23839,630,3121,690,4441,810,2487,3297
2019-09-29,19,4018,5114,2328,11169,11258,2371,57,24967,97,457,102,656,782,2314,3096
2019-09-29,20,4083,5170,2443,11721,11789,2505,57,26177,0,50,0,50,745,2257,3002
2019-09-29,21,3995,5004,2415,11657,11574,2417,54,25812,0,0,0,0,673,2190,2863
2019-09-29,22,3795,4735,2247,11106,11100,2295,50,24658,0,0,0,0,622,2147,2769
2019-09-29,23,3586,4457,2070,10419,10406,2120,46,23101,0,0,0,0,599,2164,2763
2019-09-29,24,3404,4279,1934,9692,9731,1952,44,21534,0,0,0,0,570,2265,2835
2019-09-30,1,3245,4296,1803,9016,9391,1912,41,20447,0,0,0,0,517,2288,2805
2019-09-30,2,3149,4247,1774,8752,9150,1838,40,19875,0,0,0,0,475,2179,2654
2019-09-30,3,3093,4251,1775,8583,8972,1789,41,19479,0,0,0,0,406,2115,2521
2019-09-30,4,3086,4333,1807,8570,8922,1762,42,19391,0,0,0,0,307,2074,2381
2019-09-30,5,3152,4539,1915,8841,9207,1806,44,19993,0,0,0,0,244,2049,2293
2019-09-30,6,3310,4926,2159,9519,9896,1928,50,21487,0,0,0,0,217,2050,2267
2019-09-30,7,3489,5215,2511,10663,10791,2138,55,23736,0,46,1,47,204,2047,2251
2019-09-30,8,3511,5263,2673,11412,11142,2205,55,24902,188,1753,221,2162,180,2003,2183
2019-09-30,9,3561,5284,2650,11345,11292,2183,53,24970,803,5268,931,7002,145,1949,2094
2019-09-30,10,3605,5301,2587,11000,11440,2145,53,24734,1113,6889,1425,9427,137,1860,1997
2019-09-30,11,3661,5308,2530,10610,11553,2080,53,24393,1178,7361,1614,10153,118,1802,1920
2019-09-30,12,3735,5308,2454,10181,11638,2053,53,24015,1183,7499,1644,10326,90,1933,2023
2019-09-30,13,3848,5350,2413,9944,11694,2081,54,23857,1197,7543,1648,10388,72,2021,2093
2019-09-30,14,3989,5376,2378,9956,11986,2152,56,24235,1211,7520,1641,10372,67,2184,2251
2019-09-30,15,4106,5404,2336,10051,12274,2254,57,24732,1233,7476,1633,10342,65,2356,2421
2019-09-30,16,4225,5438,2300,10442,12606,2405,59,25608,1239,7111,1549,9899,74,2520,2594
2019-09-30,17,4333,5457,2325,10899,12750,2542,60,26337,1133,6131,1303,8567,80,2605,2685
2019-09-30,18,4313,5489,2389,11582,12810,2664,60,27201,674,3161,695,4530,77,2724,2801
2019-09-30,19,4344,5601,2473,12117,12821,2734,60,27820,93,466,100,659,63,2836,2899
2019-09-30,20,4410,5613,2574,12614,13247,2819,60,28830,0,65,0,65,98,2928,3026
2019-09-30,21,4255,5403,2548,12371,12974,2697,56,28186,0,0,0,0,140,2856,2996
2019-09-30,22,4000,5070,2372,11734,12354,2534,52,26758,0,0,0,0,168,2822,2990
2019-09-30,23,3786,4753,2183,10791,11411,2287,48,24624,0,0,0,0,188,2767,2955
2019-09-30,24,3562,4545,2026,10077,10573,2079,45,22865,0,0,0,0,195,2616,2811
2019-10-01,1,3386,4373,1894,9422,9885,1972,42,21440,0,0,0,0,186,2859,3045
2019-10-01,2,3269,4320,1846,9094,9518,1879,41,20650,0,0,0,0,166,2798,2964
2019-10-01,3,3206,4306,1836,8882,9293,1822,41,20155,0,0,0,0,165,2740,2905
2019-10-01,4,3181,4375,1863,8839,9221,1794,42,20013,0,0,0,0,173,2654,2827
2019-10-01,5,3225,4576,1959,9085,9445,1824,45,20514,0,0,0,0,177,2556,2733
2019-10-01,6,3371,4954,2197,9713,10109,1952,50,21938,0,0,0,0,162,2401,2563
2019-10-01,7,3554,5241,2565,10997,11091,2153,56,24415,0,48,1,49,163,2259,2422
2019-10-01,8,3557,5261,2745,11743,11308,2215,57,25442,202,1738,232,2172,165,2040,2205
2019-10-01,9,3598,5249,2674,11480,11448,2180,55,25251,928,5329,1000,7257,166,1654,1820
2019-10-01,10,3637,5237,2590,11043,11405,2115,54,24705,1221,6963,1493,9677,168,1264,1432
2019-10-01,11,3690,5235,2497,10750,11394,2049,54,24337,1256,7344,1663,10263,170,936,1106
2019-10-01,12,3750,5241,2421,10355,11425,2009,54,23933,1249,7536,1692,10477,164,744,908
2019-10-01,13,3840,5268,2374,10135,11541,1994,55,23818,1235,7520,1681,10436,153,781,934
2019-10-01,14,3958,5266,2332,10210,11812,2046,56,24215,1238,7494,1684,10416,136,890,1026
2019-10-01,15,4096,5291,2284,10362,12049,2137,58,24693,1257,7455,1695,10407,120,1111,1231
2019-10-01,16,4243,5338,2260,10655,12335,2243,59,25379,1258,7079,1634,9971,111,1393,1504
2019-10-01,17,4319,5372,2276,11260,12553,2370,59,26338,1161,6057,1377,8595,107,1775,1882
2019-10-01,18,4341,5399,2318,11765,12544,2566,60,27033,701,3053,730,4484,139,2022,2161
2019-10-01,19,4415,5567,2389,12337,12738,2695,60,27929,90,451,98,639,236,2042,2278
2019-10-01,20,4421,5562,2535,12810,13158,2792,61,28929,2,63,0,65,291,2009,2300
2019-10-01,21,4282,5348,2483,12486,12875,2689,57,28227,0,0,0,0,260,1697,1957
2019-10-01,22,4051,5029,2320,11851,12254,2522,53,26792,0,0,0,0,255,1250,1505
2019-10-01,23,3817,4723,2138,10997,11366,2269,49,24790,0,0,0,0,255,929,1184
2019-10-01,24,3587,4511,1986,10292,10540,2069,45,23063,0,0,0,0,248,630,878
2019-10-02,1,3323,4301,1871,9574,9603,1913,43,21223,0,0,0,0,254,657,911
2019-10-02,2,3207,4253,1827,9212,9271,1837,42,20453,0,0,0,0,226,439,665
2019-10-02,3,3146,4241,1814,9004,9018,1789,42,19944,0,0,0,0,209,333,542
2019-10-02,4,3126,4310,1838,8979,8978,1766,43,19857,0,0,0,0,172,273,445
2019-10-02,5,3175,4500,1932,9213,9155,1795,47,20300,0,0,0,0,151,258,409
2019-10-02,6,3320,4875,2164,9828,9715,1932,52,21618,0,0,0,0,120,249,369
2019-10-02,7,3513,5162,2520,10953,10709,2145,58,23961,0,44,1,45,100,261,361
2019-10-02,8,3499,5176,2711,11552,10916,2177,60,24795,214,1722,233,2169,85,263,348
2019-10-02,9,3531,5161,2634,11105,10966,2055,56,24288,993,5324,981,7298,59,301,360
2019-10-02,10,3574,5139,2548,10488,10929,1984,54,23561,1298,6956,1469,9723,46,352,398
2019-10-02,11,3638,5127,2460,10140,10940,1951,54,23166,1332,7325,1666,10323,32,406,438
2019-10-02,12,3713,5113,2383,9811,10976,1940,55,22857,1340,7493,1696,10529,29,393,422
2019-10-02,13,3820,5127,2346,9710,11140,1957,56,22939,1317,7454,1685,10456,24,366,390
2019-10-02,14,3956,5115,2324,9845,11459,2021,57,23456,1316,7438,1685,10439,25,323,348
2019-10-02,15,4110,5128,2292,10076,11889,2106,58,24209,1335,7403,1694,10432,32,259,291
2019-10-02,16,4261,5165,2269,10492,12194,2215,59,25050,1327,7018,1631,9976,48,209,257
2019-10-02,17,4362,5209,2278,11340,12401,2339,61,26233,1221,5930,1368,8519,77,165,242
2019-10-02,18,4371,5240,2315,11991,12521,2535,60,27196,725,2912,705,4342,142,128,270
2019-10-02,19,4436,5425,2379,12572,12688,2667,60,28076,88,418,91,597,257,128,385
2019-10-02,20,4431,5434,2480,13022,13027,2864,61,29062,2,69,0,71,301,162,463
2019-10-02,21,4289,5229,2409,12694,12663,2737,58,28240,0,0,0,0,333,160,493
2019-10-02,22,4028,4917,2251,12023,12019,2547,54,26732,0,0,0,0,365,170,535
2019-10-02,23,3776,4623,2066,11095,11124,2301,49,24664,0,0,0,0,414,170,584
2019-10-02,24,3545,4421,1912,10418,10407,2087,45,23049,0,0,0,0,468,168,636
2019-10-03,1,3321,4290,1822,9861,9738,1943,42,21673,0,0,0,0,456,156,612
2019-10-03,2,3201,4240,1773,9506,9326,1863,41,20827,0,0,0,0,452,158,610
2019-10-03,3,3130,4231,1751,9213,9085,1807,41,20237,0,0,0,0,445,162,607
2019-10-03,4,3106,4305,1763,9117,8885,1778,42,19911,0,0,0,0,404,171,575
2019-10-03,5,3147,4495,1839,9261,8964,1803,44,20162,0,0,0,0,384,176,560
2019-10-03,6,3277,4873,2052,9832,9477,1943,49,21390,0,0,0,0,357,164,521
2019-10-03,7,3463,5158,2387,10846,10337,2160,53,23492,0,42,0,42,356,154,510
2019-10-03,8,3483,5167,2565,11236,10470,2149,56,24012,202,1710,226,2138,333,139,472
2019-10-03,9,3547,5148,2501,11368,11017,2067,54,24597,971,5349,972,7292,288,113,401
2019-10-03,10,3633,5120,2460,10976,10992,2031,54,24152,1261,7025,1464,9750,245,111,356
2019-10-03,11,3755,5085,2408,10567,11082,2001,54,23797,1305,7372,1667,10344,237,139,376
2019-10-03,12,3870,5046,2365,10294,11275,1988,56,23703,1299,7568,1689,10556,279,241,520
2019-10-03,13,4009,5059,2348,10039,11560,1991,58,23732,1274,7521,1675,10470,326,383,709
2019-10-03,14,4202,5062,2336,10074,12023,2053,61,24302,1283,7505,1673,10461,434,649,1083
2019-10-03,15,4387,5091,2303,10326,12383,2142,64,25008,1304,7476,1686,10466,518,927,1445
2019-10-03,16,4567,5173,2280,10599,12784,2237,66,25779,1303,7080,1624,10007,596,1225,1821
2019-10-03,17,4703,5198,2283,11132,13080,2364,68,26734,1195,5955,1364,8514,655,1543,2198
2019-10-03,18,4680,5226,2306,11734,13129,2512,66,27529,686,2882,682,4250,679,1802,2481
2019-10-03,19,4715,5369,2372,12506,13142,2727,66,28530,89,407,85,581,729,2026,2755
2019-10-03,20,4664,5349,2478,13071,13336,2847,63,29405,1,68,0,69,822,2165,2987
2019-10-03,21,4490,5124,2411,12725,12838,2720,59,28431,0,0,0,0,811,2188,2999
2019-10-03,22,4244,4820,2248,12046,12157,2540,55,26887,0,0,0,0,802,2233,3035
2019-10-03,23,3911,4524,2065,11184,11290,2289,50,24901,0,0,0,0,816,2306,3122
2019-10-03,24,3645,4315,1907,10394,10430,2074,45,23032,0,0,0,0,758,2312,3070
2019-10-04,1,3369,4246,1794,9709,10077,1942,42,21870,0,0,0,0,697,2523,3220
2019-10-04,2,3245,4195,1737,9341,9594,1860,41,20945,0,0,0,0,590,2579,3169
2019-10-04,3,3163,4173,1717,9121,9389,1803,41,20467,0,0,0,0,498,2582,3080
2019-10-04,4,3136,4230,1729,9061,9302,1781,42,20299,0,0,0,0,381,2564,2945
2019-10-04,5,3167,4393,1803,9260,9442,1807,44,20667,0,0,0,0,301,2545,2846
2019-10-04,6,3270,4729,2007,9862,9980,1927,48,21925,0,0,0,0,225,2510,2735
2019-10-04,7,3433,5011,2329,10881,10799,2120,52,23963,0,39,0,39,182,2412,2594
2019-10-04,8,3455,5057,2523,11526,11097,2145,53,24936,203,1683,217,2103,166,2308,2474
2019-10-04,9,3560,5089,2491,11002,10638,2074,53,23864,977,5371,965,7313,166,2093,2259
2019-10-04,10,3691,5087,2453,10380,10811,2023,52,23354,1293,7046,1469,9808,216,1861,2077
2019-10-04,11,3823,5076,2393,10140,10988,1970,53,23244,1326,7397,1674,10397,277,1663,1940
2019-10-04,12,3943,5064,2335,9817,11262,1955,54,23182,1320,7490,1691,10501,341,1608,1949
2019-10-04,13,4057,5078,2290,9617,11624,1974,56,23361,1303,7523,1684,10510,322,1714,2036
2019-10-04,14,4199,5075,2267,9728,12120,2041,58,24031,1301,7397,1676,10374,291,1889,2180
2019-10-04,15,4355,5085,2224,9935,12607,2127,61,24823,1322,7482,1691,10495,271,2038,2309
2019-10-04,16,4521,5089,2200,10372,13046,2239,63,25814,1314,7059,1635,10008,266,2139,2405
2019-10-04,17,4628,5097,2202,10919,13448,2377,66,26901,1199,5885,1351,8435,255,2255,2510
2019-10-04,18,4573,5096,2220,11493,13371,2501,64,27520,658,2749,668,4075,220,2351,2571
2019-10-04,19,4592,5276,2267,12139,13359,2662,62,28316,76,369,77,522,206,2354,2560
2019-10-04,20,4515,5250,2344,12651,13417,2757,60,28977,1,64,0,65,200,2326,2526
2019-10-04,21,4365,5073,2280,12376,12877,2643,57,28045,0,0,0,0,207,2117,2324
2019-10-04,22,4148,4839,2152,11790,12338,2506,53,26780,0,0,0,0,222,1831,2053
2019-10-04,23,3888,4592,2010,11048,11612,2303,49,25106,0,0,0,0,241,1488,1729
2019-10-04,24,3629,4384,1874,10306,10760,2098,45,23305,0,0,0,0,254,1079,1333
2019-10-05,1,3389,4239,1763,9740,10010,1965,43,21860,0,0,0,0,205,930,1135
2019-10-05,2,3247,4186,1707,9354,9568,1878,42,20942,0,0,0,0,198,686,884
2019-10-05,3,3158,4171,1682,9166,9270,1809,42,20385,0,0,0,0,198,491,689
2019-10-05,4,3116,4198,1687,9029,9089,1765,42,20028,0,0,0,0,202,355,557
2019-10-05,5,3122,4275,1722,9099,9110,1764,43,20120,0,0,0,0,202,262,464
2019-10-05,6,3149,4434,1810,9340,9357,1802,45,20659,0,0,0,0,198,185,383
2019-10-05,7,3202,4579,1957,9843,9665,1875,47,21532,0,32,0,32,197,150,347
2019-10-05,8,3187,4668,2124,10253,9580,1842,48,21826,190,1590,209,1989,191,120,311
2019-10-05,9,3308,4722,2217,10129,9564,1786,49,21626,971,5255,950,7176,170,98,268
2019-10-05,10,3454,4738,2227,9880,9626,1755,49,21406,1294,6957,1455,9706,177,104,281
2019-10-05,11,3578,4715,2170,9624,9793,1721,49,21281,1327,7308,1663,10298,171,112,283
2019-10-05,12,3693,4687,2097,9371,9995,1716,50,21225,1321,7411,1684,10416,150,102,252
2019-10-05,13,3804,4648,2055,9206,10364,1723,53,21441,1304,7435,1669,10408,130,92,222
2019-10-05,14,3948,4618,2017,9305,10955,1781,56,22193,1297,7318,1664,10279,100,89,189
2019-10-05,15,4113,4627,1987,9609,11579,1865,59,23208,1320,7359,1681,10360,84,95,179
2019-10-05,16,4283,4682,1993,10103,12233,2023,62,24516,1311,6917,1596,9824,81,136,217
2019-10-05,17,4409,4765,2016,10708,12741,2191,65,25800,1194,5723,1295,8212,80,224,304
2019-10-05,18,4409,4835,2042,11488,12913,2414,64,26975,643,2619,623,3885,77,308,385
2019-10-05,19,4432,5069,2106,12061,12936,2576,64,27733,66,282,70,418,89,503,592
2019-10-05,20,4352,5094,2184,12365,12998,2688,60,28207,2,38,0,40,125,689,814
2019-10-05,21,4215,4944,2103,12064,12399,2579,57,27195,0,0,0,0,160,613,773
2019-10-05,22,4023,4737,1994,11546,11833,2451,53,25985,0,0,0,0,180,514,694
2019-10-05,23,3748,4505,1880,10997,11078,2261,49,24485,0,0,0,0,204,420,624
2019-10-05,24,3525,4324,1764,10347,10428,2076,45,22996,0,0,0,0,210,300,510
2019-10-06,1,3362,4237,1682,9466,9715,1935,42,21258,0,0,0,0,208,245,453
2019-10-06,2,3234,4180,1635,9038,9335,1843,41,20358,0,0,0,0,242,198,440
2019-10-06,3,3150,4152,1620,8786,9015,1780,41,19726,0,0,0,0,294,188,482
2019-10-06,4,3091,4167,1632,8679,8821,1744,40,19386,0,0,0,0,331,181,512
2019-10-06,5,3073,4208,1670,8652,8804,1735,42,19341,0,0,0,0,347,185,532
2019-10-06,6,3075,4314,1746,8807,8979,1763,43,19699,0,0,0,0,339,184,523
2019-10-06,7,3107,4436,1875,9082,9173,1799,47,20215,0,29,0,29,344,191,535
2019-10-06,8,3101,4513,2035,9134,9045,1733,48,20071,170,1371,181,1722,335,200,535
2019-10-06,9,3257,4544,2134,9142,8957,1693,50,19939,846,4683,865,6394,303,214,517
2019-10-06,10,3449,4548,2142,9038,9057,1671,49,19913,1165,6440,1368,8973,245,266,511
2019-10-06,11,3620,4525,2077,8842,9223,1657,50,19867,1234,6882,1591,9707,237,344,581
2019-10-06,12,3764,4562,2025,8785,9631,1668,52,20231,1236,7059,1624,9919,196,408,604
2019-10-06,13,3890,4546,2004,8889,10157,1695,56,20893,1212,7069,1603,9884,145,439,584
2019-10-06,14,4050,4566,1966,9325,10883,1779,59,22142,1212,7115,1600,9927,96,446,542
2019-10-06,15,4228,4619,1943,9833,11659,1873,61,23522,1223,7069,1597,9889,58,407,465
2019-10-06,16,4433,4714,1955,10472,12488,2020,64,25139,1181,6695,1490,9366,28,351,379
2019-10-06,17,4562,4802,2005,11300,13031,2194,67,26688,1048,5478,1203,7729,18,294,312
2019-10-06,18,4581,4869,2077,12014,13254,2408,66,27837,521,2484,552,3557,16,231,247
2019-10-06,19,4646,5122,2161,12495,13419,2615,66,28690,50,288,61,399,15,202,217
2019-10-06,20,4567,5136,2228,12880,13345,2700,63,29084,1,38,0,39,21,210,231
2019-10-06,21,4397,4963,2142,12476,12829,2582,59,28041,0,0,0,0,36,181,217
2019-10-06,22,4155,4706,1997,11831,12125,2408,54,26516,0,0,0,0,49,163,212
2019-10-06,23,3826,4463,1838,10926,11312,2193,49,24578,0,0,0,0,74,156,230
2019-10-06,24,3575,4300,1704,10133,10427,2002,44,22706,0,0,0,0,87,151,238
2019-10-07,1,3329,4181,1647,9390,9947,1923,41,21403,0,0,0,0,65,132,197
2019-10-07,2,3202,4156,1612,9020,9529,1853,40,20540,0,0,0,0,61,125,186
2019-10-07,3,3120,4165,1607,8784,9266,1814,40,20003,0,0,0,0,56,117,173
2019-10-07,4,3072,4255,1635,8760,9174,1796,40,19868,0,0,0,0,55,112,167
2019-10-07,5,3108,4460,1728,8968,9413,1828,43,20350,0,0,0,0,58,111,169
2019-10-07,6,3260,4846,1952,9553,10072,1956,47,21726,0,0,0,0,60,107,167
2019-10-07,7,3452,5155,2302,10569,11046,2159,53,23925,0,21,0,21,61,102,163
2019-10-07,8,3490,5185,2508,11208,11369,2160,54,24888,165,1514,195,1874,58,87,145
2019-10-07,9,3605,5180,2459,11149,11566,2106,54,24975,897,5184,941,7022,49,72,121
2019-10-07,10,3744,5160,2403,10937,11699,2098,54,24889,1271,6935,1489,9695,43,74,117
2019-10-07,11,3888,5125,2348,10784,12005,2102,55,25047,1307,7338,1669,10314,29,79,108
2019-10-07,12,4011,5092,2321,10785,12387,2142,58,25472,1299,7422,1680,10401,19,79,98
2019-10-07,13,4172,5090,2316,10885,12900,2177,61,26120,1285,7455,1664,10404,14,83,97
2019-10-07,14,4356,5083,2319,11297,13600,2289,65,27347,1284,7423,1660,10367,21,89,110
2019-10-07,15,4545,5081,2314,11823,14327,2336,68,28653,1307,7402,1676,10385,27,111,138
2019-10-07,16,4745,5110,2326,12478,15030,2441,70,30115,1298,6984,1619,9901,40,184,224
2019-10-07,17,4893,5199,2340,13235,15401,2560,72,31363,1172,5697,1377,8246,60,330,390
2019-10-07,18,4878,5201,2364,13830,15426,2699,71,32123,579,2353,599,3531,94,507,601
2019-10-07,19,4963,5395,2413,14152,15350,2859,70,32526,54,193,62,309,166,810,976
2019-10-07,20,4856,5365,2448,14307,15229,2859,66,32558,1,9,0,10,230,1148,1378
2019-10-07,21,4625,5128,2310,13692,14434,2733,61,31016,0,0,0,0,280,1247,1527
2019-10-07,22,4304,4806,2138,12829,13543,2557,56,29082,0,0,0,0,313,1291,1604
2019-10-07,23,3927,4519,1949,11756,12368,2311,50,26590,0,0,0,0,334,1351,1685
2019-10-07,24,3631,4323,1785,10824,11332,2103,45,24407,0,0,0,0,360,1377,1737
2019-10-08,1,3367,4284,1733,10069,10519,1999,42,22730,0,0,0,0,314,1433,1747
2019-10-08,2,3221,4238,1677,9626,10059,1909,41,21738,0,0,0,0,293,1458,1751
2019-10-08,3,3134,4215,1644,9347,9740,1846,40,21075,0,0,0,0,271,1451,1722
2019-10-08,4,3096,4276,1644,9253,9615,1815,41,20826,0,0,0,0,250,1452,1702
2019-10-08,5,3125,4468,1708,9444,9799,1841,43,21232,0,0,0,0,229,1408,1637
2019-10-08,6,3232,4845,1909,9998,10363,1972,47,22482,0,0,0,0,204,1249,1453
2019-10-08,7,3448,5152,2239,11007,11341,2191,51,24691,0,19,0,19,125,1077,1202
2019-10-08,8,3492,5176,2426,11678,11575,2259,53,25667,160,1491,192,1843,122,892,1014
2019-10-08,9,3612,5187,2403,11502,11708,2266,53,25629,833,5156,938,6927,101,658,759
2019-10-08,10,3755,5180,2386,11185,11862,2234,53,25437,1112,6897,1462,9471,78,526,604
2019-10-08,11,3918,5170,2353,10965,12107,2198,55,25428,1126,7295,1613,10034,61,485,546
2019-10-08,12,4087,5184,2347,10890,12433,2186,59,25664,1070,7378,1627,10075,67,628,695
2019-10-08,13,4284,5252,2348,10993,12799,2208,62,26158,1049,7395,1618,10062,89,953,1042
2019-10-08,14,4498,5322,2337,11381,13428,2283,67,27261,1080,7371,1621,10072,111,1338,1449
2019-10-08,15,4704,5402,2305,11878,14082,2378,70,28506,1096,7348,1643,10087,153,1767,1920
2019-10-08,16,4908,5491,2286,12514,14733,2486,73,29908,1075,6850,1564,9489,226,2083,2309
2019-10-08,17,5011,5549,2290,13128,15125,2602,76,31034,975,5563,1338,7876,303,2308,2611
2019-10-08,18,5025,5526,2333,13665,15158,2698,74,31700,487,2251,580,3318,335,2370,2705
2019-10-08,19,5066,5643,2444,13986,15125,2830,72,32117,46,176,61,283,370,2379,2749
2019-10-08,20,4951,5510,2541,14210,15000,2893,69,32272,1,9,0,10,621,2464,3085
2019-10-08,21,4725,5208,2453,13588,14261,2755,63,30768,0,0,0,0,673,2496,3169
2019-10-08,22,4428,4886,2282,12691,13354,2557,57,28759,0,0,0,0,766,2562,3328
2019-10-08,23,4084,4586,2092,11615,12228,2299,51,26294,0,0,0,0,812,2627,3439
2019-10-08,24,3772,4374,1926,10716,11210,2086,46,24159,0,0,0,0,788,2668,3456
2019-10-09,1,3535,4308,1825,10215,10513,1973,42,22844,0,0,0,0,833,2755,3588
2019-10-09,2,3366,4243,1776,9821,10027,1882,40,21871,0,0,0,0,810,2750,3560
2019-10-09,3,3272,4215,1755,9530,9784,1823,40,21273,0,0,0,0,760,2750,3510
2019-10-09,4,3225,4272,1774,9434,9662,1793,40,21023,0,0,0,0,680,2734,3414
2019-10-09,5,3243,4451,1861,9617,9851,1818,42,21423,0,0,0,0,598,2680,3278
2019-10-09,6,3395,4818,2103,10182,10410,1953,46,22685,0,0,0,0,507,2565,3072
2019-10-09,7,3593,5142,2477,11265,11345,2187,51,24943,0,17,0,17,521,2421,2942
2019-10-09,8,3608,5197,2692,11906,11628,2256,52,25936,164,1466,183,1813,630,2334,2964
2019-10-09,9,3711,5231,2644,11718,11766,2249,52,25884,927,5123,951,7001,736,2426,3162
2019-10-09,10,3843,5257,2579,11321,11855,2197,54,25526,1277,6919,1494,9690,884,2687,3571
2019-10-09,11,3993,5291,2519,11079,12002,2135,57,25373,1315,7350,1675,10340,887,2792,3679
2019-10-09,12,4138,5317,2448,10929,12173,2100,60,25361,1306,7427,1692,10425,887,2904,3791
2019-10-09,13,4289,5357,2404,10776,12360,2093,63,25392,1294,7426,1675,10395,882,3018,3900
2019-10-09,14,4436,5366,2364,10870,12781,2136,67,25953,1294,7403,1670,10367,878,3056,3934
2019-10-09,15,4582,5388,2330,11131,13232,2210,69,26743,1317,7375,1688,10380,882,3095,3977
2019-10-09,16,4716,5430,2296,11590,13709,2303,72,27774,1308,6978,1632,9918,886,3104,3990
2019-10-09,17,4757,5477,2299,12151,13959,2457,71,28738,1181,5667,1401,8249,905,3112,4017
2019-10-09,18,4729,5514,2368,12531,13839,2613,69,29149,577,2267,597,3441,903,2993,3896
2019-10-09,19,4793,5719,2474,12884,13887,2701,67,29637,49,166,61,276,914,2961,3875
2019-10-09,20,4738,5679,2581,13172,13978,2739,64,30051,2,9,0,11,997,3050,4047
2019-10-09,21,4552,5431,2519,12735,13445,2651,60,28990,0,0,0,0,1068,3112,4180
2019-10-09,22,4275,5103,2358,11991,12684,2507,55,27340,0,0,0,0,1101,3071,4172
2019-10-09,23,3932,4812,2173,11107,11754,2283,50,25296,0,0,0,0,1121,2898,4019
2019-10-09,24,3647,4618,2019,10345,10876,2070,46,23438,0,0,0,0,1145,2356,3501
2019-10-10,1,3460,4508,1913,9647,10166,1976,46,21935,0,0,0,0,1106,1935,3041
2019-10-10,2,3304,4472,1881,9280,9719,1897,44,21039,0,0,0,0,1112,1248,2360
2019-10-10,3,3206,4472,1879,9070,9468,1832,44,20514,0,0,0,0,1112,806,1918
2019-10-10,4,3183,4556,1913,8989,9332,1802,44,20269,0,0,0,0,1114,648,1762
2019-10-10,5,3233,4758,2018,9196,9518,1828,45,20689,0,0,0,0,1106,602,1708
2019-10-10,6,3358,5149,2275,9815,10146,1958,48,22074,0,0,0,0,1088,572,1660
2019-10-10,7,3561,5457,2663,10879,11145,2191,52,24373,0,17,0,17,1052,600,1652
2019-10-10,8,3586,5465,2862,11480,11403,2244,54,25289,163,1505,183,1851,1020,678,1698
2019-10-10,9,3622,5424,2769,11207,11341,2190,57,24888,938,5184,952,7074,1010,809,1819
2019-10-10,10,3648,5370,2652,10770,11252,2142,59,24306,1269,6940,1468,9677,986,964,1950
2019-10-10,11,3665,5318,2545,10373,11280,2097,58,23888,1303,7220,1636,10159,911,1150,2061
2019-10-10,12,3661,5272,2421,10203,11380,2082,57,23804,1291,7308,1653,10252,798,1238,2036
2019-10-10,13,3689,5264,2343,10062,11553,2109,57,23861,1200,7339,1576,10115,646,1272,1918
2019-10-10,14,3767,5236,2279,10121,11909,2191,56,24358,1179,7255,1554,9988,490,1267,1757
2019-10-10,15,3860,5233,2222,10418,12331,2304,56,25195,1164,7144,1526,9834,363,1210,1573
2019-10-10,16,3942,5256,2188,10891,12742,2434,56,26218,1121,6562,1403,9086,271,1141,1412
2019-10-10,17,3952,5290,2199,11499,12891,2561,57,27103,993,5333,1187,7513,217,1051,1268
2019-10-10,18,3966,5389,2253,11956,13021,2659,57,27790,465,2086,497,3048,170,888,1058
2019-10-10,19,4114,5616,2360,12479,13333,2793,59,28759,38,111,51,200,165,770,935
2019-10-10,20,4149,5612,2485,12827,13496,2844,60,29322,1,7,0,8,158,687,845
2019-10-10,21,4054,5394,2447,12408,13009,2703,57,28273,0,0,0,0,150,647,797
2019-10-10,22,3909,5090,2305,11731,12377,2522,55,26780,0,0,0,0,153,618,771
2019-10-10,23,3801,4821,2132,10873,11468,2269,51,24758,0,0,0,0,155,611,766
2019-10-10,24,3601,4654,1988,10075,10614,2071,49,22913,0,0,0,0,164,623,787
2019-10-11,1,3360,4510,1923,9450,10280,1928,46,21798,0,0,0,0,187,595,782
2019-10-11,2,3263,4491,1887,9048,9896,1849,46,20933,0,0,0,0,229,601,830
2019-10-11,3,3202,4497,1879,8874,9578,1786,47,20380,0,0,0,0,272,580,852
2019-10-11,4,3191,4571,1910,8824,9550,1767,48,20284,0,0,0,0,284,558,842
2019-10-11,5,3243,4767,2005,9037,9688,1798,52,20670,0,0,0,0,277,539,816
2019-10-11,6,3395,5128,2241,9649,10323,1917,57,22038,0,0,0,0,269,520,789
2019-10-11,7,3586,5417,2597,10740,11233,2149,64,24273,0,16,0,16,264,509,773
2019-10-11,8,3560,5412,2803,11341,11472,2182,64,25149,135,1357,154,1646,257,502,759
2019-10-11,9,3572,5326,2721,11043,11433,2107,58,24749,766,4746,837,6349,218,555,773
2019-10-11,10,3568,5213,2615,10499,11358,2034,54,24053,1075,6470,1334,8879,175,640,815
2019-10-11,11,3565,5094,2507,10112,11496,1982,51,23748,1126,6940,1527,9593,152,713,865
2019-10-11,12,3546,4994,2391,9918,11638,1976,49,23687,1117,7122,1558,9797,130,741,871
2019-10-11,13,3562,4940,2306,9808,11929,2023,49,23915,1087,7132,1532,9751,99,763,862
2019-10-11,14,3632,4884,2258,9998,12357,2137,50,24646,1081,7138,1534,9753,61,784,845
2019-10-11,15,3728,4849,2206,10292,12856,2259,50,25563,1095,7112,1552,9759,34,712,746
2019-10-11,16,3839,4829,2174,10875,13319,2396,52,26746,1063,6700,1499,9262,17,620,637
2019-10-11,17,3885,4863,2182,11500,13601,2522,53,27778,927,5361,1288,7576,15,520,535
2019-10-11,18,3893,4965,2224,11959,13604,2604,54,28323,431,2139,525,3095,16,383,399
2019-10-11,19,4004,5191,2295,12319,13745,2715,55,28940,36,131,55,222,20,337,357
2019-10-11,20,3992,5190,2360,12514,13698,2738,55,29111,0,7,0,7,31,316,347
2019-10-11,21,3889,5040,2313,12022,13139,2610,52,27923,0,0,0,0,38,272,310
2019-10-11,22,3775,4814,2197,11399,12461,2471,49,26484,0,0,0,0,50,247,297
2019-10-11,23,3738,4596,2064,10680,11669,2272,46,24769,0,0,0,0,65,234,299
2019-10-11,24,3564,4434,1932,9970,10868,2080,46,23061,0,0,0,0,79,235,314
2019-10-12,1,3290,4442,1867,9080,9893,1948,47,21057,0,0,0,0,91,194,285
2019-10-12,2,3186,4397,1822,8685,9418,1864,48,20100,0,0,0,0,86,189,275
2019-10-12,3,3124,4374,1807,8478,9077,1799,49,19491,0,0,0,0,73,178,251
2019-10-12,4,3110,4400,1820,8320,8958,1759,50,19167,0,0,0,0,65,171,236
2019-10-12,5,3135,4474,1866,8366,8939,1759,53,19192,0,0,0,0,62,167,229
2019-10-12,6,3213,4632,1967,8582,9157,1799,56,19663,0,0,0,0,66,159,225
2019-10-12,7,3280,4787,2134,9109,9507,1886,60,20637,0,15,0,15,72,160,232
2019-10-12,8,3220,4875,2324,9395,9406,1894,62,20826,144,1477,176,1797,79,137,216
2019-10-12,9,3263,4904,2397,9275,9405,1878,58,20705,909,5190,945,7044,74,121,195
2019-10-12,10,3298,4872,2372,8870,9559,1840,54,20412,1272,6967,1483,9722,66,132,198
2019-10-12,11,3309,4809,2289,8531,9642,1796,51,20109,1309,7355,1669,10333,49,162,211
2019-10-12,12,3328,4740,2191,8318,9731,1758,50,19946,1300,7561,1682,10543,29,166,195
2019-10-12,13,3373,4679,2111,8234,9927,1745,49,20045,1208,7460,1631,10299,22,170,192
2019-10-12,14,3486,4628,2060,8316,10311,1771,50,20537,1203,7437,1628,10268,29,166,195
2019-10-12,15,3628,4617,2024,8560,10754,1846,50,21299,1219,7396,1639,10254,31,147,178
2019-10-12,16,3779,4660,2021,9083,11193,2005,51,22422,1167,6911,1538,9616,33,126,159
2019-10-12,17,3891,4748,2053,9711,11548,2180,53,23579,1017,5508,1317,7842,41,113,154
2019-10-12,18,3919,4885,2102,10365,11756,2329,53,24588,415,2071,503,2989,45,102,147
2019-10-12,19,4010,5128,2192,10922,12000,2511,55,25574,29,121,50,200,64,131,195
2019-10-12,20,3949,5131,2237,11210,12148,2579,56,26079,0,9,0,9,99,187,286
2019-10-12,21,3837,5000,2165,10847,11683,2469,54,25136,0,0,0,0,125,193,318
2019-10-12,22,3662,4800,2058,10347,11131,2343,51,23956,0,0,0,0,151,194,345
2019-10-12,23,3581,4593,1937,9772,10537,2171,48,22614,0,0,0,0,182,197,379
2019-10-12,24,3414,4416,1820,9269,9870,2010,46,21282,0,0,0,0,205,194,399
2019-10-13,1,3220,4356,1772,9218,9312,1938,45,20593,0,0,0,0,248,149,397
2019-10-13,2,3111,4303,1722,8848,8979,1850,45,19803,0,0,0,0,244,144,388
2019-10-13,3,3050,4273,1709,8593,8692,1788,45,19200,0,0,0,0,249,145,394
2019-10-13,4,3021,4286,1718,8457,8585,1747,45,18911,0,0,0,0,238,147,385
2019-10-13,5,3025,4325,1755,8436,8538,1740,47,18840,0,0,0,0,245,142,387
2019-10-13,6,3059,4431,1832,8593,8650,1769,49,19141,0,0,0,0,233,124,357
2019-10-13,7,3105,4564,1954,8942,8870,1818,53,19759,0,14,0,14,229,109,338
2019-10-13,8,3052,4648,2117,9160,8724,1808,56,19819,112,1325,141,1578,226,88,314
2019-10-13,9,3123,4662,2207,9077,8700,1792,53,19691,716,4798,818,6332,180,75,255
2019-10-13,10,3196,4650,2221,8755,8734,1742,52,19350,1008,6564,1365,8937,136,84,220
2019-10-13,11,3272,4612,2171,8465,8776,1677,51,19036,1059,7106,1565,9730,110,109,219
2019-10-13,12,3358,4632,2117,8301,8880,1640,51,18940,1040,7239,1547,9826,86,134,220
2019-10-13,13,3449,4610,2093,8281,9141,1624,51,19159,1069,7160,1536,9765,76,173,249
2019-10-13,14,3589,4645,2063,8405,9485,1647,52,19654,1089,7153,1543,9785,89,244,333
2019-10-13,15,3749,4704,2037,8678,9841,1739,53,20377,1114,7078,1546,9738,125,308,433
2019-10-13,16,3936,4813,2036,9176,10242,1895,55,21436,1083,6589,1478,9150,167,381,548
2019-10-13,17,4065,4887,2070,9870,10711,2107,58,22813,946,5170,1291,7407,199,476,675
2019-10-13,18,4105,5005,2150,10568,10974,2305,58,23971,430,1895,480,2805,232,535,767
2019-10-13,19,4223,5226,2259,11324,11422,2526,59,25398,29,85,49,163,272,644,916
2019-10-13,20,4161,5191,2311,11694,11753,2603,59,26178,0,1,0,1,316,779,1095
2019-10-13,21,4011,5008,2246,11281,11356,2478,56,25239,0,0,0,0,347,868,1215
2019-10-13,22,3801,4759,2108,10721,10819,2323,52,23983,0,0,0,0,365,976,1341
2019-10-13,23,3589,4518,1952,9944,10178,2121,47,22362,0,0,0,0,387,1049,1436
2019-10-13,24,3394,4345,1810,9205,9514,1957,44,20798,0,0,0,0,395,1110,1505
2019-10-14,1,3195,4270,1728,9233,9402,1869,41,20603,0,0,0,0,420,1036,1456
2019-10-14,2,3095,4241,1697,8926,9109,1810,41,19943,0,0,0,0,391,1057,1448
2019-10-14,3,3041,4250,1697,8740,8929,1762,41,19536,0,0,0,0,356,1105,1461
2019-10-14,4,3039,4322,1724,8723,8899,1749,41,19473,0,0,0,0,317,1110,1427
2019-10-14,5,3087,4502,1829,8962,9179,1784,44,20025,0,0,0,0,273,1069,1342
2019-10-14,6,3237,4883,2072,9582,9880,1904,48,21474,0,0,0,0,213,903,1116
2019-10-14,7,3451,5227,2440,10706,10909,2137,52,23859,0,12,0,12,200,730,930
2019-10-14,8,3429,5258,2668,11477,11237,2199,53,25038,130,1281,158,1569,203,525,728
2019-10-14,9,3445,5260,2606,11285,11298,2175,53,24890,838,4718,912,6468,170,277,447
2019-10-14,10,3484,5248,2542,10835,11324,2124,53,24403,1143,6503,1416,9062,127,167,294
2019-10-14,11,3571,5248,2473,10405,11385,2021,52,23932,1196,7037,1611,9844,80,134,214
2019-10-14,12,3655,5252,2398,10106,11440,1953,53,23623,1182,7173,1618,9973,71,121,192
2019-10-14,13,3758,5272,2363,10032,11568,1936,54,23659,1150,7059,1581,9790,48,138,186
2019-10-14,14,3909,5284,2344,10216,11827,1975,56,24139,1145,7081,1591,9817,39,155,194
2019-10-14,15,4056,5314,2310,10494,12073,2048,57,24740,1170,7002,1601,9773,53,145,198
2019-10-14,16,4206,5395,2288,11023,12412,2180,59,25744,1128,6506,1529,9163,70,141,211
2019-10-14,17,4327,5413,2287,11595,12635,2321,62,26683,964,5015,1256,7235,91,149,240
2019-10-14,18,4300,5474,2346,12116,12690,2453,61,27397,404,1822,470,2696,138,214,352
2019-10-14,19,4412,5640,2447,12702,13056,2633,61,28536,24,81,45,150,168,360,528
2019-10-14,20,4373,5538,2491,12945,13252,2715,60,29054,0,1,0,1,213,542,755
2019-10-14,21,4203,5308,2413,12511,12807,2573,56,28018,0,0,0,0,232,520,752
2019-10-14,22,3948,4992,2262,11826,12202,2409,52,26567,0,0,0,0,279,471,750
2019-10-14,23,3665,4690,2089,10916,11275,2186,48,24510,0,0,0,0,309,429,738
2019-10-14,24,3417,4499,1937,10159,10445,2010,44,22742,0,0,0,0,332,365,697
2019-10-15,1,3217,4352,1811,9328,9726,1926,41,21084,0,0,0,0,334,361,695
2019-10-15,2,3107,4306,1762,8975,9349,1850,41,20279,0,0,0,0,268,292,560
2019-10-15,3,3047,4288,1749,8738,9122,1798,41,19762,0,0,0,0,219,258,477
2019-10-15,4,3025,4358,1766,8683,9049,1777,41,19613,0,0,0,0,194,233,427
2019-10-15,5,3070,4557,1851,8918,9266,1812,44,20104,0,0,0,0,189,208,397
2019-10-15,6,3192,4936,2089,9542,9930,1945,49,21531,0,0,0,0,189,197,386
2019-10-15,7,3417,5258,2449,10696,10938,2185,54,23934,0,12,0,12,181,196,377
2019-10-15,8,3435,5289,2656,11507,11427,2231,55,25283,124,1330,150,1604,181,172,353
2019-10-15,9,3470,5258,2584,11270,11402,2153,54,24949,874,4880,906,6660,164,184,348
2019-10-15,10,3549,5230,2507,10795,11402,2086,53,24407,1232,6794,1455,9481,126,225,351
2019-10-15,11,3668,5203,2422,10359,11507,2044,53,24029,1267,7314,1649,10230,108,280,388
2019-10-15,12,3765,5182,2369,10012,11722,2026,53,23884,1245,7398,1645,10288,78,280,358
2019-10-15,13,3889,5205,2348,9849,12045,2061,55,24080,1204,7356,1607,10167,59,300,359
2019-10-15,14,4064,5207,2326,10018,12529,2158,57,24828,1205,7358,1618,10181,57,294,351
2019-10-15,15,4226,5227,2306,10354,13049,2287,59,25815,1225,7288,1632,10145,56,253,309
2019-10-15,16,4387,5336,2300,10819,13572,2432,62,26951,1207,6841,1570,9618,55,214,269
2019-10-15,17,4482,5347,2303,11375,13900,2583,64,27986,1054,5293,1297,7644,57,187,244
2019-10-15,18,4477,5417,2345,11931,13941,2709,63,28709,437,1855,482,2774,82,162,244
2019-10-15,19,4593,5550,2425,12608,14038,2868,64,29642,22,93,44,159,107,165,272
2019-10-15,20,4510,5469,2451,12821,14028,2897,61,29872,0,0,0,0,141,202,343
2019-10-15,21,4305,5237,2347,12386,13435,2750,57,28693,0,0,0,0,184,232,416
2019-10-15,22,4053,4934,2205,11681,12663,2559,53,27021,0,0,0,0,239,227,466
2019-10-15,23,3725,4654,2028,10743,11645,2302,48,24803,0,0,0,0,296,216,512
2019-10-15,24,3467,4461,1878,9972,10704,2094,44,22878,0,0,0,0,340,190,530
2019-10-16,1,3265,4339,1789,9453,9863,1970,42,21395,0,0,0,0,371,173,544
2019-10-16,2,3146,4290,1738,9099,9423,1882,41,20510,0,0,0,0,355,163,518
2019-10-16,3,3077,4276,1713,8873,9139,1819,41,19939,0,0,0,0,348,146,494
2019-10-16,4,3049,4342,1724,8808,9028,1789,41,19732,0,0,0,0,342,128,470
2019-10-16,5,3086,4539,1798,8991,9222,1818,44,20140,0,0,0,0,319,132,451
2019-10-16,6,3202,4914,2016,9587,9855,1952,48,21505,0,0,0,0,324,127,451
2019-10-16,7,3425,5236,2362,10696,10858,2187,54,23857,0,10,0,10,345,129,474
2019-10-16,8,3442,5263,2563,11378,11108,2247,55,24849,89,1072,116,1277,374,119,493
2019-10-16,9,3488,5237,2507,10975,11207,2202,54,24501,577,3965,664,5206,343,113,456
2019-10-16,10,3587,5210,2456,10623,11271,2161,53,24174,849,5474,1109,7432,302,130,432
2019-10-16,11,3714,5179,2408,10271,11519,2133,53,24044,898,5931,1315,8144,262,145,407
2019-10-16,12,3819,5169,2373,10044,11863,2153,55,24183,892,6005,1337,8234,233,136,369
2019-10-16,13,3972,5203,2358,9894,12298,2193,58,24510,845,6005,1348,8198,248,132,380
2019-10-16,14,4157,5270,2339,9991,12901,2294,61,25314,855,5914,1326,8095,274,129,403
2019-10-16,15,4330,5351,2319,10258,13540,2408,63,26336,821,5740,1255,7816,358,109,467
2019-10-16,16,4499,5444,2297,10638,14132,2541,66,27444,774,5143,1140,7057,452,129,581
2019-10-16,17,4579,5520,2298,11072,14467,2672,69,28346,640,3795,926,5361,605,199,804
2019-10-16,18,4605,5554,2351,11697,14487,2789,67,29107,277,1277,360,1914,686,223,909
2019-10-16,19,4726,5630,2451,12472,14498,2932,67,30035,12,48,34,94,772,324,1096
2019-10-16,20,4647,5450,2473,12741,14395,2954,64,30220,0,0,0,0,835,519,1354
2019-10-16,21,4443,5189,2379,12327,13735,2784,59,28971,0,0,0,0,871,686,1557
2019-10-16,22,4184,4883,2226,11657,12901,2601,54,27279,0,0,0,0,857,867,1724
2019-10-16,23,3875,4595,2045,10737,11827,2349,49,25028,0,0,0,0,873,986,1859
2019-10-16,24,3576,4390,1881,9962,10845,2130,45,23047,0,0,0,0,802,1052,1854
2019-10-17,1,3365,4267,1768,9643,10343,2001,41,22083,0,0,0,0,710,985,1695
2019-10-17,2,3238,4203,1707,9322,9847,1919,40,21182,0,0,0,0,685,1048,1733
2019-10-17,3,3151,4178,1680,9100,9507,1855,40,20556,0,0,0,0,680,1210,1890
2019-10-17,4,3106,4240,1688,9033,9365,1828,40,20327,0,0,0,0,645,1384,2029
2019-10-17,5,3145,4426,1763,9205,9529,1857,43,20692,0,0,0,0,632,1596,2228
2019-10-17,6,3308,4790,1984,9743,10103,1984,47,21931,0,0,0,0,658,2027,2685
2019-10-17,7,3509,5113,2330,10749,11145,2233,52,24234,0,9,0,9,679,2093,2772
2019-10-17,8,3553,5158,2539,11578,11494,2317,54,25507,82,1130,117,1329,609,2086,2695
2019-10-17,9,3640,5178,2518,11610,11606,2324,53,25658,610,4413,738,5761,579,2138,2717
2019-10-17,10,3743,5180,2481,11467,11696,2255,53,25537,966,6303,1213,8482,442,2429,2871
2019-10-17,11,3862,5181,2442,11244,11868,2142,54,25373,1049,6989,1380,9418,340,2655,2995
2019-10-17,12,3959,5184,2397,10944,12014,2088,55,25167,1044,7088,1412,9544,275,2775,3050
2019-10-17,13,4057,5248,2367,10636,12206,2072,57,25039,1067,7111,1416,9594,278,2934,3212
2019-10-17,14,4175,5288,2344,10533,12578,2120,59,25357,1073,7117,1456,9646,281,3066,3347
2019-10-17,15,4294,5346,2312,10659,12869,2184,61,25840,1092,6975,1453,9520,277,3178,3455
2019-10-17,16,4378,5369,2288,10897,13140,2294,63,26460,1076,6568,1366,9010,334,3271,3605
2019-10-17,17,4418,5348,2291,11306,13214,2399,62,27047,919,4955,1035,6909,439,3309,3748
2019-10-17,18,4386,5368,2339,11713,13134,2521,60,27494,381,1628,367,2376,471,3328,3799
2019-10-17,19,4501,5492,2453,12268,13466,2663,60,28516,16,74,35,125,514,3315,3829
2019-10-17,20,4467,5408,2495,12527,13496,2710,58,28845,0,0,0,0,501,3350,3851
2019-10-17,21,4305,5183,2398,12153,12931,2577,56,27771,0,0,0,0,420,3398,3818
2019-10-17,22,4089,4898,2246,11611,12168,2433,52,26319,0,0,0,0,397,3390,3787
2019-10-17,23,3789,4623,2069,10797,11229,2214,48,24342,0,0,0,0,396,3397,3793
2019-10-17,24,3525,4429,1909,10057,10421,2036,44,22615,0,0,0,0,382,3457,3839
2019-10-18,1,3351,4282,1798,9253,10013,1992,45,21357,0,0,0,0,357,3389,3746
2019-10-18,2,3221,4224,1741,8909,9556,1910,44,20474,0,0,0,0,347,3294,3641
2019-10-18,3,3135,4214,1721,8710,9275,1847,44,19930,0,0,0,0,337,3110,3447
2019-10-18,4,3109,4282,1733,8622,9147,1814,44,19681,0,0,0,0,334,2918,3252
2019-10-18,5,3141,4465,1810,8821,9336,1846,46,20110,0,0,0,0,299,2630,2929
2019-10-18,6,3254,4811,2021,9411,9927,1962,49,21407,0,0,0,0,284,2332,2616
2019-10-18,7,3444,5128,2350,10499,10901,2185,53,23692,0,8,0,8,258,2100,2358
2019-10-18,8,3450,5183,2558,11207,11164,2241,54,24720,101,1199,122,1422,248,1838,2086
2019-10-18,9,3495,5180,2540,11050,11209,2219,54,24594,767,4646,813,6226,259,1325,1584
2019-10-18,10,3560,5164,2493,10626,11255,2134,54,24137,1092,6505,1368,8965,258,933,1191
2019-10-18,11,3633,5139,2439,10185,11319,2078,53,23702,1143,7052,1568,9763,250,622,872
2019-10-18,12,3675,5107,2374,9977,11438,2051,53,23585,1120,7133,1576,9829,237,417,654
2019-10-18,13,3744,5092,2320,9770,11649,2067,54,23607,1066,6987,1558,9611,246,466,712
2019-10-18,14,3845,5063,2284,9759,12125,2139,54,24142,1066,6970,1569,9605,282,552,834
2019-10-18,15,3965,5049,2241,9868,12585,2261,55,24835,1062,6878,1562,9502,326,867,1193
2019-10-18,16,4079,5039,2213,10171,13030,2409,56,25727,1028,6379,1514,8921,409,1319,1728
2019-10-18,17,4121,5041,2217,10689,13243,2517,59,26562,848,4774,1173,6795,484,1644,2128
2019-10-18,18,4077,5137,2263,11117,13217,2599,57,27045,324,1526,408,2258,523,1933,2456
2019-10-18,19,4220,5295,2356,11683,13429,2690,59,27915,11,61,33,105,566,2079,2645
2019-10-18,20,4179,5227,2384,11950,13379,2691,59,28134,0,0,0,0,584,2203,2787
2019-10-18,21,4030,5061,2281,11554,12773,2576,56,27013,0,0,0,0,600,2213,2813
2019-10-18,22,3850,4847,2146,11083,12110,2457,53,25756,0,0,0,0,583,2222,2805
2019-10-18,23,3723,4612,2005,10395,11355,2282,49,24135,0,0,0,0,571,2201,2772
2019-10-18,24,3534,4423,1863,9778,10543,2092,46,22512,0,0,0,0,578,2082,2660
2019-10-19,1,3309,4310,1777,9231,9734,1985,42,21059,0,0,0,0,649,2088,2737
2019-10-19,2,3192,4251,1714,8860,9271,1892,42,20130,0,0,0,0,622,2023,2645
2019-10-19,3,3117,4238,1682,8602,9008,1827,42,19544,0,0,0,0,624,1972,2596
2019-10-19,4,3091,4266,1674,8480,8847,1784,42,19216,0,0,0,0,627,1888,2515
2019-10-19,5,3114,4340,1699,8525,8870,1789,44,19294,0,0,0,0,631,1833,2464
2019-10-19,6,3159,4493,1782,8763,9102,1827,47,19798,0,0,0,0,591,1809,2400
2019-10-19,7,3250,4668,1921,9249,9424,1914,51,20703,0,7,0,7,579,1765,2344
2019-10-19,8,3225,4760,2087,9612,9338,1918,53,20985,89,1132,125,1346,580,1786,2366
2019-10-19,9,3288,4812,2205,9664,9381,1893,52,21045,735,4599,817,6151,551,1607,2158
2019-10-19,10,3332,4811,2258,9450,9454,1849,50,20859,1107,6532,1386,9025,529,1637,2166
2019-10-19,11,3357,4783,2248,9189,9481,1798,49,20579,1161,7063,1576,9800,508,1618,2126
2019-10-19,12,3416,4755,2208,8949,9530,1765,48,20350,1136,7175,1590,9901,604,1644,2248
2019-10-19,13,3503,4725,2162,8792,9741,1770,48,20408,1124,7126,1590,9840,595,1854,2449
2019-10-19,14,3637,4693,2112,8789,10094,1810,49,20807,1127,7151,1601,9879,599,1996,2595
2019-10-19,15,3770,4724,2082,8963,10574,1903,50,21557,1132,7077,1598,9807,606,2165,2771
2019-10-19,16,3928,4770,2073,9330,11039,2078,52,22566,1099,6570,1536,9205,644,2230,2874
2019-10-19,17,4031,4865,2106,9854,11427,2257,55,23659,920,4911,1173,7004,670,2311,2981
2019-10-19,18,4033,5031,2165,10432,11669,2403,54,24624,337,1520,404,2261,675,2299,2974
2019-10-19,19,4158,5227,2266,11130,12092,2588,55,25931,10,58,29,97,655,2323,2978
2019-10-19,20,4108,5176,2284,11415,12177,2624,55,26337,0,0,0,0,586,2316,2902
2019-10-19,21,3962,5010,2188,11161,11659,2499,53,25437,0,0,0,0,523,2270,2793
2019-10-19,22,3792,4803,2074,10757,11131,2379,50,24383,0,0,0,0,455,2284,2739
2019-10-19,23,3624,4572,1954,10157,10557,2207,47,23035,0,0,0,0,446,2325,2771
2019-10-19,24,3452,4394,1831,9612,9902,2051,44,21676,0,0,0,0,389,2397,2786
2019-10-20,1,3299,4335,1729,9170,9459,1955,43,20692,0,0,0,0,346,2821,3167
2019-10-20,2,3184,4281,1678,8779,9034,1864,42,19785,0,0,0,0,284,2815,3099
2019-10-20,3,3112,4258,1662,8527,8725,1796,42,19154,0,0,0,0,258,2750,3008
2019-10-20,4,3074,4275,1672,8391,8546,1756,42,18800,0,0,0,0,248,2670,2918
2019-10-20,5,3063,4324,1712,8401,8515,1752,44,18776,0,0,0,0,233,2539,2772
2019-10-20,6,3079,4432,1788,8539,8618,1779,46,19046,0,0,0,0,208,2259,2467
2019-10-20,7,3149,4593,1926,8866,8874,1826,49,19677,0,6,0,6,198,1978,2176
2019-10-20,8,3098,4674,2093,9191,8754,1811,50,19871,74,1026,98,1198,198,1688,1886
2019-10-20,9,3175,4690,2211,9133,8515,1788,52,19549,653,4266,691,5610,191,1366,1557
2019-10-20,10,3261,4686,2249,8856,8595,1746,51,19316,1018,6290,1154,8462,188,1036,1224
2019-10-20,11,3335,4665,2222,8626,8783,1716,50,19241,1088,6848,1388,9324,183,817,1000
2019-10-20,12,3390,4707,2166,8466,9070,1722,50,19374,1081,6940,1463,9484,174,582,756
2019-10-20,13,3462,4703,2110,8356,9446,1744,50,19662,1075,6950,1484,9509,191,561,752
2019-10-20,14,3575,4718,2049,8410,9985,1806,50,20317,1090,6984,1520,9594,216,532,748
2019-10-20,15,3702,4756,2007,8656,10673,1919,51,21364,1099,6895,1496,9490,246,547,793
2019-10-20,16,3843,4838,1988,9075,11367,2107,52,22666,1137,6433,1432,9002,293,589,882
2019-10-20,17,3913,4907,2016,9585,11939,2326,55,23971,927,4758,1058,6743,358,687,1045
2019-10-20,18,3943,5077,2115,10290,12265,2535,55,25211,326,1410,358,2094,365,821,1186
2019-10-20,19,4123,5277,2272,11057,12721,2758,56,26658,8,45,15,68,355,1012,1367
2019-10-20,20,4090,5231,2329,11373,12725,2799,58,27020,0,0,0,0,342,1084,1426
2019-10-20,21,3937,5068,2242,11110,12151,2660,55,26042,0,0,0,0,308,985,1293
2019-10-20,22,3741,4825,2101,10603,11631,2483,51,24834,0,0,0,0,276,838,1114
2019-10-20,23,3637,4594,1942,9906,10833,2263,47,23114,0,0,0,0,251,729,980
2019-10-20,24,3440,4444,1799,9340,10172,2064,44,21685,0,0,0,0,226,593,819
2019-10-21,1,3236,4425,1710,9102,9537,1931,41,20682,0,0,0,0,182,395,577
2019-10-21,2,3132,4387,1676,8781,9173,1855,40,19921,0,0,0,0,171,339,510
2019-10-21,3,3081,4392,1673,8623,9016,1811,41,19562,0,0,0,0,171,327,498
2019-10-21,4,3072,4478,1705,8582,8961,1777,42,19434,0,0,0,0,161,308,469
2019-10-21,5,3124,4686,1803,8816,9222,1794,45,19949,0,0,0,0,158,261,419
2019-10-21,6,3281,5069,2041,9424,9887,1927,49,21360,0,0,0,0,166,227,393
2019-10-21,7,3524,5421,2411,10574,10947,2158,56,23806,0,6,0,6,184,205,389
2019-10-21,8,3533,5458,2619,11394,11312,2239,56,25073,82,1041,115,1238,204,197,401
2019-10-21,9,3545,5449,2581,11216,11386,2239,56,24963,775,4432,834,6041,205,203,408
2019-10-21,10,3559,5413,2524,10865,11651,2225,54,24863,1172,6357,1407,8936,217,229,446
2019-10-21,11,3586,5369,2465,10675,11971,2230,53,24996,1214,6843,1596,9653,245,254,499
2019-10-21,12,3621,5341,2392,10519,12372,2288,54,25299,1181,6883,1614,9678,256,248,504
2019-10-21,13,3697,5346,2353,10481,12858,2375,55,25835,1160,6847,1595,9602,261,230,491
2019-10-21,14,3831,5337,2324,10649,13419,2501,57,26693,1168,6939,1609,9716,251,211,462
2019-10-21,15,3973,5338,2286,10954,14050,2642,58,27771,1190,6879,1604,9673,237,184,421
2019-10-21,16,4103,5356,2260,11528,14659,2774,60,29088,1177,6442,1538,9157,220,164,384
2019-10-21,17,4187,5384,2268,11907,14920,2892,61,29845,957,4785,1157,6899,194,145,339
2019-10-21,18,4217,5553,2340,12572,14902,3010,61,30610,319,1385,375,2079,165,127,292
2019-10-21,19,4385,5702,2458,13113,15052,3148,62,31441,7,43,22,72,166,149,315
2019-10-21,20,4345,5618,2458,13196,14852,3121,60,31295,0,0,0,0,157,164,321
2019-10-21,21,4174,5402,2368,12687,14085,2944,57,29837,0,0,0,0,159,157,316
2019-10-21,22,3938,5089,2218,11977,13279,2728,52,28102,0,0,0,0,170,160,330
2019-10-21,23,3697,4804,2042,11052,12216,2451,48,25833,0,0,0,0,174,167,341
2019-10-21,24,3471,4612,1886,10280,11211,2215,44,23818,0,0,0,0,162,182,344
2019-10-22,1,3277,4470,1776,9714,10364,2092,42,22303,0,0,0,0,236,203,439
2019-10-22,2,3169,4416,1718,9331,9929,1989,41,21370,0,0,0,0,229,222,451
2019-10-22,3,3111,4412,1695,9074,9632,1920,41,20747,0,0,0,0,225,235,460
2019-10-22,4,3089,4492,1706,8981,9507,1880,42,20496,0,0,0,0,222,243,465
2019-10-22,5,3130,4681,1781,9178,9694,1892,44,20878,0,0,0,0,218,255,473
2019-10-22,6,3265,5056,2003,9788,10325,2009,49,22242,0,0,0,0,210,263,473
2019-10-22,7,3502,5394,2344,10888,11422,2235,54,24669,0,5,0,5,210,258,468
2019-10-22,8,3498,5413,2557,11617,11704,2319,56,25767,73,1067,115,1255,202,249,451
2019-10-22,9,3507,5379,2513,11430,11758,2360,55,25677,748,4553,833,6134,184,253,437
2019-10-22,10,3536,5340,2469,11104,11995,2390,54,25614,1162,6552,1421,9135,179,270,449
2019-10-22,11,3606,5303,2415,10876,12339,2433,53,25773,1208,7060,1606,9874,169,272,441
2019-10-22,12,3672,5277,2385,10745,12869,2502,54,26242,1176,7101,1623,9900,145,252,397
2019-10-22,13,3762,5283,2371,10765,13435,2605,56,26932,1135,7053,1595,9783,143,238,381
2019-10-22,14,3911,5276,2354,11127,14137,2758,58,28150,1138,7069,1610,9817,140,211,351
2019-10-22,15,4066,5297,2333,11593,14888,2910,59,29519,1163,7015,1606,9784,129,177,306
2019-10-22,16,4205,5329,2322,12209,15483,3061,61,30884,1153,6573,1536,9262,112,161,273
2019-10-22,17,4289,5359,2341,12862,15795,3170,63,31960,933,4875,1131,6939,105,160,265
2019-10-22,18,4295,5509,2383,13408,15680,3234,63,32460,294,1374,364,2032,98,167,265
2019-10-22,19,4434,5648,2468,13871,15753,3340,63,33101,6,49,19,74,110,231,341
2019-10-22,20,4378,5546,2455,13856,15482,3291,60,32760,0,0,0,0,117,342,459
2019-10-22,21,4178,5335,2348,13240,14615,3093,57,31080,0,0,0,0,130,376,506
2019-10-22,22,3938,5032,2207,12450,13692,2863,53,29139,0,0,0,0,161,377,538
2019-10-22,23,3693,4750,2040,11421,12522,2567,48,26650,0,0,0,0,209,390,599
2019-10-22,24,3463,4559,1884,10551,11452,2314,45,24451,0,0,0,0,237,376,613
2019-10-23,1,3250,4387,1790,9822,10794,2144,42,22872,0,0,0,0,172,123,295
2019-10-23,2,3138,4330,1737,9404,10282,2027,42,21838,0,0,0,0,210,90,300
2019-10-23,3,3080,4321,1714,9144,9928,1953,42,21146,0,0,0,0,243,68,311
2019-10-23,4,3054,4392,1726,9074,9767,1903,42,20867,0,0,0,0,254,63,317
2019-10-23,5,3095,4586,1809,9252,9909,1912,45,21208,0,0,0,0,245,56,301
2019-10-23,6,3224,4959,2044,9820,10432,2033,49,22432,0,0,0,0,230,47,277
2019-10-23,7,3460,5299,2405,10847,11409,2257,54,24650,0,0,0,0,220,43,263
2019-10-23,8,3465,5329,2631,11619,11676,2326,56,25750,100,900,113,1113,231,45,276
2019-10-23,9,3479,5304,2594,11485,11852,2363,55,25826,551,3541,629,4721,254,49,303
2019-10-23,10,3538,5285,2528,11238,12090,2376,54,25827,1011,5756,1198,7965,264,56,320
2019-10-23,11,3635,5272,2472,11089,12442,2385,54,26039,1128,6503,1435,9066,322,70,392
2019-10-23,12,3726,5256,2402,10996,12874,2421,54,26416,1104,6626,1494,9224,421,84,505
2019-10-23,13,3831,5273,2360,11027,13405,2493,56,27052,1077,6625,1496,9198,458,94,552
2019-10-23,14,3982,5262,2329,11391,14039,2595,59,28154,1079,6644,1498,9221,464,102,566
2019-10-23,15,4132,5275,2297,11878,14771,2717,60,29495,1109,6567,1496,9172,473,109,582
2019-10-23,16,4269,5296,2272,12368,15439,2841,62,30781,1102,6068,1390,8560,471,115,586
2019-10-23,17,4340,5326,2281,13023,15667,2942,64,31764,843,4184,993,6020,453,120,573
2019-10-23,18,4336,5478,2346,13508,15550,3013,64,32202,300,1344,340,1984,433,126,559
2019-10-23,19,4459,5630,2462,13980,15578,3135,64,32825,6,51,4,61,424,127,551
2019-10-23,20,4422,5544,2471,13927,15249,3102,61,32406,0,6,1,7,474,131,605
2019-10-23,21,4237,5330,2398,13320,14351,2912,57,30707,0,1,0,1,590,140,730
2019-10-23,22,3994,5028,2259,12562,13495,2711,53,28889,0,0,0,0,731,153,884
2019-10-23,23,3706,4758,2087,11538,12415,2443,49,26519,0,0,0,0,857,173,1030
2019-10-23,24,3474,4580,1939,10667,11367,2223,45,24373,0,0,0,0,918,209,1127
2019-10-24,1,3265,4452,1816,9827,10813,2069,42,22833,0,0,0,0,928,322,1250
2019-10-24,2,3161,4403,1773,9421,10314,1975,41,21836,0,0,0,0,891,385,1276
2019-10-24,3,3102,4410,1758,9156,9969,1907,41,21160,0,0,0,0,823,441,1264
2019-10-24,4,3081,4493,1776,9049,9791,1866,42,20829,0,0,0,0,774,503,1277
2019-10-24,5,3127,4691,1868,9254,9955,1878,44,21227,0,0,0,0,780,578,1358
2019-10-24,6,3259,5076,2106,9808,10556,1996,49,22500,0,0,0,0,788,645,1433
2019-10-24,7,3500,5411,2472,10835,11629,2228,54,24840,0,0,0,0,757,672,1429
2019-10-24,8,3505,5424,2690,11533,11942,2293,56,25924,94,885,108,1087,703,666,1369
2019-10-24,9,3513,5368,2624,11326,11985,2318,55,25760,535,3528,619,4682,630,682,1312
2019-10-24,10,3533,5319,2542,11103,12172,2338,55,25742,988,5806,1198,7992,567,773,1340
2019-10-24,11,3557,5274,2464,10941,12203,2362,54,25631,1104,6575,1444,9123,509,948,1457
2019-10-24,12,3577,5226,2375,10870,13164,2414,54,26566,1085,6665,1507,9257,418,1133,1551
2019-10-24,13,3625,5218,2329,10862,13680,2506,54,27164,1065,6663,1511,9239,319,1253,1572
2019-10-24,14,3724,5191,2293,11252,14318,2655,55,28344,1071,6692,1510,9273,236,1277,1513
2019-10-24,15,3829,5183,2255,11804,14891,2817,54,29631,1098,6602,1497,9197,167,1216,1383
2019-10-24,16,3937,5195,2248,12392,15448,2974,55,30928,1088,6098,1379,8565,119,1104,1223
2019-10-24,17,3957,5204,2259,13122,15664,3087,57,31988,828,4184,983,5995,90,958,1048
2019-10-24,18,3955,5377,2309,13609,15415,3149,55,32294,289,1330,335,1954,77,821,898
2019-10-24,19,4095,5543,2401,13950,15452,3258,58,32794,4,50,3,57,75,697,772
2019-10-24,20,4094,5475,2386,13752,15128,3215,59,32223,0,4,1,5,77,602,679
2019-10-24,21,3963,5273,2305,13128,14396,3023,55,30669,0,1,0,1,75,544,619
2019-10-24,22,3761,4991,2178,12431,13629,2806,51,28985,0,0,0,0,69,504,573
2019-10-24,23,3666,4730,2019,11378,12513,2529,48,26537,0,0,0,0,66,497,563
2019-10-24,24,3466,4565,1877,10597,11480,2287,45,24491,0,0,0,0,66,505,571
2019-10-25,1,3306,4445,1788,9984,10874,2118,43,23091,0,0,0,0,47,509,556
2019-10-25,2,3211,4413,1737,9563,10353,2014,43,22046,0,0,0,0,49,520,569
2019-10-25,3,3152,4408,1715,9275,9984,1967,43,21342,0,0,0,0,64,506,570
2019-10-25,4,3139,4485,1727,9109,9837,1941,44,21006,0,0,0,0,93,478,571
2019-10-25,5,3188,4676,1804,9286,9983,1939,47,21331,0,0,0,0,132,455,587
2019-10-25,6,3325,5022,2019,9814,10485,2044,52,22464,0,0,0,0,151,447,598
2019-10-25,7,3550,5354,2340,10682,11408,2267,57,24491,0,0,0,0,137,440,577
2019-10-25,8,3540,5364,2557,11380,11633,2348,60,25491,90,869,105,1064,113,429,542
2019-10-25,9,3540,5303,2518,11321,11840,2341,55,25640,534,3502,622,4658,91,419,510
2019-10-25,10,3538,5228,2465,11073,12024,2383,53,25589,998,5786,1206,7990,57,417,474
2019-10-25,11,3541,5149,2399,10832,12413,2391,51,25745,1115,6561,1447,9123,28,418,446
2019-10-25,12,3538,5071,2336,10750,12779,2422,50,26062,1094,6674,1504,9272,17,398,415
2019-10-25,13,3561,5033,2293,10801,13197,2487,51,26590,1070,6679,1508,9257,9,354,363
2019-10-25,14,3660,4992,2271,11202,13754,2608,51,27680,1074,6704,1508,9286,5,288,293
2019-10-25,15,3778,4980,2254,11703,14387,2734,52,28941,1100,6623,1495,9218,5,217,222
2019-10-25,16,3890,4973,2237,12181,14912,2852,53,30063,1090,6105,1376,8571,5,156,161
2019-10-25,17,3954,4980,2237,12782,15167,2940,54,31010,823,4140,973,5936,9,116,125
2019-10-25,18,3980,5130,2258,13104,14980,2980,55,31183,281,1328,325,1934,27,117,144
2019-10-25,19,4107,5262,2321,13264,14980,3071,56,31437,2,44,3,49,78,142,220
2019-10-25,20,4052,5168,2277,13027,14589,2998,56,30735,0,5,1,6,159,187,346
2019-10-25,21,3902,5014,2167,12368,13852,2820,53,29156,0,1,0,1,229,209,438
2019-10-25,22,3724,4805,2064,11708,13121,2654,49,27598,0,0,0,0,257,207,464
2019-10-25,23,3655,4585,1951,10971,12248,2446,46,25778,0,0,0,0,264,215,479
2019-10-25,24,3487,4402,1834,10324,11334,2231,44,24005,0,0,0,0,280,238,518
2019-10-26,1,3284,4350,1816,9838,10728,2051,43,22737,0,0,0,0,215,357,572
2019-10-26,2,3167,4289,1767,9376,10107,1942,42,21547,0,0,0,0,188,440,628
2019-10-26,3,3101,4269,1741,9044,9680,1871,42,20719,0,0,0,0,143,531,674
2019-10-26,4,3068,4292,1742,8864,9453,1828,43,20271,0,0,0,0,117,623,740
2019-10-26,5,3083,4360,1781,8847,9371,1814,45,20162,0,0,0,0,115,667,782
2019-10-26,6,3139,4500,1881,9045,9570,1847,48,20593,0,0,0,0,109,646,755
2019-10-26,7,3245,4690,2042,9448,9947,1930,52,21456,0,4,0,4,97,584,681
2019-10-26,8,3207,4796,2228,9869,9964,1946,54,21905,58,917,81,1056,97,509,606
2019-10-26,9,3267,4851,2356,9904,10134,1976,53,22140,695,4352,750,5797,101,421,522
2019-10-26,10,3325,4852,2371,9761,10436,1971,52,22286,1058,6531,1340,8929,93,326,419
2019-10-26,11,3382,4824,2345,9576,10753,1947,50,22391,1102,7065,1535,9702,95,293,388
2019-10-26,12,3471,4798,2290,9411,11147,1940,50,22611,1069,7135,1544,9748,104,349,453
2019-10-26,13,3546,4774,2215,9391,11591,1960,51,23058,1019,7049,1509,9577,98,522,620
2019-10-26,14,3684,4768,2147,9569,12052,2009,53,23749,1020,7032,1522,9574,87,883,970
2019-10-26,15,3828,4797,2096,9894,12672,2111,55,24798,1049,6970,1526,9545,80,1400,1480
2019-10-26,16,3972,4859,2080,10366,13311,2262,58,26063,1007,6455,1393,8855,79,1850,1929
2019-10-26,17,4069,4945,2113,10917,13752,2396,62,27184,789,4517,1001,6307,87,2065,2152
2019-10-26,18,4085,5135,2190,11480,13756,2517,62,27875,217,1100,291,1608,120,2126,2246
2019-10-26,19,4156,5293,2325,12006,13826,2712,62,28675,3,35,4,42,188,2145,2333
2019-10-26,20,4082,5215,2323,11921,13402,2712,58,28158,0,0,0,0,255,2136,2391
2019-10-26,21,3941,5066,2232,11448,12809,2564,54,26934,0,0,0,0,309,2124,2433
2019-10-26,22,3788,4873,2130,10956,12151,2427,51,25646,0,0,0,0,369,2133,2502
2019-10-26,23,3571,4663,2012,10349,11426,2264,48,24150,0,0,0,0,451,2147,2598
2019-10-26,24,3400,4496,1898,9799,10625,2099,44,22638,0,0,0,0,520,2155,2675
2019-10-27,1,3230,4460,1831,9343,9920,1997,42,21380,0,0,0,0,663,1948,2611
2019-10-27,2,3123,4409,1788,8944,9379,1911,42,20357,0,0,0,0,907,1897,2804
2019-10-27,3,3064,4390,1780,8688,9060,1844,42,19723,0,0,0,0,1099,1874,2973
2019-10-27,4,3032,4406,1792,8546,8851,1804,42,19334,0,0,0,0,1175,1832,3007
2019-10-27,5,3024,4462,1841,8506,8870,1794,43,19304,0,0,0,0,1197,1764,2961
2019-10-27,6,3040,4580,1934,8640,8970,1816,45,19561,0,0,0,0,1203,1706,2909
2019-10-27,7,3131,4765,2083,8922,9263,1872,48,20198,0,3,0,3,1196,1650,2846
2019-10-27,8,3087,4852,2275,9186,9241,1886,50,20464,57,819,74,950,1193,1547,2740
2019-10-27,9,3148,4856,2407,9267,9229,1911,52,20515,681,3955,685,5321,1199,1336,2535
2019-10-27,10,3220,4853,2414,9015,9332,1892,51,20343,1129,6134,1268,8531,1203,1154,2357
2019-10-27,11,3286,4830,2366,8838,9429,1844,49,20214,1174,6677,1457,9308,1201,1159,2360
2019-10-27,12,3341,4874,2281,8724,9557,1803,48,20180,1128,6759,1478,9365,1197,1193,2390
2019-10-27,13,3389,4867,2207,8567,9668,1778,47,20108,1104,6718,1481,9303,1193,1187,2380
2019-10-27,14,3472,4880,2142,8624,9891,1811,47,20421,1105,6692,1491,9288,1191,1220,2411
2019-10-27,15,3552,4914,2087,8884,10128,1862,48,20971,1147,6567,1476,9190,1190,1258,2448
2019-10-27,16,3649,5002,2061,9266,10431,2003,49,21798,1136,5931,1349,8416,1186,1307,2493
2019-10-27,17,3676,5076,2095,9882,10745,2166,53,22893,893,4073,975,5941,1176,1367,2543
2019-10-27,18,3755,5271,2224,10542,11140,2332,54,24124,242,954,279,1475,1161,1369,2530
2019-10-27,19,3899,5443,2399,11271,11870,2555,57,25824,2,22,3,27,1151,1332,2483
2019-10-27,20,3906,5365,2443,11509,12087,2575,57,26296,0,0,0,0,1150,1228,2378
2019-10-27,21,3830,5201,2365,11202,11754,2444,53,25522,0,0,0,0,1147,1126,2273
2019-10-27,22,3704,4963,2243,10693,11232,2293,50,24342,0,0,0,0,1141,1123,2264
2019-10-27,23,3646,4744,2092,9987,10574,2101,47,22780,0,0,0,0,1132,1031,2163
2019-10-27,24,3467,4627,1959,9394,9871,1943,45,21327,0,0,0,0,1121,854,1975
2019-10-28,1,3227,4556,1878,8743,9171,1850,44,19871,0,0,0,0,1102,747,1849
2019-10-28,2,3135,4555,1860,8428,8863,1788,44,19192,0,0,0,0,1065,676,1741
2019-10-28,3,3109,4580,1872,8313,8684,1750,46,18859,0,0,0,0,1016,595,1611
2019-10-28,4,3111,4689,1924,8295,8598,1731,49,18742,0,0,0,0,955,545,1500
2019-10-28,5,3188,4918,2055,8539,8865,1768,53,19295,0,0,0,0,885,539,1424
2019-10-28,6,3388,5333,2326,9236,9544,1909,59,20813,0,0,0,0,835,500,1335
2019-10-28,7,3661,5694,2726,10452,10662,2152,68,23420,0,3,0,3,773,427,1200
2019-10-28,8,3648,5694,2976,11321,11106,2225,71,24814,56,805,88,949,669,385,1054
2019-10-28,9,3623,5599,2904,11096,11117,2146,64,24503,664,3966,763,5393,509,393,902
2019-10-28,10,3594,5509,2785,10489,11049,2064,59,23721,1009,6029,1303,8341,349,448,797
2019-10-28,11,3581,5409,2687,10133,11058,2005,55,23306,1067,6545,1496,9108,267,493,760
2019-10-28,12,3551,5330,2559,9896,11061,1999,52,23063,1040,6609,1529,9178,197,461,658
2019-10-28,13,3557,5302,2472,9743,11181,2023,51,23049,1024,6441,1483,8948,112,372,484
2019-10-28,14,3625,5252,2395,9762,11350,2095,50,23314,1027,6420,1496,8943,54,269,323
2019-10-28,15,3712,5229,2325,9964,11523,2189,50,23784,1059,6321,1501,8881,24,181,205
2019-10-28,16,3816,5244,2270,10355,11723,2302,51,24491,1050,5819,1384,8253,25,120,145
2019-10-28,17,3885,5309,2288,10833,11892,2413,53,25249,814,3920,990,5724,51,90,141
2019-10-28,18,3928,5526,2392,11507,12079,2549,54,26248,212,863,280,1355,93,87,180
2019-10-28,19,4108,5682,2574,12307,12621,2739,57,27784,2,38,3,43,184,117,301
2019-10-28,20,4132,5598,2621,12459,12654,2706,58,27936,0,0,0,0,292,190,482
2019-10-28,21,4020,5388,2533,11997,12275,2574,56,26960,0,0,0,0,364,296,660
2019-10-28,22,3860,5076,2384,11342,11683,2428,55,25566,0,0,0,0,398,442,840
2019-10-28,23,3722,4807,2202,10464,10844,2205,53,23626,0,0,0,0,394,649,1043
2019-10-28,24,3524,4662,2075,9761,10086,2015,52,21976,0,0,0,0,371,891,1262
2019-10-29,1,3365,4820,2143,8767,9571,1899,50,20353,0,0,0,0,350,1126,1476
2019-10-29,2,3288,4791,2114,8478,9163,1829,51,19589,0,0,0,0,334,1328,1662
2019-10-29,3,3264,4796,2106,8306,8935,1782,53,19142,0,0,0,0,323,1487,1810
2019-10-29,4,3273,4875,2133,8309,8812,1775,55,19014,0,0,0,0,315,1599,1914
2019-10-29,5,3350,5083,2238,8565,9038,1818,59,19542,0,0,0,0,305,1676,1981
2019-10-29,6,3523,5465,2498,9251,9700,1968,65,21051,0,0,0,0,288,1729,2017
2019-10-29,7,3790,5821,2886,10443,10751,2237,72,23569,0,2,0,2,265,1766,2031
2019-10-29,8,3751,5828,3129,11306,11125,2293,76,24862,55,777,78,910,247,1786,2033
2019-10-29,9,3667,5760,3081,10948,10990,2161,66,24254,692,3933,743,5368,243,1803,2046
2019-10-29,10,3596,5698,2984,10364,10862,2050,58,23409,1131,6041,1321,8493,261,1825,2086
2019-10-29,11,3552,5655,2910,9918,10737,1967,54,22743,1169,6556,1508,9233,311,1880,2191
2019-10-29,12,3539,5627,2832,9581,10730,1911,51,22340,1129,6615,1533,9277,393,1985,2378
2019-10-29,13,3544,5643,2778,9359,10769,1882,49,22134,1093,6546,1505,9144,502,2127,2629
2019-10-29,14,3602,5623,2725,9413,11022,1928,49,22482,1101,6530,1513,9144,616,2256,2872
2019-10-29,15,3693,5648,2670,9552,11226,1994,49,22896,1146,6491,1523,9160,714,2327,3041
2019-10-29,16,3774,5699,2640,9946,11470,2112,50,23647,1131,6023,1414,8568,789,2325,3114
2019-10-29,17,3845,5771,2644,10465,11627,2236,51,24449,887,4019,1015,5921,850,2263,3113
2019-10-29,18,3907,5954,2756,11110,11865,2380,53,25471,227,854,278,1359,905,2173,3078
2019-10-29,19,4066,6082,2915,11963,12445,2595,55,27122,2,46,3,51,966,2026,2992
2019-10-29,20,4106,5970,2945,12162,12497,2615,54,27393,0,0,0,0,1033,1821,2854
2019-10-29,21,4009,5733,2836,11775,12140,2502,51,26535,0,0,0,0,1087,1593,2680
2019-10-29,22,3865,5422,2673,11111,11707,2367,49,25300,0,0,0,0,1126,1363,2489
2019-10-29,23,3752,5155,2485,10267,10909,2163,47,23453,0,0,0,0,1149,1148,2297
2019-10-29,24,3574,4997,2335,9580,10145,1988,47,21822,0,0,0,0,1156,960,2116
2019-10-30,1,3358,4968,2287,9093,9536,1916,52,20675,0,0,0,0,999,671,1670
2019-10-30,2,3273,4937,2258,8766,9176,1841,55,19919,0,0,0,0,967,752,1719
2019-10-30,3,3248,4949,2269,8575,8951,1796,56,19472,0,0,0,0,923,762,1685
2019-10-30,4,3251,5030,2317,8572,8889,1782,59,19366,0,0,0,0,885,794,1679
2019-10-30,5,3328,5236,2443,8789,9112,1828,63,19856,0,0,0,0,826,814,1640
2019-10-30,6,3517,5623,2719,9499,9740,1985,70,21352,0,0,0,0,751,817,1568
2019-10-30,7,3774,5965,3121,10708,10804,2257,78,23913,0,2,0,2,664,788,1452
2019-10-30,8,3731,5970,3353,11550,11173,2319,82,25186,54,754,78,886,608,769,1377
2019-10-30,9,3652,5885,3269,11160,10963,2181,73,24438,665,3908,717,5290,561,830,1391
2019-10-30,10,3597,5793,3133,10462,10795,2061,64,23443,1128,6034,1292,8454,523,942,1465
2019-10-30,11,3568,5678,3005,10058,10761,1977,61,22917,1167,6540,1499,9206,497,1036,1533
2019-10-30,12,3534,5564,2853,9756,10715,1939,59,22529,1121,6578,1524,9223,394,1082,1476
2019-10-30,13,3546,5523,2749,9520,10743,1960,54,22336,1085,6506,1487,9078,264,1098,1362
2019-10-30,14,3604,5478,2664,9536,10915,2009,51,22570,1095,6497,1494,9086,167,1082,1249
2019-10-30,15,3691,5485,2598,9681,11110,2102,51,23008,1137,6445,1513,9095,109,1021,1130
2019-10-30,16,3791,5530,2560,10077,11341,2236,51,23768,1125,5975,1403,8503,74,951,1025
2019-10-30,17,3865,5602,2575,10551,11492,2364,53,24536,872,3997,992,5861,49,877,926
2019-10-30,18,3952,5852,2700,11243,11772,2484,56,25619,218,850,264,1332,38,766,804
2019-10-30,19,4111,5999,2873,12117,12467,2676,61,27384,1,47,1,49,39,689,728
2019-10-30,20,4110,5920,2915,12268,12520,2695,64,27618,0,0,0,0,42,624,666
2019-10-30,21,4022,5720,2831,11893,12195,2580,62,26820,0,0,0,0,44,595,639
2019-10-30,22,3885,5421,2685,11286,11720,2449,62,25604,0,0,0,0,42,568,610
2019-10-30,23,3763,5160,2502,10415,10947,2236,60,23735,0,0,0,0,47,561,608
2019-10-30,24,3593,5005,2353,9700,10195,2052,60,22084,0,0,0,0,48,551,599
2019-10-31,1,3490,4978,2271,9182,9917,1944,64,21152,0,0,0,0,77,484,561
2019-10-31,2,3432,4948,2237,8875,9601,1881,65,20464,0,0,0,0,90,462,552
2019-10-31,3,3423,4959,2240,8706,9326,1829,67,19972,0,0,0,0,103,461,564
2019-10-31,4,3444,5039,2278,8698,9294,1811,70,19913,0,0,0,0,118,449,567
2019-10-31,5,3535,5241,2396,8931,9537,1857,75,20444,0,0,0,0,131,433,564
2019-10-31,6,3727,5627,2665,9628,10310,2012,82,22073,0,0,0,0,144,417,561
2019-10-31,7,3978,5972,3050,10829,11389,2295,91,24648,0,2,0,2,147,406,553
2019-10-31,8,3941,5969,3263,11665,11625,2358,93,25785,51,744,63,858,137,391,528
2019-10-31,9,3823,5881,3182,11267,11050,2223,81,24670,622,3911,679,5212,127,394,521
2019-10-31,10,3716,5780,3048,10574,10812,2096,71,23593,1100,6000,1261,8361,110,417,527
2019-10-31,11,3620,5666,2930,10146,10716,2024,64,22992,1147,6513,1449,9109,102,449,551
2019-10-31,12,3533,5568,2798,9871,10681,1992,57,22643,1105,6565,1472,9142,103,431,534
2019-10-31,13,3471,5537,2708,9668,10782,2015,54,22561,1071,6478,1453,9002,102,414,516
2019-10-31,14,3449,5510,2628,9705,11090,2088,52,22977,1074,6488,1463,9025,85,380,465
2019-10-31,15,3454,5518,2556,9878,11363,2194,51,23527,1102,6445,1476,9023,70,330,400
2019-10-31,16,3491,5553,2502,10257,11633,2340,52,24320,1101,5952,1361,8414,56,283,339
2019-10-31,17,3581,5607,2521,10792,11874,2478,54,25243,857,3885,951,5693,52,234,286
2019-10-31,18,3690,5841,2631,11418,12261,2613,56,26392,208,789,247,1244,45,201,246
2019-10-31,19,3877,5973,2788,12234,13038,2774,59,28146,1,42,1,44,52,206,258
2019-10-31,20,3879,5882,2828,12360,12992,2739,60,28192,0,0,0,0,70,203,273
2019-10-31,21,3853,5682,2744,11970,12586,2617,60,27278,0,0,0,0,86,195,281
2019-10-31,22,3761,5395,2609,11388,11963,2480,61,25931,0,0,0,0,101,186,287
2019-10-31,23,3683,5138,2436,10547,11176,2266,60,24090,0,0,0,0,119,182,301
2019-10-31,24,3540,4963,2277,9863,10404,2073,60,22442,0,0,0,0,137,174,311
2019-11-01,1,3462,4859,2139,9605,9863,1883,67,21466,0,0,0,0,118,177,295
2019-11-01,2,3378,4812,2087,9276,9481,1805,67,20682,0,0,0,0,117,165,282
2019-11-01,3,3351,4812,2083,9083,9238,1763,69,20205,0,0,0,0,111,166,277
2019-11-01,4,3355,4888,2112,9064,9114,1749,71,20062,0,0,0,0,101,165,266
2019-11-01,5,3424,5080,2217,9300,9354,1797,75,20580,0,0,0,0,98,168,266
2019-11-01,6,3594,5458,2465,9970,10013,1944,82,22062,0,0,0,0,101,173,274
2019-11-01,7,3848,5855,2846,11184,11097,2177,90,24602,0,1,0,1,107,183,290
2019-11-01,8,3824,5868,3086,12043,11532,2236,93,25956,37,707,61,805,116,190,306
2019-11-01,9,3744,5799,3029,11644,11295,2090,82,25152,606,3857,689,5152,113,187,300
2019-11-01,10,3679,5716,2914,10964,10899,1932,72,23901,1083,6003,1288,8374,110,208,318
2019-11-01,11,3603,5620,2802,10391,10736,1832,66,23053,1134,6524,1485,9143,107,235,342
2019-11-01,12,3550,5536,2683,9967,10637,1777,60,22470,1101,6563,1510,9174,89,241,330
2019-11-01,13,3529,5488,2580,9699,10732,1768,58,22284,1068,6477,1488,9033,78,241,319
2019-11-01,14,3555,5444,2493,9745,11109,1795,56,22741,1073,6485,1500,9058,73,238,311
2019-11-01,15,3595,5434,2411,9944,11484,1895,55,23413,1105,6437,1501,9043,71,208,279
2019-11-01,16,3654,5441,2355,10329,11741,2031,55,24195,1104,5846,1387,8337,67,184,251
2019-11-01,17,3717,5548,2388,10834,12060,2191,57,25185,852,3724,957,5533,68,162,230
2019-11-01,18,3822,5689,2491,11455,12215,2352,59,26136,201,813,237,1251,74,163,237
2019-11-01,19,4004,5776,2628,12230,12774,2480,64,27589,1,36,1,38,80,180,260
2019-11-01,20,4038,5709,2630,12242,12680,2449,64,27496,0,0,0,0,83,196,279
2019-11-01,21,3948,5527,2544,11868,12289,2381,63,26648,0,0,0,0,82,195,277
2019-11-01,22,3842,5308,2443,11332,11815,2289,63,25539,0,0,0,0,88,195,283
2019-11-01,23,3750,5099,2311,10629,11098,2135,63,23972,0,0,0,0,96,197,293
2019-11-01,24,3587,4925,2167,9946,10362,1964,62,22386,0,0,0,0,95,195,290
2019-11-02,1,3467,4682,2046,9452,9689,1874,57,21116,0,0,0,0,81,235,316
2019-11-02,2,3367,4626,1993,9052,9189,1793,58,20136,0,0,0,0,81,235,316
2019-11-02,3,3310,4621,1985,8821,8886,1735,59,19544,0,0,0,0,78,237,315
2019-11-02,4,3280,4655,2007,8689,8721,1704,60,19218,0,0,0,0,79,235,314
2019-11-02,5,3283,4734,2071,8742,8742,1717,63,19308,0,0,0,0,81,229,310
2019-11-02,6,3360,4914,2189,9090,9073,1775,66,20048,0,0,0,0,88,226,314
2019-11-02,7,3469,5170,2389,9688,9548,1874,73,21229,0,1,0,1,93,219,312
2019-11-02,8,3430,5283,2591,10241,9639,1922,77,21923,35,683,59,777,93,207,300
2019-11-02,9,3438,5308,2705,10019,9429,1840,70,21404,600,3755,687,5042,91,202,293
2019-11-02,10,3453,5272,2668,9536,9348,1740,63,20720,1071,5921,1276,8268,90,221,311
2019-11-02,11,3447,5198,2567,9009,9204,1651,57,19953,1110,6463,1466,9039,88,247,335
2019-11-02,12,3432,5109,2443,8684,9173,1603,54,19551,1073,6460,1488,9021,74,245,319
2019-11-02,13,3425,5029,2312,8556,9328,1601,53,19572,1046,6461,1479,8986,71,239,310
2019-11-02,14,3468,4962,2202,8611,9620,1624,52,19941,1058,6475,1495,9028,60,222,282
2019-11-02,15,3524,4946,2136,8884,10022,1724,51,20725,1095,6371,1486,8952,45,175,220
2019-11-02,16,3593,4962,2134,9305,10424,1891,51,21719,1091,5844,1379,8314,32,133,165
2019-11-02,17,3687,5129,2179,9917,10700,2084,53,22796,822,3747,938,5507,29,103,132
2019-11-02,18,3783,5304,2291,10676,11118,2266,55,24160,183,716,225,1124,30,95,125
2019-11-02,19,3967,5439,2426,11528,11754,2422,60,25813,0,16,1,17,35,115,150
2019-11-02,20,3954,5436,2419,11564,11698,2404,61,25769,0,0,0,0,51,139,190
2019-11-02,21,3847,5291,2341,11225,11401,2330,59,25057,0,0,0,0,69,143,212
2019-11-02,22,3744,5087,2269,10762,11064,2248,58,24173,0,0,0,0,81,141,222
2019-11-02,23,3686,4890,2160,10137,10467,2107,55,22808,0,0,0,0,103,133,236
2019-11-02,24,3518,4720,2038,9548,9813,1951,52,21406,0,0,0,0,116,128,244
2019-11-03,1,3316,4582,1913,9256,9334,1866,51,20554,0,0,0,0,85,111,196
2019-11-03,2,3214,4534,1867,8932,8938,1786,51,19752,0,0,0,0,81,107,188
2019-11-03,3,3140,4554,1885,8636,8494,1701,53,18938,0,0,0,0,87,113,200
2019-11-03,4,3158,4625,1950,8644,8439,1718,57,18903,0,0,0,0,84,100,184
2019-11-03,5,3223,4754,2056,8865,8637,1774,62,19395,0,1,0,1,83,94,177
2019-11-03,6,3210,4825,2209,9161,8620,1803,67,19698,30,686,57,773,81,86,167
2019-11-03,7,3204,4927,2369,9228,8383,1795,68,19524,579,4001,697,5277,76,72,148
2019-11-03,8,3278,4920,2454,9133,8343,1731,63,19313,1050,6359,1317,8726,71,76,147
2019-11-03,9,3331,4860,2423,8782,8460,1665,57,19004,1094,6901,1511,9506,65,89,154
2019-11-03,10,3336,4781,2283,8544,8567,1597,54,18802,1059,6924,1529,9512,49,92,141
2019-11-03,11,3373,4776,2210,8435,8786,1590,52,18903,1025,6871,1513,9409,46,96,142
2019-11-03,12,3408,4733,2170,8416,9169,1632,51,19310,1034,6903,1530,9467,41,102,143
2019-11-03,13,3492,4759,2133,8635,9592,1705,50,20024,1070,6883,1521,9474,37,93,130
2019-11-03,14,3593,4835,2116,9054,9974,1819,48,20939,1065,6352,1402,8819,32,86,118
2019-11-03,15,3709,5012,2139,9565,10446,1978,49,22079,803,4021,942,5766,37,93,130
2019-11-03,16,3898,5360,2250,10364,11067,2205,52,23730,175,761,217,1153,48,108,156
2019-11-03,17,4148,5550,2436,11466,11981,2560,59,26108,0,24,1,25,70,189,259
2019-11-03,18,4088,5526,2461,11697,12067,2579,59,26445,0,0,0,0,99,288,387
2019-11-03,19,3964,5382,2427,11506,11823,2487,57,25915,0,0,0,0,119,294,413
2019-11-03,20,3790,5189,2332,11129,11476,2360,54,25069,0,0,0,0,143,276,419
2019-11-03,21,3623,4943,2209,10535,10876,2216,52,23746,0,0,0,0,170,253,423
2019-11-03,22,3491,4728,2056,9818,10144,2035,48,22108,0,0,0,0,170,224,394
2019-11-03,23,3332,4587,1921,9220,9526,1893,46,20730,0,0,0,0,162,209,371
2019-11-03,24,3214,4534,1867,8932,8938,1786,51,19752,0,0,0,0,81,107,188
2019-11-04,1,3186,4487,1831,8909,8883,1845,45,19740,0,0,0,0,152,192,344
2019-11-04,2,3106,4467,1801,8643,8556,1785,45,19084,0,0,0,0,146,178,324
2019-11-04,3,3065,4486,1806,8488,8435,1742,46,18772,0,0,0,0,137,176,313
2019-11-04,4,3068,4589,1852,8537,8456,1734,49,18848,0,0,0,0,133,169,302
2019-11-04,5,3144,4829,1978,8837,8767,1796,53,19511,0,0,0,0,130,132,262
2019-11-04,6,3316,5229,2259,9535,9512,1957,61,21131,0,1,0,1,129,107,236
2019-11-04,7,3456,5491,2629,10640,10276,2142,69,23193,27,673,51,751,123,84,207
2019-11-04,8,3481,5540,2824,11213,10683,2169,66,24181,530,3960,662,5152,107,72,179
2019-11-04,9,3516,5489,2721,11056,10828,2108,62,24099,996,6291,1282,8569,95,71,166
2019-11-04,10,3532,5437,2622,10720,10883,2044,59,23745,1043,6835,1485,9363,79,87,166
2019-11-04,11,3548,5368,2524,10447,10922,1995,56,23456,1021,6864,1505,9390,59,98,157
2019-11-04,12,3566,5314,2454,10281,11046,1968,55,23387,972,6808,1496,9276,46,104,150
2019-11-04,13,3623,5304,2418,10252,11263,2012,55,23611,984,6828,1511,9323,41,101,142
2019-11-04,14,3723,5296,2386,10515,11591,2085,55,24277,1016,6797,1499,9312,34,90,124
2019-11-04,15,3828,5318,2366,10889,11979,2173,55,25135,1017,6242,1380,8639,36,85,121
2019-11-04,16,3936,5428,2362,11306,12317,2278,57,26002,746,3867,921,5534,41,80,121
2019-11-04,17,4112,5712,2450,11927,12743,2460,60,27233,160,708,205,1073,50,82,132
2019-11-04,18,4322,5882,2612,12805,13627,2768,65,29308,0,20,0,20,63,117,180
2019-11-04,19,4259,5823,2622,12918,13278,2749,64,29052,0,0,0,0,87,188,275
2019-11-04,20,4101,5645,2585,12580,12774,2650,62,28108,0,0,0,0,115,167,282
2019-11-04,21,3932,5403,2487,12034,12234,2523,58,26893,0,0,0,0,141,125,266
2019-11-04,22,3730,5092,2339,11291,11614,2352,54,25354,0,0,0,0,165,103,268
2019-11-04,23,3567,4831,2168,10402,10758,2134,50,23388,0,0,0,0,170,95,265
2019-11-04,24,3373,4658,2015,9719,9967,1962,47,21752,0,0,0,0,161,104,265
2019-11-05,1,3227,4534,1904,9463,9417,1897,47,20880,0,0,0,0,110,122,232
2019-11-05,2,3140,4497,1860,9163,9071,1826,47,20170,0,0,0,0,111,130,241
2019-11-05,3,3094,4505,1851,8951,8792,1776,49,19632,0,0,0,0,110,136,246
2019-11-05,4,3088,4592,1881,8955,8751,1763,50,19588,0,0,0,0,106,144,250
2019-11-05,5,3154,4825,1992,9187,9018,1817,55,20140,0,0,0,0,98,150,248
2019-11-05,6,3315,5220,2264,9842,9794,1971,63,21731,0,1,0,1,90,152,242
2019-11-05,7,3455,5474,2642,10934,10544,2171,70,23800,26,637,49,712,87,148,235
2019-11-05,8,3474,5493,2808,11432,10856,2194,66,24600,546,3845,659,5050,81,140,221
2019-11-05,9,3498,5415,2694,11111,10868,2136,61,24239,1022,6110,1276,8408,75,152,227
2019-11-05,10,3513,5343,2591,10707,10890,2067,57,23772,1072,6667,1478,9217,68,163,231
2019-11-05,11,3539,5262,2478,10424,11015,2019,54,23554,1037,6678,1501,9216,54,179,233
2019-11-05,12,3567,5202,2415,10255,11264,1999,53,23631,965,6578,1484,9027,43,180,223
2019-11-05,13,3638,5186,2378,10241,11539,2022,53,23933,970,6613,1497,9080,34,178,212
2019-11-05,14,3722,5179,2347,10571,11935,2094,53,24721,999,6536,1484,9019,27,150,177
2019-11-05,15,3821,5217,2320,10983,12319,2172,53,25571,906,5904,1325,8135,20,132,152
2019-11-05,16,3924,5335,2331,11410,12668,2292,55,26476,650,3617,875,5142,21,116,137
2019-11-05,17,4086,5603,2414,12069,13089,2472,58,27743,133,632,192,957,29,106,135
2019-11-05,18,4285,5760,2571,12938,13930,2771,63,29756,0,12,0,12,38,125,163
2019-11-05,19,4242,5717,2572,12994,13633,2739,62,29479,0,0,0,0,55,170,225
2019-11-05,20,4101,5559,2530,12659,13144,2618,59,28525,0,0,0,0,87,170,257
2019-11-05,21,3922,5321,2428,12115,12580,2496,56,27311,0,0,0,0,120,157,277
2019-11-05,22,3726,5013,2283,11368,11892,2337,52,25713,0,0,0,0,149,153,302
2019-11-05,23,3551,4757,2123,10505,11001,2130,48,23742,0,0,0,0,160,169,329
2019-11-05,24,3361,4586,1973,9840,10177,1964,46,22089,0,0,0,0,168,164,332
2019-11-06,1,3219,4497,1932,9389,9481,1905,45,20885,0,0,0,0,176,160,336
2019-11-06,2,3129,4457,1890,9090,9162,1834,45,20183,0,0,0,0,159,178,337
2019-11-06,3,3084,4468,1880,8919,8944,1781,47,19742,0,0,0,0,156,194,350
2019-11-06,4,3076,4550,1907,8931,8893,1764,48,19697,0,0,0,0,166,205,371
2019-11-06,5,3143,4794,2021,9197,9070,1817,53,20181,0,0,0,0,158,196,354
2019-11-06,6,3304,5166,2288,9892,9759,1978,60,21749,0,0,0,0,132,189,321
2019-11-06,7,3443,5413,2675,10685,10527,2155,68,23485,21,564,45,630,119,175,294
2019-11-06,8,3458,5432,2839,11207,10859,2198,63,24405,424,3488,626,4538,109,128,237
2019-11-06,9,3478,5369,2737,11052,10959,2145,60,24263,841,5660,1216,7717,87,96,183
2019-11-06,10,3495,5306,2636,10694,10946,2082,56,23820,908,6254,1409,8571,76,84,160
2019-11-06,11,3525,5236,2535,10449,11066,2034,53,23644,905,6352,1441,8698,56,97,153
2019-11-06,12,3570,5182,2463,10222,11248,2017,53,23584,899,6342,1433,8674,46,128,174
2019-11-06,13,3641,5173,2408,10174,11534,2042,53,23844,907,6346,1446,8699,33,163,196
2019-11-06,14,3736,5163,2376,10460,11938,2105,54,24597,937,6238,1421,8596,32,216,248
2019-11-06,15,3829,5196,2355,10867,12307,2183,55,25466,927,5666,1297,7890,35,293,328
2019-11-06,16,3942,5309,2359,11308,12638,2297,57,26343,665,3404,849,4918,48,376,424
2019-11-06,17,4105,5586,2454,11925,12953,2470,59,27475,118,572,179,869,62,475,537
2019-11-06,18,4312,5735,2637,12797,13663,2754,62,29323,0,11,0,11,77,581,658
2019-11-06,19,4265,5685,2681,12859,13410,2730,61,29105,0,0,0,0,100,672,772
2019-11-06,20,4115,5524,2634,12524,13005,2620,59,28268,0,0,0,0,132,647,779
2019-11-06,21,3946,5288,2532,12015,12512,2500,55,27163,0,0,0,0,157,595,752
2019-11-06,22,3731,4991,2379,11299,11806,2344,52,25573,0,0,0,0,177,515,692
2019-11-06,23,3556,4736,2206,10421,10932,2139,48,23597,0,0,0,0,166,353,519
2019-11-06,24,3369,4574,2056,9726,10132,1972,45,21929,0,0,0,0,151,203,354
2019-11-07,1,3217,4469,1975,9251,9551,1894,45,20786,0,0,0,0,96,65,161
2019-11-07,2,3130,4437,1937,8946,9183,1825,45,20054,0,0,0,0,76,49,125
2019-11-07,3,3078,4457,1930,8773,8961,1767,46,19595,0,0,0,0,60,47,107
2019-11-07,4,3073,4547,1965,8761,8902,1746,47,19510,0,0,0,0,44,45,89
2019-11-07,5,3144,4778,2080,9038,9101,1795,52,20057,0,0,0,0,35,48,83
2019-11-07,6,3309,5170,2357,9696,9764,1943,59,21509,0,0,0,0,30,53,83
2019-11-07,7,3447,5419,2747,10750,10536,2135,67,23531,17,551,33,601,26,56,82
2019-11-07,8,3475,5436,2922,11211,10831,2175,62,24356,344,2856,450,3650,22,59,81
2019-11-07,9,3502,5353,2808,11034,10859,2109,59,24108,819,5340,1052,7211,17,63,80
2019-11-07,10,3521,5282,2699,10691,10932,2035,56,23750,983,6280,1333,8596,10,80,90
2019-11-07,11,3548,5206,2585,10475,11120,1998,53,23679,976,6389,1418,8783,7,107,114
2019-11-07,12,3588,5139,2493,10307,11288,1997,53,23680,958,6382,1442,8782,6,125,131
2019-11-07,13,3651,5119,2422,10303,11609,2030,53,24031,962,6381,1440,8783,6,133,139
2019-11-07,14,3729,5097,2373,10662,12117,2122,54,24985,993,6289,1402,8684,5,138,143
2019-11-07,15,3819,5107,2340,11101,12554,2220,54,25964,966,5592,1252,7810,4,137,141
2019-11-07,16,3918,5216,2336,11656,12842,2358,56,26954,656,3363,805,4824,4,121,125
2019-11-07,17,4076,5485,2432,12294,13024,2528,59,27946,182,818,220,1220,5,98,103
2019-11-07,18,4268,5636,2616,12982,13612,2800,62,29498,0,12,0,12,8,85,93
2019-11-07,19,4222,5596,2666,12989,13336,2777,61,29205,0,0,0,0,17,81,98
2019-11-07,20,4087,5445,2616,12703,12906,2649,58,28358,0,0,0,0,42,79,121
2019-11-07,21,3923,5215,2525,12206,12457,2509,55,27271,0,0,0,0,78,77,155
2019-11-07,22,3724,4929,2377,11488,11821,2352,51,25755,0,0,0,0,109,80,189
2019-11-07,23,3559,4684,2211,10643,10979,2147,48,23859,0,0,0,0,119,90,209
2019-11-07,24,3374,4532,2067,9924,10200,1983,45,22195,0,0,0,0,110,102,212
2019-11-08,1,3235,4499,1985,9248,9780,1875,45,21005,0,0,0,0,81,91,172
2019-11-08,2,3147,4463,1943,8934,9363,1796,45,20189,0,0,0,0,59,104,163
2019-11-08,3,3103,4475,1936,8763,9091,1741,46,19697,0,0,0,0,40,114,154
2019-11-08,4,3099,4559,1968,8742,8952,1725,48,19530,0,0,0,0,30,124,154
2019-11-08,5,3169,4777,2078,9002,9194,1773,52,20074,0,0,0,0,25,135,160
2019-11-08,6,3330,5132,2337,9669,9870,1926,59,21601,0,0,0,0,21,141,162
2019-11-08,7,3474,5367,2688,10792,10617,2123,66,23655,12,533,29,574,16,144,160
2019-11-08,8,3501,5401,2847,11407,10883,2155,62,24572,328,2855,438,3621,13,144,157
2019-11-08,9,3538,5335,2753,11148,10882,2090,59,24234,802,5403,1041,7246,11,150,161
2019-11-08,10,3548,5259,2648,10725,11010,2021,54,23868,969,6353,1326,8648,8,171,179
2019-11-08,11,3557,5167,2531,10544,11244,1974,52,23859,962,6443,1410,8815,7,193,200
2019-11-08,12,3580,5088,2441,10457,11491,1966,51,24007,945,6432,1434,8811,6,215,221
2019-11-08,13,3639,5057,2375,10390,11883,2025,51,24388,950,6427,1432,8809,5,233,238
2019-11-08,14,3705,5047,2331,10658,12268,2133,51,25146,982,6316,1397,8695,7,236,243
2019-11-08,15,3793,5062,2300,11054,12725,2257,52,26130,955,5618,1250,7823,8,222,230
2019-11-08,16,3871,5145,2293,11508,13124,2403,53,27130,640,3360,806,4806,9,196,205
2019-11-08,17,4037,5392,2383,12088,13448,2572,55,28209,171,804,219,1194,17,162,179
2019-11-08,18,4240,5502,2522,12810,14019,2846,59,29777,0,12,0,12,26,163,189
2019-11-08,19,4159,5442,2518,12778,13548,2792,59,29226,0,0,0,0,42,180,222
2019-11-08,20,4002,5275,2460,12384,13035,2638,56,28171,0,0,0,0,73,188,261
2019-11-08,21,3869,5087,2366,11857,12525,2502,54,26992,0,0,0,0,120,184,304
2019-11-08,22,3710,4876,2250,11227,11953,2356,51,25640,0,0,0,0,167,177,344
2019-11-08,23,3573,4672,2124,10530,11186,2167,48,23985,0,0,0,0,194,167,361
2019-11-08,24,3412,4514,2000,9868,10401,1999,45,22368,0,0,0,0,192,155,347
2019-11-09,1,3302,4463,1929,9600,9745,1893,44,21364,0,0,0,0,143,140,283
2019-11-09,2,3211,4419,1876,9214,9210,1806,44,20356,0,0,0,0,110,136,246
2019-11-09,3,3156,4416,1858,8978,8885,1747,46,19737,0,0,0,0,82,137,219
2019-11-09,4,3134,4462,1873,8873,8737,1717,48,19460,0,0,0,0,67,133,200
2019-11-09,5,3161,4570,1930,8960,8817,1734,52,19649,0,0,0,0,61,131,192
2019-11-09,6,3237,4748,2056,9181,9088,1786,58,20195,0,0,0,0,56,128,184
2019-11-09,7,3243,4830,2211,9561,9172,1827,61,20702,9,495,25,529,51,123,174
2019-11-09,8,3246,4924,2352,9850,9155,1832,59,20964,318,2749,422,3489,45,114,159
2019-11-09,9,3316,4939,2408,9976,9289,1819,56,21181,797,5236,1022,7055,34,103,137
2019-11-09,10,3363,4907,2402,9802,9567,1780,52,21264,968,6163,1307,8438,24,98,122
2019-11-09,11,3399,4842,2331,9427,9773,1740,49,21049,972,6282,1391,8645,19,99,118
2019-11-09,12,3440,4775,2258,9322,10077,1737,47,21238,953,6253,1412,8618,18,102,120
2019-11-09,13,3477,4734,2186,9245,10462,1783,47,21580,962,6193,1411,8566,17,99,116
2019-11-09,14,3549,4724,2138,9378,10760,1866,47,22094,991,6008,1373,8372,19,93,112
2019-11-09,15,3642,4765,2113,9687,11271,1990,48,23044,957,5250,1221,7428,24,84,108
2019-11-09,16,3711,4900,2140,10179,11743,2163,48,24185,637,3098,780,4515,37,85,122
2019-11-09,17,3918,5219,2248,10768,12273,2365,52,25522,170,725,209,1104,60,115,175
2019-11-09,18,4137,5361,2402,11512,13098,2645,56,27382,0,8,0,8,122,213,335
2019-11-09,19,4071,5350,2395,11685,12781,2653,56,27248,0,0,0,0,213,342,555
2019-11-09,20,3930,5213,2321,11446,12193,2537,54,26303,0,0,0,0,293,384,677
2019-11-09,21,3799,5045,2223,11020,11646,2399,52,25169,0,0,0,0,351,363,714
2019-11-09,22,3659,4852,2126,10535,11129,2267,50,24056,0,0,0,0,387,335,722
2019-11-09,23,3541,4659,2016,9986,10503,2089,47,22700,0,0,0,0,384,311,695
2019-11-09,24,3397,4499,1903,9420,9844,1950,45,21339,0,0,0,0,365,309,674
2019-11-10,1,3287,4415,1821,9150,9373,1874,44,20503,0,0,0,0,282,402,684
2019-11-10,2,3193,4365,1772,8807,8936,1788,44,19637,0,0,0,0,207,469,676
2019-11-10,3,3134,4358,1761,8581,8637,1735,46,19060,0,0,0,0,149,505,654
2019-11-10,4,3119,4390,1776,8500,8407,1708,47,18724,0,0,0,0,119,445,564
2019-11-10,5,3139,4465,1832,8560,8371,1707,51,18754,0,0,0,0,96,322,418
2019-11-10,6,3200,4580,1941,8752,8530,1746,57,19150,0,0,0,0,74,230,304
2019-11-10,7,3199,4660,2068,9015,8569,1778,61,19489,4,462,19,485,61,215,276
2019-11-10,8,3204,4751,2213,9104,8479,1788,59,19489,290,2647,405,3342,52,166,218
2019-11-10,9,3279,4739,2278,9103,8485,1764,57,19460,742,5106,997,6845,37,78,115
2019-11-10,10,3324,4707,2290,8816,8683,1710,53,19315,925,6048,1274,8247,25,33,58
2019-11-10,11,3370,4645,2225,8605,8998,1666,50,19360,940,6180,1361,8481,22,23,45
2019-11-10,12,3412,4649,2168,8426,9332,1653,49,19522,927,6184,1400,8511,22,26,48
2019-11-10,13,3461,4639,2138,8450,9745,1676,49,19977,933,6141,1402,8476,22,33,55
2019-11-10,14,3519,4681,2102,8703,10314,1770,48,20892,965,5932,1359,8256,23,46,69
2019-11-10,15,3614,4766,2085,9176,10705,1866,49,21847,937,5166,1206,7309,23,73,96
2019-11-10,16,3706,4950,2112,9727,11103,2019,48,22958,616,3001,758,4375,29,121,150
2019-11-10,17,3905,5277,2230,10530,11591,2230,52,24471,157,673,198,1028,52,199,251
2019-11-10,18,4150,5417,2410,11546,12395,2550,58,26610,0,6,0,6,81,303,384
2019-11-10,19,4093,5384,2432,11816,12304,2563,58,26810,0,0,0,0,101,402,503
2019-11-10,20,3954,5254,2381,11601,11975,2470,55,26172,0,0,0,0,122,430,552
2019-11-10,21,3805,5073,2289,11211,11515,2342,53,25177,0,0,0,0,150,383,533
2019-11-10,22,3634,4835,2167,10641,10985,2200,50,23950,0,0,0,0,163,317,480
2019-11-10,23,3505,4618,2013,9913,10288,2022,46,22348,0,0,0,0,145,247,392
2019-11-10,24,3356,4481,1877,9260,9581,1884,44,20847,0,0,0,0,114,184,298
2019-11-11,1,3196,4373,1806,8764,9076,1846,43,19800,0,0,0,0,79,162,241
2019-11-11,2,3125,4359,1771,8476,8781,1791,43,19164,0,0,0,0,69,104,173
2019-11-11,3,3082,4361,1773,8306,8610,1733,44,18767,0,0,0,0,69,72,141
2019-11-11,4,3073,4451,1809,8341,8596,1705,46,18749,0,0,0,0,70,51,121
2019-11-11,5,3137,4704,1919,8671,8842,1761,52,19395,0,0,0,0,70,41,111
2019-11-11,6,3273,5101,2143,9344,9577,1876,56,20927,0,0,0,0,68,45,113
2019-11-11,7,3333,5368,2427,10452,10349,1987,59,22923,2,455,17,474,65,54,119
2019-11-11,8,3360,5405,2644,11052,10724,2043,57,23939,287,2678,392,3357,62,63,125
2019-11-11,9,3435,5381,2672,10917,10961,2043,58,24028,757,5261,994,7012,50,75,125
2019-11-11,10,3487,5340,2668,10587,11045,2009,55,23746,932,6265,1290,8487,38,103,141
2019-11-11,11,3534,5290,2630,10301,11119,1964,53,23484,931,6372,1377,8680,36,136,172
2019-11-11,12,3590,5248,2560,10134,11287,1933,52,23451,906,6361,1395,8662,35,156,191
2019-11-11,13,3646,5267,2495,10135,11625,1953,52,23809,901,6336,1381,8618,34,166,200
2019-11-11,14,3729,5258,2432,10407,12049,2045,52,24595,901,6227,1322,8450,30,156,186
2019-11-11,15,3831,5274,2400,10755,12409,2144,54,25396,806,5491,1138,7435,24,126,150
2019-11-11,16,3920,5366,2395,11306,12690,2283,54,26373,481,3185,684,4350,20,94,114
2019-11-11,17,4087,5675,2497,11951,13013,2461,57,27535,116,711,172,999,19,77,96
2019-11-11,18,4313,5819,2713,12817,13655,2745,63,29332,1,9,0,10,18,75,93
2019-11-11,19,4252,5736,2752,12891,13505,2717,61,29227,0,0,0,0,17,79,96
2019-11-11,20,4112,5589,2674,12507,12875,2621,59,28118,0,0,0,0,17,84,101
2019-11-11,21,3949,5360,2563,11994,12347,2482,55,26942,0,0,0,0,17,87,104
2019-11-11,22,3746,5047,2401,11254,11670,2305,52,25349,0,0,0,0,16,90,106
2019-11-11,23,3595,4790,2230,10332,10882,2099,48,23430,0,0,0,0,14,91,105
2019-11-11,24,3409,4637,2063,9616,10141,1935,45,21809,0,0,0,0,11,89,100
2019-11-12,1,3191,4608,1879,9331,9399,1874,45,20730,0,0,0,0,11,72,83
2019-11-12,2,3106,4584,1838,8987,8971,1807,45,19880,0,0,0,0,8,71,79
2019-11-12,3,3062,4606,1833,8781,8753,1752,46,19386,0,0,0,0,7,78,85
2019-11-12,4,3059,4698,1869,8751,8610,1736,47,19224,0,0,0,0,7,93,100
2019-11-12,5,3131,4942,1975,9000,8808,1792,51,19734,0,0,0,0,9,107,116
2019-11-12,6,3296,5333,2241,9538,9384,1951,57,21006,0,0,0,0,12,117,129
2019-11-12,7,3443,5593,2606,10549,10039,2154,65,22885,0,421,7,428,16,125,141
2019-11-12,8,3476,5592,2780,11151,10326,2181,61,23789,229,2551,333,3113,22,125,147
2019-11-12,9,3496,5492,2682,11214,10843,2100,59,24263,623,5072,879,6574,20,122,142
2019-11-12,10,3505,5396,2590,10844,10917,2016,55,23874,802,6074,1172,8048,14,120,134
2019-11-12,11,3519,5294,2475,10560,11086,1972,53,23719,824,6169,1258,8251,13,110,123
2019-11-12,12,3527,5212,2405,10405,11321,1968,52,23802,803,6115,1273,8191,20,96,116
2019-11-12,13,3565,5181,2340,10405,11655,2009,52,24168,812,6034,1256,8102,32,85,117
2019-11-12,14,3644,5154,2300,10659,12136,2118,53,25008,801,5825,1170,7796,39,80,119
2019-11-12,15,3727,5165,2267,11083,12544,2224,54,25948,689,4954,964,6607,38,77,115
2019-11-12,16,3827,5284,2271,11507,12815,2371,56,26794,407,2756,561,3724,34,76,110
2019-11-12,17,3976,5584,2375,12105,13010,2550,58,27770,101,596,138,835,32,80,112
2019-11-12,18,4171,5740,2557,12889,13614,2826,62,29440,0,7,0,7,31,88,119
2019-11-12,19,4154,5697,2579,12991,13389,2792,61,29278,0,0,0,0,31,99,130
2019-11-12,20,4031,5555,2517,12642,12915,2672,59,28331,0,0,0,0,39,106,145
2019-11-12,21,3902,5331,2411,12085,12439,2533,55,27154,0,0,0,0,51,95,146
2019-11-12,22,3720,5030,2261,11358,11709,2363,51,25539,0,0,0,0,58,90,148
2019-11-12,23,3553,4776,2090,10478,10856,2151,48,23608,0,0,0,0,57,97,154
2019-11-12,24,3365,4611,1954,9758,10054,1982,45,21918,0,0,0,0,54,107,161
2019-11-13,1,3224,4514,1895,9327,9316,1899,45,20632,0,0,0,0,32,115,147
2019-11-13,2,3141,4480,1857,8998,8954,1825,45,19865,0,0,0,0,28,148,176
2019-11-13,3,3099,4495,1847,8786,8721,1768,46,19365,0,0,0,0,23,178,201
2019-11-13,4,3100,4580,1878,8755,8659,1746,47,19257,0,0,0,0,23,199,222
2019-11-13,5,3171,4804,1992,8992,8894,1793,51,19782,0,0,0,0,22,189,211
2019-11-13,6,3339,5185,2261,9592,9449,1946,57,21096,0,0,0,0,20,159,179
2019-11-13,7,3495,5439,2625,10554,10095,2137,63,22911,0,350,2,352,17,130,147
2019-11-13,8,3506,5456,2812,11212,10410,2193,62,23933,154,2167,217,2538,16,91,107
2019-11-13,9,3508,5380,2714,11113,10483,2131,59,23842,459,4386,661,5506,13,51,64
2019-11-13,10,3510,5305,2619,10812,10509,2055,55,23486,636,5409,974,7019,9,31,40
2019-11-13,11,3518,5230,2513,10528,10587,2008,53,23228,679,5617,1089,7385,5,35,40
2019-11-13,12,3526,5166,2432,10476,10753,2003,53,23329,675,5556,1109,7340,4,51,55
2019-11-13,13,3572,5154,2362,10504,10969,2037,53,23618,680,5415,1104,7199,5,82,87
2019-11-13,14,3649,5142,2315,10783,11287,2101,54,24274,660,5111,1049,6820,9,130,139
2019-11-13,15,3727,5173,2289,11151,11627,2192,56,25067,549,4233,876,5658,14,189,203
2019-11-13,16,3823,5287,2295,11566,11815,2311,56,25795,313,2290,500,3103,18,245,263
2019-11-13,17,4001,5576,2398,12081,12043,2476,58,26718,76,465,115,656,25,308,333
2019-11-13,18,4219,5699,2594,12654,12846,2740,62,28345,0,3,0,3,41,399,440
2019-11-13,19,4185,5645,2624,12676,12673,2719,61,28174,0,0,0,0,84,502,586
2019-11-13,20,4063,5510,2556,12328,12157,2631,59,27218,0,0,0,0,154,583,737
2019-11-13,21,3913,5294,2451,11872,11794,2501,55,26264,0,0,0,0,215,583,798
2019-11-13,22,3719,5002,2303,11321,11330,2350,52,25094,0,0,0,0,272,531,803
2019-11-13,23,3554,4750,2131,10542,10624,2145,48,23403,0,0,0,0,326,482,808
2019-11-13,24,3375,4587,1990,9867,9900,1978,45,21834,0,0,0,0,398,435,833
2019-11-14,1,3238,4490,1945,9378,9253,1885,45,20639,0,0,0,0,490,409,899
2019-11-14,2,3156,4459,1904,9035,8887,1815,45,19856,0,0,0,0,516,386,902
2019-11-14,3,3105,4478,1894,8832,8646,1760,45,19363,0,0,0,0,471,421,892
2019-11-14,4,3101,4576,1924,8793,8579,1740,46,19235,0,0,0,0,500,472,972
2019-11-14,5,3174,4810,2035,9044,8757,1787,50,19716,0,0,0,0,540,482,1022
2019-11-14,6,3326,5197,2306,9572,9374,1936,55,21018,0,0,0,0,490,433,923
2019-11-14,7,3476,5451,2652,10732,10205,2133,61,23209,0,273,1,274,454,353,807
2019-11-14,8,3504,5455,2825,11392,10639,2203,60,24359,201,1820,244,2265,408,265,673
2019-11-14,9,3527,5364,2731,11389,10599,2170,57,24254,604,3781,745,5130,336,171,507
2019-11-14,10,3546,5281,2652,11244,10595,2108,54,24037,833,4750,1100,6683,312,110,422
2019-11-14,11,3568,5192,2546,11195,10526,2054,53,23864,876,5010,1228,7114,326,108,434
2019-11-14,12,3582,5114,2470,11026,10607,2027,53,23749,849,5015,1250,7114,321,148,469
2019-11-14,13,3627,5090,2406,10979,10801,2029,54,23898,833,4961,1230,7024,314,216,530
2019-11-14,14,3689,5071,2349,11094,11120,2090,56,24395,804,4755,1125,6684,308,294,602
2019-11-14,15,3773,5088,2315,11264,11278,2153,57,24796,681,4001,913,5595,295,359,654
2019-11-14,16,3844,5195,2317,11541,11513,2265,58,25421,396,2177,521,3094,270,391,661
2019-11-14,17,4006,5471,2420,12034,11764,2427,60,26336,93,435,119,647,266,404,670
2019-11-14,18,4207,5582,2607,12754,12456,2680,62,28020,0,3,0,3,300,423,723
2019-11-14,19,4182,5533,2628,12645,12363,2668,61,27798,0,0,0,0,359,455,814
2019-11-14,20,4075,5408,2557,12311,12109,2592,59,27129,0,0,0,0,394,458,852
2019-11-14,21,3930,5198,2462,11951,11684,2467,56,26214,0,0,0,0,389,429,818
2019-11-14,22,3735,4920,2316,11368,11180,2319,52,24969,0,0,0,0,360,417,777
2019-11-14,23,3573,4672,2150,10637,10539,2120,48,23413,0,0,0,0,339,395,734
2019-11-14,24,3392,4520,2010,9935,9842,1961,45,21858,0,0,0,0,329,395,724
2019-11-15,1,3248,4469,1926,9384,9306,1881,45,20657,0,0,0,0,308,269,577
2019-11-15,2,3158,4436,1879,9010,8866,1801,45,19764,0,0,0,0,294,279,573
2019-11-15,3,3112,4447,1866,8818,8622,1747,45,19275,0,0,0,0,265,293,558
2019-11-15,4,3105,4529,1895,8755,8546,1730,46,19131,0,0,0,0,230,312,542
2019-11-15,5,3171,4733,1992,9034,8728,1777,50,19660,0,0,0,0,188,316,504
2019-11-15,6,3329,5081,2229,9604,9330,1920,56,20964,0,0,0,0,162,322,484
2019-11-15,7,3483,5329,2557,10655,10055,2126,61,22950,0,274,2,276,147,353,500
2019-11-15,8,3511,5363,2730,11349,10464,2200,61,24141,161,1896,201,2258,119,361,480
2019-11-15,9,3544,5302,2681,11273,10529,2170,59,24072,520,4056,616,5192,85,304,389
2019-11-15,10,3558,5232,2616,11053,10542,2110,55,23795,758,5126,904,6788,77,199,276
2019-11-15,11,3565,5149,2522,10812,10542,2039,54,23479,827,5338,1021,7186,84,149,233
2019-11-15,12,3576,5073,2452,10576,10566,1984,52,23208,829,5293,1072,7194,82,180,262
2019-11-15,13,3618,5054,2383,10496,10669,1987,52,23238,851,5171,1100,7122,72,238,310
2019-11-15,14,3674,5039,2329,10499,10900,2009,53,23495,898,4871,1102,6871,61,309,370
2019-11-15,15,3754,5052,2291,10512,11018,2069,54,23693,875,4044,989,5908,50,388,438
2019-11-15,16,3820,5138,2293,10778,11232,2174,54,24279,565,2159,608,3332,40,481,521
2019-11-15,17,3987,5398,2392,11266,11432,2313,55,25106,139,418,150,707,37,618,655
2019-11-15,18,4195,5458,2568,12139,12092,2562,60,26897,0,2,0,2,56,774,830
2019-11-15,19,4131,5371,2564,12084,12068,2563,59,26817,0,0,0,0,101,873,974
2019-11-15,20,4003,5227,2474,11664,11800,2483,58,26049,0,0,0,0,143,812,955
2019-11-15,21,3868,5057,2372,11352,11544,2382,55,25377,0,0,0,0,171,596,767
2019-11-15,22,3728,4853,2252,10926,11158,2274,52,24450,0,0,0,0,184,408,592
2019-11-15,23,3591,4647,2128,10338,10696,2110,50,23234,0,0,0,0,181,317,498
2019-11-15,24,3433,4485,2014,9741,9891,1959,47,21679,0,0,0,0,172,262,434
2019-11-16,1,3293,4459,1952,9184,9312,1856,45,20467,0,0,0,0,142,214,356
2019-11-16,2,3201,4409,1902,8843,8905,1780,44,19651,0,0,0,0,139,234,373
2019-11-16,3,3149,4411,1889,8600,8605,1724,45,19052,0,0,0,0,131,210,341
2019-11-16,4,3129,4447,1907,8468,8463,1697,46,18745,0,0,0,0,125,190,315
2019-11-16,5,3152,4550,1973,8507,8475,1715,49,18796,0,0,0,0,122,178,300
2019-11-16,6,3236,4705,2098,8687,8684,1777,53,19263,0,0,0,0,117,168,285
2019-11-16,7,3249,4820,2245,9107,8783,1837,59,19840,0,314,1,315,108,163,271
2019-11-16,8,3256,4913,2407,9313,8755,1847,57,20027,235,2313,308,2856,101,148,249
2019-11-16,9,3325,4947,2491,9319,8830,1823,55,20088,722,4902,906,6530,90,134,224
2019-11-16,10,3373,4935,2497,9046,8902,1784,52,19828,959,6004,1247,8210,81,139,220
2019-11-16,11,3408,4892,2426,8806,8934,1730,50,19558,964,6152,1344,8460,85,156,241
2019-11-16,12,3455,4857,2353,8551,9172,1687,49,19495,934,6140,1366,8440,87,173,260
2019-11-16,13,3502,4827,2261,8437,9504,1701,49,19726,943,6109,1365,8417,87,178,265
2019-11-16,14,3557,4807,2183,8514,9911,1734,50,20243,980,5997,1325,8302,84,167,251
2019-11-16,15,3629,4838,2153,8819,10347,1826,51,21081,941,5273,1159,7373,77,145,222
2019-11-16,16,3699,4974,2181,9327,10801,1989,51,22209,595,3021,704,4320,72,119,191
2019-11-16,17,3918,5310,2295,10020,11216,2206,55,23544,142,650,171,963,76,108,184
2019-11-16,18,4154,5436,2478,11104,11741,2493,58,25458,0,6,0,6,87,140,227
2019-11-16,19,4105,5394,2478,11290,11666,2520,58,25589,0,0,0,0,100,168,268
2019-11-16,20,3977,5282,2404,10989,11277,2438,56,24803,0,0,0,0,117,195,312
2019-11-16,21,3843,5134,2318,10686,10846,2327,54,23965,0,0,0,0,133,216,349
2019-11-16,22,3685,4948,2220,10292,10377,2215,52,22989,0,0,0,0,142,225,367
2019-11-16,23,3543,4755,2108,9745,9827,2064,49,21730,0,0,0,0,138,236,374
2019-11-16,24,3408,4587,1998,9317,9336,1929,47,20695,0,0,0,0,124,260,384
2019-11-17,1,3288,4491,1877,8933,8983,1865,45,19879,0,0,0,0,66,194,260
2019-11-17,2,3194,4439,1828,8644,8657,1777,45,19190,0,0,0,0,55,223,278
2019-11-17,3,3132,4437,1821,8403,8383,1724,46,18611,0,0,0,0,49,261,310
2019-11-17,4,3117,4468,1838,8315,8221,1701,47,18338,0,0,0,0,46,295,341
2019-11-17,5,3132,4547,1895,8313,8100,1701,50,18227,0,0,0,0,45,323,368
2019-11-17,6,3188,4666,1994,8478,8162,1740,53,18480,0,0,0,0,45,336,381
2019-11-17,7,3204,4764,2132,8726,8128,1773,58,18738,0,318,1,319,46,336,382
2019-11-17,8,3207,4850,2258,8796,8046,1774,58,18733,239,2358,313,2910,43,329,372
2019-11-17,9,3281,4828,2340,8739,8076,1739,57,18658,725,5007,921,6653,36,322,358
2019-11-17,10,3333,4792,2348,8464,8309,1677,53,18540,953,6119,1256,8328,27,322,349
2019-11-17,11,3375,4730,2268,8252,8617,1663,51,18619,955,6240,1351,8546,22,329,351
2019-11-17,12,3424,4726,2205,8092,9021,1699,50,18899,924,6213,1373,8510,20,338,358
2019-11-17,13,3459,4685,2177,8168,9519,1779,51,19553,931,6195,1364,8490,18,340,358
2019-11-17,14,3532,4700,2137,8398,10058,1898,52,20442,966,6090,1325,8381,17,319,336
2019-11-17,15,3581,4770,2120,8806,10639,2054,52,21590,928,5337,1166,7431,16,276,292
2019-11-17,16,3669,4949,2151,9387,11192,2237,52,22905,587,3021,700,4308,17,229,246
2019-11-17,17,3872,5305,2269,10184,11781,2464,55,24520,138,631,165,934,22,192,214
2019-11-17,18,4105,5428,2440,11248,12641,2789,59,26774,0,6,0,6,28,182,210
2019-11-17,19,4063,5387,2441,11549,12460,2797,59,26901,0,0,0,0,33,192,225
2019-11-17,20,3953,5280,2393,11328,11951,2685,58,26058,0,0,0,0,37,196,233
2019-11-17,21,3818,5112,2315,11007,11395,2524,55,25019,0,0,0,0,37,182,219
2019-11-17,22,3665,4878,2189,10500,10814,2344,52,23762,0,0,0,0,37,163,200
2019-11-17,23,3525,4659,2044,9816,10152,2122,49,22194,0,0,0,0,37,163,200
2019-11-17,24,3367,4525,1909,9200,9461,1944,46,20692,0,0,0,0,37,162,199
2019-11-18,1,3219,4428,1775,8784,9183,1864,44,19920,0,0,0,0,34,113,147
2019-11-18,2,3145,4406,1739,8507,8905,1798,45,19298,0,0,0,0,31,90,121
2019-11-18,3,3105,4430,1744,8346,8711,1747,46,18891,0,0,0,0,23,75,98
2019-11-18,4,3113,4538,1784,8382,8681,1727,48,18879,0,0,0,0,13,74,87
2019-11-18,5,3191,4780,1910,8674,8969,1781,53,19518,0,0,0,0,9,78,87
2019-11-18,6,3364,5181,2169,9365,9692,1929,59,21085,0,0,0,0,10,81,91
2019-11-18,7,3542,5451,2523,10520,10505,2110,66,23239,0,273,0,273,13,80,93
2019-11-18,8,3575,5476,2706,11069,10706,2183,66,24066,238,2148,309,2695,16,80,96
2019-11-18,9,3596,5426,2653,10762,10564,2193,63,23619,727,4647,920,6294,15,79,94
2019-11-18,10,3607,5374,2587,10446,10725,2169,59,23436,956,5734,1258,7948,13,81,94
2019-11-18,11,3611,5308,2502,10210,10965,2163,57,23432,956,5904,1353,8213,15,86,101
2019-11-18,12,3625,5252,2444,10084,11270,2196,56,23642,925,5896,1376,8197,19,87,106
2019-11-18,13,3672,5240,2407,10096,11677,2263,56,24129,934,5779,1366,8079,28,81,109
2019-11-18,14,3727,5228,2375,10318,12202,2372,57,24988,972,5518,1325,7815,33,65,98
2019-11-18,15,3792,5248,2346,10690,12682,2499,58,25970,939,4705,1162,6806,33,52,85
2019-11-18,16,3876,5358,2353,11155,13120,2614,58,26989,594,2559,690,3843,34,50,84
2019-11-18,17,4066,5660,2455,11802,13399,2756,61,28057,139,493,159,791,47,54,101
2019-11-18,18,4279,5743,2615,12694,14165,2998,65,29960,0,2,0,2,79,69,148
2019-11-18,19,4247,5671,2616,12725,13745,2950,64,29522,0,0,0,0,133,92,225
2019-11-18,20,4120,5537,2532,12360,13081,2812,62,28354,0,0,0,0,206,106,312
2019-11-18,21,3950,5324,2432,11843,12477,2641,59,27064,0,0,0,0,281,110,391
2019-11-18,22,3764,5022,2281,11205,11962,2443,55,25712,0,0,0,0,346,130,476
2019-11-18,23,3602,4753,2116,10382,11197,2207,51,23896,0,0,0,0,396,148,544
2019-11-18,24,3416,4581,1976,9682,10534,2016,48,22331,0,0,0,0,446,173,619
2019-11-19,1,3247,4512,1907,9147,9790,1919,46,20959,0,0,0,0,471,249,720
2019-11-19,2,3164,4467,1864,8812,9385,1838,46,20138,0,0,0,0,570,312,882
2019-11-19,3,3119,4477,1850,8616,9128,1778,47,19629,0,0,0,0,671,372,1043
2019-11-19,4,3120,4561,1872,8587,8994,1760,48,19440,0,0,0,0,726,397,1123
2019-11-19,5,3186,4790,1974,8854,9217,1801,52,19979,0,0,0,0,716,418,1134
2019-11-19,6,3343,5171,2221,9487,9963,1948,58,21518,0,0,0,0,675,441,1116
2019-11-19,7,3511,5441,2564,10606,10775,2149,65,23654,0,180,0,180,646,445,1091
2019-11-19,8,3549,5461,2753,11260,11062,2236,64,24671,177,1405,220,1802,616,446,1062
2019-11-19,9,3564,5399,2692,11276,11112,2266,61,24745,569,3222,698,4489,550,443,993
2019-11-19,10,3582,5348,2633,10918,11191,2235,56,24437,807,4177,1013,5997,509,453,962
2019-11-19,11,3605,5294,2553,10694,11366,2271,55,24422,852,4298,1122,6272,452,533,985
2019-11-19,12,3646,5248,2521,10504,11522,2315,56,24424,836,4256,1145,6237,374,680,1054
2019-11-19,13,3723,5253,2488,10421,11767,2350,57,24625,846,4024,1141,6011,348,846,1194
2019-11-19,14,3793,5253,2449,10576,12122,2428,59,25221,867,3559,1089,5515,339,987,1326
2019-11-19,15,3881,5287,2419,10830,12394,2507,59,25821,800,2850,942,4592,339,1108,1447
2019-11-19,16,3950,5409,2435,11180,12648,2571,61,26497,484,1500,567,2551,350,1179,1529
2019-11-19,17,4125,5703,2566,11840,12983,2627,63,27554,109,282,135,526,363,1188,1551
2019-11-19,18,4345,5776,2741,12785,13747,2784,65,29427,0,0,0,0,397,1161,1558
2019-11-19,19,4313,5693,2739,12756,13436,2758,64,29063,0,0,0,0,435,1093,1528
2019-11-19,20,4213,5562,2662,12415,12964,2643,62,28134,0,0,0,0,422,1036,1458
2019-11-19,21,4054,5346,2549,11957,12404,2513,59,26986,0,0,0,0,384,1066,1450
2019-11-19,22,3863,5053,2394,11284,11814,2355,55,25561,0,0,0,0,371,1162,1533
2019-11-19,23,3613,4794,2217,10410,10975,2152,50,23645,0,0,0,0,369,1241,1610
2019-11-19,24,3423,4626,2078,9713,10191,1984,48,21995,0,0,0,0,366,1272,1638
2019-11-20,1,3276,4553,2022,9473,9598,1981,51,21160,0,0,0,0,290,1210,1500
2019-11-20,2,3186,4512,1986,9134,9225,1904,51,20372,0,0,0,0,314,1186,1500
2019-11-20,3,3129,4518,1975,8941,8980,1850,52,19885,0,0,0,0,349,1208,1557
2019-11-20,4,3119,4600,2004,8897,8910,1819,53,19742,0,0,0,0,370,1226,1596
2019-11-20,5,3176,4824,2119,9164,9080,1859,56,20217,0,0,0,0,408,1221,1629
2019-11-20,6,3321,5197,2376,9854,9761,2003,62,21733,0,0,0,0,508,1210,1718
2019-11-20,7,3487,5465,2730,10955,10646,2201,68,23916,0,150,0,150,679,1174,1853
2019-11-20,8,3529,5481,2931,11618,11155,2295,68,25185,164,1124,150,1438,814,1124,1938
2019-11-20,9,3561,5432,2863,11349,11397,2360,67,25215,535,2635,531,3701,882,1131,2013
2019-11-20,10,3595,5395,2784,10965,11487,2381,66,24935,734,3531,791,5056,921,1182,2103
2019-11-20,11,3634,5372,2693,10694,11400,2370,64,24567,737,3650,844,5231,963,1248,2211
2019-11-20,12,3656,5345,2638,10499,11392,2349,62,24339,714,3631,847,5192,982,1298,2280
2019-11-20,13,3679,5354,2592,10392,11374,2351,60,24207,710,3558,814,5082,984,1331,2315
2019-11-20,14,3728,5346,2547,10506,11399,2380,59,24373,699,3285,727,4711,973,1346,2319
2019-11-20,15,3794,5376,2513,10802,11337,2400,59,24633,614,2717,596,3927,951,1406,2357
2019-11-20,16,3888,5493,2540,11268,11455,2449,60,25276,352,1449,338,2139,908,1424,2332
2019-11-20,17,4078,5800,2670,11852,11854,2642,64,26478,76,275,77,428,889,1344,2233
2019-11-20,18,4270,5861,2859,12828,12516,2896,69,28371,0,0,0,0,875,1224,2099
2019-11-20,19,4259,5770,2871,12814,12410,2885,69,28238,0,0,0,0,884,1069,1953
2019-11-20,20,4197,5638,2792,12516,12194,2793,68,27620,0,0,0,0,872,945,1817
2019-11-20,21,4080,5419,2694,12113,11814,2639,66,26684,0,0,0,0,795,835,1630
2019-11-20,22,3900,5123,2539,11482,11331,2467,64,25394,0,0,0,0,617,762,1379
2019-11-20,23,3706,4864,2362,10663,10597,2242,61,23616,0,0,0,0,455,706,1161
2019-11-20,24,3518,4708,2219,9955,9896,2054,58,22019,0,0,0,0,386,658,1044
2019-11-21,1,3378,4638,2135,9254,9999,1894,55,21262,0,0,0,0,268,453,721
2019-11-21,2,3305,4609,2104,8949,9617,1826,54,20506,0,0,0,0,195,398,593
2019-11-21,3,3265,4625,2103,8754,9381,1773,56,20020,0,0,0,0,139,377,516
2019-11-21,4,3274,4713,2144,8719,9269,1752,58,19847,0,0,0,0,114,361,475
2019-11-21,5,3353,4943,2269,9007,9529,1801,62,20449,0,0,0,0,103,339,442
2019-11-21,6,3516,5326,2544,9663,10234,1951,68,21973,0,0,0,0,107,310,417
2019-11-21,7,3690,5593,2919,10858,11146,2162,75,24298,0,147,0,147,104,284,388
2019-11-21,8,3731,5606,3123,11481,11585,2242,77,25442,192,1190,226,1608,84,262,346
2019-11-21,9,3734,5541,3034,11244,11647,2230,71,25259,646,2718,757,4121,60,246,306
2019-11-21,10,3721,5478,2928,10821,11630,2159,66,24747,924,3527,1130,5581,42,242,284
2019-11-21,11,3711,5416,2810,10485,11601,2101,62,24307,952,3646,1253,5851,31,229,260
2019-11-21,12,3681,5353,2711,10223,11561,2087,59,23986,919,3669,1271,5859,17,213,230
2019-11-21,13,3671,5341,2636,10153,11538,2099,56,23904,922,3640,1223,5785,8,206,214
2019-11-21,14,3682,5319,2571,10296,11574,2187,55,24169,938,3389,1091,5418,6,200,206
2019-11-21,15,3706,5330,2522,10576,11732,2261,54,24679,857,2782,891,4530,6,195,201
2019-11-21,16,3771,5451,2518,10939,11857,2321,55,25228,500,1465,513,2478,9,189,198
2019-11-21,17,4000,5763,2660,11598,12284,2408,58,26404,103,272,117,492,17,179,196
2019-11-21,18,4225,5830,2858,12629,13169,2656,64,28575,0,0,0,0,25,163,188
2019-11-21,19,4223,5757,2890,12633,13152,2694,66,28603,0,0,0,0,30,148,178
2019-11-21,20,4171,5647,2830,12308,12863,2630,64,27922,0,0,0,0,42,128,170
2019-11-21,21,4077,5437,2744,11890,12471,2510,63,26992,0,0,0,0,53,111,164
2019-11-21,22,3921,5159,2597,11274,11936,2366,61,25696,0,0,0,0,58,100,158
2019-11-21,23,3739,4911,2424,10487,11120,2163,59,23889,0,0,0,0,61,84,145
2019-11-21,24,3572,4763,2285,9798,10354,1992,57,22260,0,0,0,0,64,73,137
2019-11-22,1,3510,4747,2208,9381,9581,1880,61,20957,0,0,0,0,58,38,96
2019-11-22,2,3440,4717,2177,9060,9242,1807,61,20225,0,0,0,0,48,31,79
2019-11-22,3,3404,4727,2179,8858,9028,1760,62,19762,0,0,0,0,41,37,78
2019-11-22,4,3413,4817,2228,8840,8980,1751,64,19689,0,0,0,0,36,49,85
2019-11-22,5,3491,5036,2349,9137,9233,1800,69,20294,0,0,0,0,30,66,96
2019-11-22,6,3651,5376,2611,9775,9911,1956,76,21774,0,0,0,0,37,79,116
2019-11-22,7,3820,5638,2968,10917,10807,2188,82,24050,0,161,0,161,51,85,136
2019-11-22,8,3844,5662,3158,11490,11147,2238,83,25013,203,1537,227,1967,50,90,140
2019-11-22,9,3826,5610,3062,11402,11202,2163,75,24898,668,3628,764,5060,37,86,123
2019-11-22,10,3792,5541,2944,11044,11144,2065,68,24378,934,4786,1127,6847,24,117,141
2019-11-22,11,3751,5461,2808,10716,10965,1990,64,23792,947,5017,1227,7191,21,143,164
2019-11-22,12,3710,5382,2692,10438,10813,1963,61,23329,908,4967,1234,7109,20,157,177
2019-11-22,13,3684,5356,2598,10269,10765,1958,58,23106,906,4876,1218,7000,15,162,177
2019-11-22,14,3680,5334,2521,10324,10879,1986,57,23303,921,4617,1144,6682,12,160,172
2019-11-22,15,3702,5345,2457,10498,11007,2042,56,23660,858,3892,961,5711,12,150,162
2019-11-22,16,3769,5440,2463,10793,11213,2134,57,24256,520,2087,553,3160,13,131,144
2019-11-22,17,3992,5751,2598,11371,11647,2283,61,25417,113,378,123,614,14,116,130
2019-11-22,18,4234,5809,2783,12385,12629,2585,65,27720,0,0,0,0,14,116,130
2019-11-22,19,4225,5704,2793,12346,12514,2608,65,27590,0,0,0,0,20,133,153
2019-11-22,20,4170,5568,2719,11998,12187,2536,64,26842,0,0,0,0,32,149,181
2019-11-22,21,4088,5396,2631,11603,11747,2438,66,25910,0,0,0,0,41,156,197
2019-11-22,22,3969,5187,2506,11128,11371,2330,64,24950,0,0,0,0,51,158,209
2019-11-22,23,3807,4980,2372,10467,10781,2163,63,23530,0,0,0,0,63,154,217
2019-11-22,24,3660,4822,2240,9825,10137,1999,61,22078,0,0,0,0,71,152,223
2019-11-23,1,3517,4757,2176,9213,9415,1874,58,20600,0,0,0,0,43,161,204
2019-11-23,2,3443,4712,2133,8861,9049,1802,58,19809,0,0,0,0,41,182,223
2019-11-23,3,3397,4711,2125,8628,8800,1749,59,19276,0,0,0,0,36,210,246
2019-11-23,4,3389,4750,2153,8547,8698,1722,62,19069,0,0,0,0,31,239,270
2019-11-23,5,3418,4852,2226,8596,8730,1745,65,19177,0,0,0,0,28,266,294
2019-11-23,6,3496,5011,2349,8908,9020,1807,70,19844,0,0,0,0,26,285,311
2019-11-23,7,3537,5146,2506,9361,9329,1881,75,20703,0,144,0,144,26,303,329
2019-11-23,8,3518,5254,2673,9606,9317,1888,76,20942,205,1667,253,2125,25,324,349
2019-11-23,9,3545,5281,2751,9556,9357,1874,70,20912,674,3988,827,5489,24,351,375
2019-11-23,10,3554,5264,2730,9281,9261,1833,64,20496,936,5174,1189,7299,21,425,446
2019-11-23,11,3544,5214,2631,8915,9173,1768,60,19971,945,5446,1301,7692,23,518,541
2019-11-23,12,3524,5146,2531,8667,9091,1693,57,19562,910,5474,1330,7714,27,571,598
2019-11-23,13,3500,5096,2418,8591,9121,1674,55,19496,919,5425,1323,7667,29,603,632
2019-11-23,14,3497,5068,2319,8646,9301,1671,55,19728,959,5258,1284,7501,27,613,640
2019-11-23,15,3516,5087,2252,8968,9549,1724,54,20351,927,4518,1130,6575,23,586,609
2019-11-23,16,3578,5223,2294,9477,9886,1875,55,21350,580,2449,666,3695,20,498,518
2019-11-23,17,3837,5590,2438,10199,10458,2080,60,22853,129,458,151,738,22,393,415
2019-11-23,18,4091,5697,2633,11417,11552,2383,65,25467,0,0,0,0,29,339,368
2019-11-23,19,4079,5638,2631,11489,11583,2452,65,25627,0,0,0,0,34,315,349
2019-11-23,20,4022,5536,2557,11282,11279,2413,64,25075,0,0,0,0,37,289,326
2019-11-23,21,3956,5386,2479,10973,10929,2317,65,24321,0,0,0,0,41,249,290
2019-11-23,22,3854,5191,2383,10548,10635,2226,63,23512,0,0,0,0,47,217,264
2019-11-23,23,3713,4994,2268,9994,10161,2084,61,22340,0,0,0,0,52,192,244
2019-11-23,24,3582,4826,2154,9502,9623,1950,59,21175,0,0,0,0,57,166,223
2019-11-24,1,3426,4732,2118,9236,9135,1863,57,20328,0,0,0,0,62,106,168
2019-11-24,2,3352,4679,2073,8920,8784,1782,57,19581,0,0,0,0,53,89,142
2019-11-24,3,3311,4671,2066,8693,8538,1731,59,19059,0,0,0,0,33,83,116
2019-11-24,4,3310,4702,2088,8637,8407,1702,61,18846,0,0,0,0,19,82,101
2019-11-24,5,3340,4774,2154,8684,8439,1711,64,18937,0,0,0,0,14,79,93
2019-11-24,6,3410,4886,2255,8918,8551,1761,69,19337,0,0,0,0,11,73,84
2019-11-24,7,3445,5003,2378,9341,8643,1826,77,19924,0,167,0,167,11,63,74
2019-11-24,8,3435,5095,2532,9434,8606,1822,75,19973,206,1905,253,2364,12,56,68
2019-11-24,9,3461,5074,2624,9340,8598,1769,69,19813,678,4502,828,6008,11,48,59
2019-11-24,10,3474,5038,2632,9022,8534,1689,64,19345,939,5706,1189,7834,9,39,48
2019-11-24,11,3467,4977,2555,8617,8500,1604,59,18812,947,5896,1304,8147,8,30,38
2019-11-24,12,3447,4971,2495,8394,8517,1565,56,18566,912,5899,1333,8144,9,23,32
2019-11-24,13,3422,4933,2439,8378,8578,1579,54,18626,918,5892,1321,8131,11,21,32
2019-11-24,14,3426,4952,2368,8499,8765,1624,52,18975,952,5782,1280,8014,9,21,30
2019-11-24,15,3452,5023,2337,8807,8901,1721,51,19516,905,5045,1125,7075,5,33,38
2019-11-24,16,3523,5203,2382,9464,9330,1875,51,20755,561,2794,657,4012,5,71,76
2019-11-24,17,3767,5583,2533,10348,9921,2100,56,22459,127,540,144,811,7,154,161
2019-11-24,18,4037,5676,2742,11720,11075,2439,62,25331,0,0,0,0,11,298,309
2019-11-24,19,4046,5619,2756,11914,11197,2505,61,25714,0,0,0,0,26,419,445
2019-11-24,20,4013,5520,2700,11678,10987,2460,61,25222,0,0,0,0,45,451,496
2019-11-24,21,3928,5359,2617,11340,10707,2341,60,24484,0,0,0,0,56,476,532
2019-11-24,22,3799,5135,2478,10863,10360,2214,59,23534,0,0,0,0,67,542,609
2019-11-24,23,3643,4913,2320,10134,9829,2038,57,22094,0,0,0,0,77,694,771
2019-11-24,24,3505,4779,2184,9508,9259,1895,55,20756,0,0,0,0,85,927,1012
2019-11-25,1,3411,4708,2119,9165,9001,1838,55,20098,0,0,0,0,101,1276,1377
2019-11-25,2,3348,4692,2088,8901,8736,1780,56,19512,0,0,0,0,115,1476,1591
2019-11-25,3,3321,4713,2095,8741,8589,1742,58,19169,0,0,0,0,122,1539,1661
2019-11-25,4,3338,4815,2142,8775,8592,1728,61,19195,0,0,0,0,114,1599,1713
2019-11-25,5,3418,5053,2274,9120,8922,1787,67,19934,0,0,0,0,104,1682,1786
2019-11-25,6,3597,5434,2539,9858,9604,1943,74,21517,0,0,0,0,118,1778,1896
2019-11-25,7,3787,5730,2895,11055,10530,2158,84,23866,0,128,0,128,210,1934,2144
2019-11-25,8,3829,5773,3115,11760,10906,2226,81,25010,200,1696,249,2145,334,2033,2367
2019-11-25,9,3827,5751,3047,11656,11012,2172,74,24949,671,4155,830,5656,379,2090,2469
2019-11-25,10,3809,5724,2979,11311,10957,2096,67,24466,937,5375,1208,7520,394,2244,2638
2019-11-25,11,3789,5700,2899,10943,10899,2027,63,23967,944,5608,1321,7873,545,2435,2980
2019-11-25,12,3765,5684,2836,10698,10864,1978,59,23635,914,5611,1351,7876,811,2560,3371
2019-11-25,13,3753,5698,2788,10607,10910,1986,57,23597,932,5595,1357,7884,964,2615,3579
2019-11-25,14,3762,5691,2732,10736,11044,2014,55,23884,980,5479,1319,7778,972,2660,3632
2019-11-25,15,3786,5724,2702,11008,11117,2080,55,24295,949,4772,1159,6880,942,2671,3613
2019-11-25,16,3831,5855,2734,11419,11301,2165,56,24976,597,2622,683,3902,848,2592,3440
2019-11-25,17,4064,6193,2880,12114,11703,2328,60,26240,136,496,156,788,714,2490,3204
2019-11-25,18,4323,6236,3069,13161,12669,2668,66,28599,0,0,0,0,633,2431,3064
2019-11-25,19,4341,6133,3069,13219,12669,2707,65,28696,0,0,0,0,595,2407,3002
2019-11-25,20,4304,6000,2981,12886,12433,2642,64,28062,0,0,0,0,591,2543,3134
2019-11-25,21,4197,5776,2867,12490,12036,2505,63,27133,0,0,0,0,649,2491,3140
2019-11-25,22,4032,5470,2701,11842,11476,2346,61,25770,0,0,0,0,739,2324,3063
2019-11-25,23,3837,5194,2506,10956,10719,2137,59,23911,0,0,0,0,815,2051,2866
2019-11-25,24,3665,5033,2357,10250,10017,1969,58,22338,0,0,0,0,846,1760,2606
2019-11-26,1,3592,4986,2355,9806,9439,1903,63,21255,0,0,0,0,742,1702,2444
2019-11-26,2,3529,4953,2329,9522,9117,1832,65,20576,0,0,0,0,729,1371,2100
2019-11-26,3,3492,4961,2328,9335,8922,1784,67,20149,0,0,0,0,705,1039,1744
2019-11-26,4,3502,5058,2366,9338,8875,1774,70,20097,0,0,0,0,648,823,1471
2019-11-26,5,3578,5293,2489,9635,9097,1829,75,20675,0,0,0,0,612,709,1321
2019-11-26,6,3754,5679,2763,10370,9822,1991,84,22305,0,0,0,0,550,615,1165
2019-11-26,7,3940,5965,3131,11637,10808,2225,94,24801,0,149,0,149,423,459,882
2019-11-26,8,3955,5976,3343,12318,11102,2282,91,25835,171,1800,221,2192,271,302,573
2019-11-26,9,3927,5917,3259,12154,11003,2167,82,25441,567,4309,762,5638,133,232,365
2019-11-26,10,3901,5856,3164,11925,10823,2042,74,24900,819,5521,1155,7495,66,228,294
2019-11-26,11,3880,5800,3060,11644,10665,1953,68,24366,855,5732,1287,7874,53,222,275
2019-11-26,12,3847,5750,2990,11446,10557,1905,64,24008,811,5727,1307,7845,65,186,251
2019-11-26,13,3825,5747,2937,11413,10555,1905,59,23969,755,5691,1302,7748,104,141,245
2019-11-26,14,3822,5734,2887,11440,10600,1969,58,24103,643,5492,1246,7381,174,115,289
2019-11-26,15,3837,5768,2845,11545,10726,2035,57,24400,470,4737,1033,6240,238,116,354
2019-11-26,16,3915,5913,2876,11776,10934,2136,58,24940,233,2596,554,3383,309,133,442
2019-11-26,17,4168,6266,3030,12427,11433,2319,63,26281,41,484,108,633,456,155,611
2019-11-26,18,4428,6327,3218,13529,12505,2653,73,28795,0,1,0,1,722,182,904
2019-11-26,19,4442,6232,3205,13591,12581,2703,75,28990,0,0,0,0,976,210,1186
2019-11-26,20,4399,6112,3107,13289,12419,2654,75,28483,0,0,0,0,932,263,1195
2019-11-26,21,4303,5895,2994,12858,12067,2537,74,27584,0,0,0,0,756,399,1155
2019-11-26,22,4141,5593,2826,12187,11557,2379,70,26242,0,0,0,0,720,556,1276
2019-11-26,23,3922,5325,2634,11285,10844,2184,67,24420,0,0,0,0,747,741,1488
2019-11-26,24,3751,5151,2475,10534,10146,2006,66,22795,0,0,0,0,752,984,1736
2019-11-27,1,3635,5037,2425,9967,9641,1909,68,21622,0,0,0,0,440,1146,1586
2019-11-27,2,3566,5008,2388,9623,9310,1838,69,20877,0,0,0,0,470,1277,1747
2019-11-27,3,3535,5005,2381,9419,9100,1804,71,20430,0,0,0,0,538,1400,1938
2019-11-27,4,3550,5086,2416,9403,9045,1772,73,20329,0,0,0,0,563,1439,2002
2019-11-27,5,3623,5310,2533,9663,9315,1820,80,20913,0,0,0,0,500,1335,1835
2019-11-27,6,3790,5689,2791,10344,10003,1973,84,22440,0,0,0,0,421,1064,1485
2019-11-27,7,3971,5970,3141,11477,10844,2187,91,24634,0,81,0,81,383,842,1225
2019-11-27,8,3979,5985,3332,12174,11324,2316,90,25939,93,796,109,998,353,779,1132
2019-11-27,9,3939,5930,3278,12095,11562,2270,85,26053,332,2051,416,2799,331,717,1048
2019-11-27,10,3894,5853,3198,11947,11580,2259,78,25906,473,2983,676,4132,317,676,993
2019-11-27,11,3856,5774,3111,11837,11553,2231,73,25733,482,3434,778,4694,289,726,1015
2019-11-27,12,3820,5710,3050,11764,11454,2245,68,25570,473,3694,799,4966,263,822,1085
2019-11-27,13,3802,5702,3009,11695,11459,2279,63,25537,471,3739,790,5000,253,931,1184
2019-11-27,14,3802,5696,2973,11724,11492,2328,59,25645,463,3505,740,4708,232,1009,1241
2019-11-27,15,3818,5735,2962,11751,11462,2379,60,25692,398,2875,630,3903,194,1016,1210
2019-11-27,16,3901,5873,3001,11864,11670,2407,60,26037,219,1481,368,2068,168,1025,1193
2019-11-27,17,4175,6237,3150,12426,11984,2466,65,26980,45,255,82,382,144,972,1116
2019-11-27,18,4451,6291,3346,13484,12789,2641,75,29025,0,0,0,0,113,889,1002
2019-11-27,19,4470,6194,3327,13536,12809,2691,75,29147,0,0,0,0,88,816,904
2019-11-27,20,4438,6070,3223,13274,12642,2634,74,28660,0,0,0,0,70,784,854
2019-11-27,21,4341,5869,3109,12930,12281,2507,74,27828,0,0,0,0,54,764,818
2019-11-27,22,4179,5568,2938,12323,11781,2359,72,26572,0,0,0,0,42,746,788
2019-11-27,23,3961,5294,2745,11405,11050,2158,69,24718,0,0,0,0,31,736,767
2019-11-27,24,3794,5114,2580,10668,10343,1999,68,23114,0,0,0,0,22,733,755
2019-11-28,1,3716,4920,2482,10025,10004,1988,71,22123,0,0,0,0,19,794,813
2019-11-28,2,3627,4843,2429,9617,9548,1892,71,21163,0,0,0,0,12,748,760
2019-11-28,3,3570,4820,2410,9353,9283,1851,72,20593,0,0,0,0,9,671,680
2019-11-28,4,3560,4850,2435,9233,9093,1823,74,20259,0,0,0,0,12,574,586
2019-11-28,5,3583,4920,2508,9290,9085,1806,78,20293,0,0,0,0,14,515,529
2019-11-28,6,3658,5045,2622,9589,9278,1866,83,20853,0,0,0,0,15,468,483
2019-11-28,7,3700,5181,2782,10010,9459,1928,90,21523,0,63,0,63,18,405,423
2019-11-28,8,3694,5344,2988,10266,9552,2051,92,21994,75,714,73,862,21,361,382
2019-11-28,9,3724,5441,3139,10268,9578,2125,89,22096,293,1860,295,2448,30,366,396
2019-11-28,10,3757,5493,3163,10227,9708,2199,84,22252,472,2540,531,3543,47,409,456
2019-11-28,11,3785,5514,3145,10172,9794,2224,79,22302,535,2525,669,3729,71,449,520
2019-11-28,12,3796,5448,3080,10150,9861,2215,75,22335,547,2323,706,3576,99,481,580
2019-11-28,13,3784,5283,2942,10062,10046,2242,70,22455,519,1896,668,3083,137,534,671
2019-11-28,14,3759,5138,2790,10059,10177,2281,65,22618,446,1297,573,2316,174,590,764
2019-11-28,15,3735,5064,2657,10129,10259,2313,66,22800,330,864,444,1638,195,571,766
2019-11-28,16,3767,5113,2618,10428,10446,2349,67,23324,161,381,233,775,203,560,763
2019-11-28,17,3956,5354,2687,10897,10717,2474,72,24195,29,40,47,116,196,581,777
2019-11-28,18,4148,5430,2793,11471,11472,2502,80,25559,0,0,0,0,175,564,739
2019-11-28,19,4112,5423,2765,11294,11283,2486,78,25176,0,0,0,0,147,549,696
2019-11-28,20,4072,5378,2740,11124,11154,2419,78,24811,0,0,0,0,128,556,684
2019-11-28,21,4015,5333,2723,11044,10989,2330,77,24474,0,0,0,0,119,587,706
2019-11-28,22,3957,5215,2674,10850,10761,2276,77,23999,0,0,0,0,119,650,769
2019-11-28,23,3841,5048,2592,10479,10417,2160,74,23165,0,0,0,0,134,764,898
2019-11-28,24,3729,4930,2489,10038,9925,2031,75,22103,0,0,0,0,153,881,1034
2019-11-29,1,3684,4806,2435,9412,9293,1989,86,20815,0,0,0,0,178,1005,1183
2019-11-29,2,3620,4762,2444,9117,8979,1925,87,20144,0,0,0,0,193,1174,1367
2019-11-29,3,3587,4755,2466,8963,8781,1872,89,19741,0,0,0,0,215,1356,1571
2019-11-29,4,3590,4823,2532,8914,8709,1850,92,19601,0,0,0,0,253,1555,1808
2019-11-29,5,3639,4942,2645,9095,8847,1883,95,19956,0,0,0,0,295,1685,1980
2019-11-29,6,3727,5086,2816,9449,9215,1981,98,20779,0,0,0,0,306,1758,2064
2019-11-29,7,3790,5203,3000,9969,9586,2084,101,21774,0,88,0,88,287,1847,2134
2019-11-29,8,3767,5288,3190,10183,9684,2087,102,22090,166,1326,168,1660,249,1980,2229
2019-11-29,9,3767,5317,3215,10253,9733,2057,96,22174,598,3455,626,4679,190,2094,2284
2019-11-29,10,3776,5300,3162,10089,9870,2016,94,22103,873,4683,1009,6565,150,2173,2323
2019-11-29,11,3772,5285,3043,9792,9801,1998,86,21711,871,4974,1132,6977,155,2263,2418
2019-11-29,12,3742,5248,2895,9595,9695,1965,80,21368,818,5001,1132,6951,158,2312,2470
2019-11-29,13,3708,5227,2765,9565,9727,1977,76,21379,802,4952,1087,6841,149,2285,2434
2019-11-29,14,3690,5251,2666,9611,9780,2011,72,21509,769,4745,973,6487,142,2183,2325
2019-11-29,15,3707,5287,2625,9811,9904,2092,69,21911,674,4018,803,5495,134,2052,2186
2019-11-29,16,3809,5457,2656,10249,10186,2220,73,22762,380,2144,460,2984,127,1874,2001
2019-11-29,17,4101,5830,2849,11134,10757,2439,82,24446,73,401,100,574,113,1678,1791
2019-11-29,18,4401,5913,3031,12186,11912,2765,93,26990,0,1,0,1,91,1552,1643
2019-11-29,19,4416,5853,3037,12099,11981,2724,95,26934,0,0,0,0,83,1433,1516
2019-11-29,20,4375,5750,3011,11849,11826,2644,94,26448,0,0,0,0,77,1335,1412
2019-11-29,21,4312,5624,2974,11634,11621,2573,93,25957,0,0,0,0,69,1283,1352
2019-11-29,22,4197,5429,2881,11305,11301,2488,92,25221,0,0,0,0,75,1248,1323
2019-11-29,23,4021,5222,2756,10751,10808,2335,88,24016,0,0,0,0,90,1223,1313
2019-11-29,24,3876,5053,2625,10165,10250,2160,85,22695,0,0,0,0,97,1182,1279
2019-11-30,1,3783,4843,2551,10029,10209,1953,78,22306,0,0,0,0,48,982,1030
2019-11-30,2,3713,4787,2549,9680,9844,1875,79,21516,0,0,0,0,51,892,943
2019-11-30,3,3678,4789,2564,9483,9648,1823,80,21071,0,0,0,0,60,754,814
2019-11-30,4,3682,4831,2610,9366,9552,1806,83,20847,0,0,0,0,57,586,643
2019-11-30,5,3727,4933,2686,9458,9644,1844,87,21070,0,0,0,0,55,365,420
2019-11-30,6,3805,5078,2823,9766,9926,1904,93,21725,0,0,0,0,73,169,242
2019-11-30,7,3874,5212,2984,10255,10242,1997,99,22628,0,88,0,88,110,75,185
2019-11-30,8,3877,5326,3175,10678,10328,2030,100,23169,40,1168,69,1277,144,50,194
2019-11-30,9,3882,5378,3249,10958,10296,1985,92,23360,172,2966,275,3413,154,46,200
2019-11-30,10,3863,5366,3202,10987,10145,1915,84,23163,248,4052,433,4733,179,60,239
2019-11-30,11,3839,5322,3072,10992,10012,1859,78,22970,250,4371,484,5105,218,79,297
2019-11-30,12,3800,5267,2934,10881,9917,1796,72,22701,273,4365,499,5137,265,89,354
2019-11-30,13,3754,5224,2795,10781,9848,1782,66,22512,251,4128,422,4801,330,93,423
2019-11-30,14,3704,5199,2675,10679,9746,1765,64,22289,182,3512,297,3991,435,94,529
2019-11-30,15,3699,5215,2607,10659,9814,1844,62,22416,118,2537,199,2854,586,98,684
2019-11-30,16,3778,5355,2646,10803,10128,1983,61,23013,49,1153,86,1288,703,104,807
2019-11-30,17,4065,5723,2809,11344,10703,2219,70,24373,6,162,11,179,791,112,903
2019-11-30,18,4347,5776,2990,12390,11774,2439,79,26716,0,0,0,0,827,128,955
2019-11-30,19,4341,5708,2985,12326,12000,2533,80,26976,0,0,0,0,781,159,940
2019-11-30,20,4299,5646,2917,11971,11818,2504,80,26409,0,0,0,0,761,192,953
2019-11-30,21,4247,5531,2838,11599,11557,2425,80,25697,0,0,0,0,772,200,972
2019-11-30,22,4153,5339,2738,11142,11273,2336,78,24866,0,0,0,0,762,203,965
2019-11-30,23,3981,5134,2609,10492,10809,2182,76,23596,0,0,0,0,746,200,946
2019-11-30,24,3842,4972,2489,9956,10252,2036,75,22355,0,0,0,0,743,177,920
2019-12-01,1,3670,4929,2375,9486,9549,1997,76,21146,0,0,0,0,980,116,1096
2019-12-01,2,3593,4900,2334,9116,9205,1918,76,20352,0,0,0,0,949,100,1049
2019-12-01,3,3556,4913,2336,8888,8969,1871,77,19842,0,0,0,0,917,90,1007
2019-12-01,4,3555,4967,2365,8771,8871,1846,79,19603,0,0,0,0,872,85,957
2019-12-01,5,3590,5043,2425,8765,8889,1852,83,19625,0,0,0,0,832,86,918
2019-12-01,6,3653,5182,2545,8979,9127,1900,90,20131,0,0,0,0,794,90,884
2019-12-01,7,3710,5323,2706,9387,9325,1975,94,20815,0,77,0,77,752,93,845
2019-12-01,8,3692,5400,2875,9748,9323,1975,95,21177,12,974,47,1033,694,96,790
2019-12-01,9,3667,5338,2963,9994,9169,1903,89,21192,78,2548,202,2828,632,96,728
2019-12-01,10,3647,5250,2956,10123,8946,1780,82,20969,144,3596,389,4129,603,92,695
2019-12-01,11,3623,5121,2870,10118,8727,1665,74,20624,192,3950,537,4679,529,83,612
2019-12-01,12,3604,5050,2755,10009,8513,1591,67,20216,244,4011,600,4855,430,71,501
2019-12-01,13,3585,4961,2663,9960,8431,1586,62,20079,239,3905,559,4703,382,64,446
2019-12-01,14,3608,4941,2592,9960,8469,1599,59,20126,198,3519,468,4185,379,62,441
2019-12-01,15,3663,4984,2566,10159,8645,1711,57,20609,143,2717,359,3219,395,61,456
2019-12-01,16,3784,5185,2614,10484,9019,1863,58,21460,64,1297,182,1543,431,62,493
2019-12-01,17,4090,5576,2779,11118,9944,2146,66,23311,9,192,32,233,471,66,537
2019-12-01,18,4390,5709,2979,12054,11419,2600,76,26187,0,0,0,0,482,70,552
2019-12-01,19,4384,5704,2973,12172,11741,2691,78,26720,0,0,0,0,478,71,549
2019-12-01,20,4316,5647,2933,11930,11716,2648,79,26409,0,0,0,0,448,72,520
2019-12-01,21,4241,5511,2854,11612,11520,2547,79,25796,0,0,0,0,393,73,466
2019-12-01,22,4093,5259,2724,11117,11107,2411,77,24751,0,0,0,0,347,74,421
2019-12-01,23,3899,4995,2549,10345,10492,2213,74,23160,0,0,0,0,317,74,391
2019-12-01,24,3731,4854,2399,9630,9800,2027,72,21566,0,0,0,0,290,70,360
2019-12-02,1,3616,4894,2332,9388,9393,1922,67,20807,0,0,0,0,200,59,259
2019-12-02,2,3548,4893,2306,9015,9070,1860,67,20051,0,0,0,0,165,55,220
2019-12-02,3,3516,4912,2323,8842,8903,1818,69,19669,0,0,0,0,137,50,187
2019-12-02,4,3533,5015,2374,8850,8921,1812,71,19694,0,0,0,0,119,47,166
2019-12-02,5,3615,5261,2523,9131,9188,1873,77,20314,0,0,0,0,126,46,172
2019-12-02,6,3788,5662,2807,9824,9961,2052,86,21962,0,0,0,0,164,46,210
2019-12-02,7,3998,5989,3197,11028,10985,2304,93,24447,0,47,0,47,191,46,237
2019-12-02,8,4017,6008,3426,12005,11353,2376,94,25865,40,937,121,1098,203,46,249
2019-12-02,9,3972,5948,3354,12193,11384,2278,87,25978,178,2594,484,3256,209,43,252
2019-12-02,10,3910,5848,3255,12328,11225,2141,80,25809,300,3713,790,4803,181,39,220
2019-12-02,11,3843,5728,3141,12374,11052,2026,72,25559,353,4116,883,5352,135,37,172
2019-12-02,12,3803,5645,3019,12368,10902,1964,66,25337,383,4118,895,5396,98,36,134
2019-12-02,13,3777,5622,2931,12361,10793,1958,63,25210,384,3895,884,5163,76,35,111
2019-12-02,14,3782,5592,2855,12328,10870,2001,61,25296,358,3404,804,4566,74,37,111
2019-12-02,15,3810,5617,2809,12377,11014,2078,59,25563,289,2583,643,3515,84,42,126
2019-12-02,16,3898,5772,2842,12432,11298,2183,60,26009,146,1290,353,1789,95,40,135
2019-12-02,17,4200,6134,3002,12834,11960,2406,65,27302,26,227,73,326,95,34,129
2019-12-02,18,4495,6241,3203,13483,13209,2825,70,29624,0,0,0,0,97,27,124
2019-12-02,19,4515,6183,3218,13531,13284,2895,72,29819,0,0,0,0,101,23,124
2019-12-02,20,4461,6074,3152,13252,13077,2837,74,29277,0,0,0,0,107,24,131
2019-12-02,21,4361,5875,3054,12795,12713,2712,73,28329,0,0,0,0,115,26,141
2019-12-02,22,4178,5544,2893,12064,12095,2538,71,26804,0,0,0,0,119,30,149
2019-12-02,23,3956,5218,2686,11095,11214,2288,68,24701,0,0,0,0,123,31,154
2019-12-02,24,3757,5017,2510,10261,10369,2071,66,22803,0,0,0,0,119,30,149
2019-12-03,1,3633,4983,2379,9656,9741,1979,67,21480,0,0,0,0,62,19,81
2019-12-03,2,3558,4957,2342,9305,9408,1902,68,20721,0,0,0,0,61,19,80
2019-12-03,3,3523,4953,2343,9096,9204,1859,70,20267,0,0,0,0,64,20,84
2019-12-03,4,3532,5035,2376,9066,9180,1846,72,20202,0,0,0,0,64,20,84
2019-12-03,5,3605,5263,2505,9315,9458,1898,78,20786,0,0,0,0,56,20,76
2019-12-03,6,3771,5653,2777,10034,10373,2056,87,22585,0,0,0,0,47,26,73
2019-12-03,7,3971,5974,3155,11282,11422,2315,93,25143,0,24,0,24,40,34,74
2019-12-03,8,3976,5981,3363,12072,11931,2399,94,26532,94,548,102,744,33,43,76
2019-12-03,9,3930,5918,3278,12043,11968,2351,86,26485,374,1608,392,2374,32,59,91
2019-12-03,10,3873,5829,3173,11842,11917,2345,78,26223,565,2325,644,3534,29,69,98
2019-12-03,11,3828,5731,3060,11687,11877,2304,72,25979,581,2524,756,3861,23,69,92
2019-12-03,12,3788,5654,2945,11521,11813,2287,67,25727,566,2549,781,3896,21,67,88
2019-12-03,13,3766,5639,2858,11395,11811,2280,63,25600,534,2299,715,3548,20,67,87
2019-12-03,14,3766,5609,2794,11452,11830,2306,62,25689,451,1774,569,2794,21,74,95
2019-12-03,15,3791,5644,2742,11531,11892,2336,60,25864,326,1258,412,1996,20,81,101
2019-12-03,16,3882,5808,2764,11656,11923,2379,62,26060,160,587,212,959,16,83,99
2019-12-03,17,4176,6156,2928,12347,12320,2548,67,27315,29,83,41,153,16,78,94
2019-12-03,18,4442,6251,3123,13335,13381,2863,72,29688,0,1,0,1,18,71,89
2019-12-03,19,4455,6188,3130,13340,13402,2863,73,29714,0,0,0,0,19,78,97
2019-12-03,20,4402,6084,3066,13078,13174,2788,75,29150,0,0,0,0,18,86,104
2019-12-03,21,4311,5877,2975,12674,12811,2680,74,28275,0,0,0,0,20,85,105
2019-12-03,22,4130,5555,2817,12017,12196,2516,71,26833,0,0,0,0,25,89,114
2019-12-03,23,3910,5238,2618,11049,11323,2273,68,24748,0,0,0,0,26,104,130
2019-12-03,24,3714,5041,2445,10217,10450,2067,65,22836,0,0,0,0,24,124,148
2019-12-04,1,3572,4970,2297,9819,9813,1954,63,21684,0,0,0,0,21,127,148
2019-12-04,2,3492,4933,2252,9470,9412,1880,64,20861,0,0,0,0,16,148,164
2019-12-04,3,3455,4948,2247,9251,9172,1827,65,20350,0,0,0,0,13,170,183
2019-12-04,4,3457,5045,2277,9186,9104,1807,66,20199,0,0,0,0,11,184,195
2019-12-04,5,3518,5268,2397,9453,9280,1861,71,20700,0,0,0,0,11,205,216
2019-12-04,6,3682,5655,2666,10128,10009,2016,78,22266,0,0,0,0,13,244,257
2019-12-04,7,3883,5976,3041,11305,11067,2272,85,24764,0,19,0,19,11,258,269
2019-12-04,8,3891,5985,3262,12049,11633,2361,88,26167,6,341,29,376,12,266,278
2019-12-04,9,3871,5913,3177,12135,11926,2354,82,26534,57,1012,147,1216,15,279,294
2019-12-04,10,3839,5827,3079,12115,12097,2312,76,26639,119,1427,306,1852,16,317,333
2019-12-04,11,3818,5735,2979,12019,12147,2247,72,26528,182,1521,459,2162,15,372,387
2019-12-04,12,3789,5647,2873,11909,12166,2252,68,26444,241,1639,538,2418,14,408,422
2019-12-04,13,3781,5614,2789,11820,12122,2294,64,26339,239,1529,507,2275,13,474,487
2019-12-04,14,3792,5584,2731,11779,11997,2367,61,26240,222,1320,462,2004,12,487,499
2019-12-04,15,3825,5611,2682,11787,11867,2311,60,26060,195,1212,396,1803,12,449,461
2019-12-04,16,3940,5767,2707,11942,11929,2345,61,26313,108,690,222,1020,15,431,446
2019-12-04,17,4234,6122,2869,12186,12217,2487,67,26991,21,118,49,188,18,425,443
2019-12-04,18,4473,6211,3052,13212,13130,2807,77,29261,0,0,0,0,23,446,469
2019-12-04,19,4475,6153,3054,13231,13172,2844,77,29358,0,0,0,0,26,463,489
2019-12-04,20,4417,6067,2991,12973,12995,2785,76,28864,0,0,0,0,25,506,531
2019-12-04,21,4319,5874,2898,12610,12643,2662,75,28025,0,0,0,0,26,558,584
2019-12-04,22,4139,5557,2747,11984,12049,2500,72,26640,0,0,0,0,27,573,600
2019-12-04,23,3913,5245,2553,11062,11197,2260,68,24622,0,0,0,0,29,564,593
2019-12-04,24,3716,5051,2382,10252,10361,2048,65,22762,0,0,0,0,36,556,592
2019-12-05,1,3603,4950,2266,9634,9833,1925,66,21494,0,0,0,0,39,466,505
2019-12-05,2,3528,4921,2223,9265,9441,1859,66,20667,0,0,0,0,35,483,518
2019-12-05,3,3492,4923,2216,9017,9224,1804,68,20149,0,0,0,0,25,444,469
2019-12-05,4,3501,5008,2245,8980,9182,1785,70,20053,0,0,0,0,18,375,393
2019-12-05,5,3575,5233,2365,9250,9441,1839,75,20641,0,0,0,0,16,288,304
2019-12-05,6,3747,5620,2636,9938,10146,1991,84,22195,0,0,0,0,14,179,193
2019-12-05,7,3965,5940,3014,11078,11175,2259,91,24649,0,32,0,32,14,104,118
2019-12-05,8,3973,5951,3238,11876,11526,2320,91,25862,91,873,122,1086,17,76,93
2019-12-05,9,3936,5890,3148,11858,11601,2235,84,25814,349,2470,470,3289,18,49,67
2019-12-05,10,3877,5804,3056,11613,11545,2113,77,25383,527,3427,752,4706,18,41,59
2019-12-05,11,3822,5705,2953,11370,11471,2020,72,24969,541,3669,840,5050,22,43,65
2019-12-05,12,3774,5622,2844,11077,11401,1969,66,24546,525,3707,847,5079,26,43,69
2019-12-05,13,3743,5604,2761,11052,11329,1953,62,24431,506,3650,801,4957,26,41,67
2019-12-05,14,3741,5575,2703,11177,11348,2000,60,24617,446,3392,675,4513,23,39,62
2019-12-05,15,3756,5602,2650,11346,11357,2074,58,24867,341,2682,504,3527,22,41,63
2019-12-05,16,3847,5754,2665,11553,11561,2185,59,25390,181,1290,260,1731,21,47,68
2019-12-05,17,4154,6089,2816,12204,12073,2406,65,26774,38,201,51,290,20,58,78
2019-12-05,18,4413,6161,2985,13067,13197,2759,72,29129,0,0,0,0,21,78,99
2019-12-05,19,4420,6095,2977,13090,13217,2812,73,29227,0,0,0,0,21,106,127
2019-12-05,20,4369,6008,2911,12846,13003,2760,74,28719,0,0,0,0,24,134,158
2019-12-05,21,4284,5821,2827,12430,12665,2645,74,27850,0,0,0,0,23,152,175
2019-12-05,22,4114,5515,2686,11805,12082,2489,71,26483,0,0,0,0,23,155,178
2019-12-05,23,3904,5212,2493,10898,11256,2254,67,24510,0,0,0,0,24,143,167
2019-12-05,24,3711,5017,2332,10081,10416,2047,65,22644,0,0,0,0,33,128,161
2019-12-06,1,3588,4907,2223,9454,9802,1938,63,21313,0,0,0,0,13,109,122
2019-12-06,2,3516,4874,2170,9063,9422,1869,63,20473,0,0,0,0,20,83,103
2019-12-06,3,3481,4883,2151,8837,9207,1813,65,19977,0,0,0,0,31,74,105
2019-12-06,4,3495,4966,2172,8795,9165,1795,67,19877,0,0,0,0,42,70,112
2019-12-06,5,3565,5184,2279,9050,9416,1849,72,20450,0,0,0,0,60,64,124
2019-12-06,6,3731,5543,2508,9671,10096,1992,78,21911,0,0,0,0,91,61,152
2019-12-06,7,3935,5859,2847,10847,11102,2250,85,24358,0,25,0,25,123,63,186
2019-12-06,8,3953,5888,3058,11538,11434,2309,86,25437,145,847,165,1157,162,67,229
2019-12-06,9,3934,5812,3008,11442,11411,2230,80,25213,568,2492,667,3727,176,71,247
2019-12-06,10,3889,5711,2945,11211,11287,2128,74,24754,881,3591,1096,5568,143,85,228
2019-12-06,11,3838,5591,2866,10921,11164,2081,70,24288,903,3967,1229,6099,121,94,215
2019-12-06,12,3786,5487,2774,10694,11128,2089,65,24036,855,4004,1239,6098,133,91,224
2019-12-06,13,3751,5440,2697,10587,11048,2106,62,23863,844,3847,1213,5904,167,85,252
2019-12-06,14,3737,5397,2638,10744,11089,2195,60,24145,828,3431,1112,5371,194,78,272
2019-12-06,15,3743,5401,2604,11037,11185,2297,59,24629,750,2674,918,4342,221,67,288
2019-12-06,16,3817,5536,2625,11221,11339,2386,60,25056,442,1320,518,2280,249,59,308
2019-12-06,17,4107,5876,2762,11973,11903,2532,66,26523,91,206,110,407,308,56,364
2019-12-06,18,4344,5940,2909,12830,12939,2702,70,28590,0,0,0,0,390,54,444
2019-12-06,19,4337,5870,2866,12660,12908,2733,71,28422,0,0,0,0,479,57,536
2019-12-06,20,4283,5768,2772,12272,12632,2679,71,27708,0,0,0,0,540,63,603
2019-12-06,21,4206,5610,2684,11942,12264,2576,71,26908,0,0,0,0,544,67,611
2019-12-06,22,4075,5378,2567,11438,11811,2448,69,25823,0,0,0,0,515,74,589
2019-12-06,23,3909,5116,2417,10692,11134,2262,66,24209,0,0,0,0,448,91,539
2019-12-06,24,3737,4934,2261,9959,10361,2063,63,22501,0,0,0,0,381,113,494
2019-12-07,1,3576,4850,2092,9536,9654,1936,59,21283,0,0,0,0,289,198,487
2019-12-07,2,3491,4806,2029,9097,9209,1848,58,20308,0,0,0,0,275,219,494
2019-12-07,3,3436,4789,2005,8807,8935,1793,60,19692,0,0,0,0,301,214,515
2019-12-07,4,3427,4825,2008,8718,8805,1768,62,19449,0,0,0,0,346,209,555
2019-12-07,5,3459,4923,2062,8768,8873,1782,66,19587,0,0,0,0,386,208,594
2019-12-07,6,3521,5078,2173,9026,9171,1840,69,20212,0,0,0,0,415,205,620
2019-12-07,7,3606,5245,2326,9813,9527,1940,74,21453,0,22,0,22,439,201,640
2019-12-07,8,3597,5344,2505,10264,9866,1979,76,22285,52,689,73,814,450,196,646
2019-12-07,9,3629,5402,2622,10644,9999,2065,73,22875,230,2079,308,2617,438,186,624
2019-12-07,10,3638,5376,2649,10879,10025,2105,67,23170,399,2993,529,3921,412,177,589
2019-12-07,11,3608,5306,2614,10906,10023,2056,61,23140,481,3200,620,4301,434,211,645
2019-12-07,12,3583,5223,2541,10900,9998,2047,58,23098,520,3150,628,4298,508,303,811
2019-12-07,13,3569,5168,2459,10863,9969,2085,56,23073,526,2882,573,3981,582,418,1000
2019-12-07,14,3578,5127,2385,10919,9984,2138,54,23193,514,2358,472,3344,632,503,1135
2019-12-07,15,3603,5138,2350,10983,10094,2149,53,23380,443,1723,350,2516,606,521,1127
2019-12-07,16,3706,5307,2378,11164,10318,2208,55,23844,240,794,179,1213,551,511,1062
2019-12-07,17,3990,5692,2532,11516,10931,2371,61,24974,45,102,35,182,525,499,1024
2019-12-07,18,4243,5784,2674,12281,11839,2524,66,26804,0,0,0,0,493,463,956
2019-12-07,19,4217,5746,2639,12143,11842,2576,66,26722,0,0,0,0,473,438,911
2019-12-07,20,4146,5678,2567,11774,11627,2532,65,26094,0,0,0,0,435,422,857
2019-12-07,21,4072,5547,2502,11435,11350,2443,65,25394,0,0,0,0,368,431,799
2019-12-07,22,3963,5323,2414,11007,10962,2340,63,24475,0,0,0,0,334,472,806
2019-12-07,23,3838,5056,2281,10392,10398,2178,60,23132,0,0,0,0,316,519,835
2019-12-07,24,3679,4848,2150,9828,9724,2020,58,21734,0,0,0,0,296,597,893
2019-12-08,1,3526,4724,2054,9327,9294,1945,56,20722,0,0,0,0,264,661,925
2019-12-08,2,3431,4672,2002,8916,8894,1860,55,19826,0,0,0,0,238,680,918
2019-12-08,3,3372,4657,1990,8693,8636,1801,56,19288,0,0,0,0,196,707,903
2019-12-08,4,3352,4680,2000,8559,8500,1770,57,18987,0,0,0,0,160,747,907
2019-12-08,5,3370,4752,2057,8579,8510,1759,60,19011,0,0,0,0,138,829,967
2019-12-08,6,3411,4871,2159,8770,8787,1792,63,19514,0,0,0,0,123,902,1025
2019-12-08,7,3472,5017,2300,9205,9033,1856,67,20260,0,6,0,6,111,939,1050
2019-12-08,8,3461,5117,2481,9544,9303,1899,70,20916,83,490,82,655,92,970,1062
2019-12-08,9,3499,5112,2601,9777,9436,1950,69,21326,341,1642,350,2333,64,1027,1091
2019-12-08,10,3514,5079,2630,9958,9437,1981,67,21538,513,2484,637,3634,46,1178,1224
2019-12-08,11,3497,5016,2583,9939,9379,1947,63,21422,524,2774,784,4082,37,1422,1459
2019-12-08,12,3502,5013,2511,9791,9334,1929,60,21208,547,2968,821,4336,33,1652,1685
2019-12-08,13,3507,4986,2439,9689,9333,1940,58,21115,573,3136,822,4531,29,1871,1900
2019-12-08,14,3521,5008,2379,9727,9387,1991,57,21261,558,3243,783,4584,24,2018,2042
2019-12-08,15,3565,5069,2345,9815,9552,2055,56,21574,507,2903,674,4084,24,1998,2022
2019-12-08,16,3671,5280,2378,10147,9806,2138,57,22247,292,1543,394,2229,30,1889,1919
2019-12-08,17,3960,5655,2540,10892,10506,2388,63,23952,53,271,85,409,41,1784,1825
2019-12-08,18,4213,5732,2718,12046,11378,2704,68,26299,0,0,0,0,53,1839,1892
2019-12-08,19,4225,5685,2728,12253,11507,2704,69,26635,0,0,0,0,61,2007,2068
2019-12-08,20,4182,5626,2684,12099,11401,2641,69,26309,0,0,0,0,73,2095,2168
2019-12-08,21,4106,5487,2617,11819,11164,2554,68,25702,0,0,0,0,83,2073,2156
2019-12-08,22,3960,5237,2497,11349,10745,2422,66,24681,0,0,0,0,83,2009,2092
2019-12-08,23,3793,4965,2333,10593,10133,2221,64,23109,0,0,0,0,87,1936,2023
2019-12-08,24,3608,4798,2185,9836,9464,2031,62,21491,0,0,0,0,90,1882,1972
2019-12-09,1,3484,4805,2078,9114,8997,1883,59,20149,0,0,0,0,67,1627,1694
2019-12-09,2,3409,4785,2051,8777,8672,1821,59,19425,0,0,0,0,57,1751,1808
2019-12-09,3,3374,4808,2060,8555,8509,1770,60,18990,0,0,0,0,53,1860,1913
2019-12-09,4,3384,4916,2105,8539,8505,1757,62,18962,0,0,0,0,62,1843,1905
2019-12-09,5,3464,5159,2242,8856,8816,1808,67,19644,0,0,0,0,84,1635,1719
2019-12-09,6,3643,5551,2517,9655,9565,1963,76,21356,0,0,0,0,95,1278,1373
2019-12-09,7,3870,5895,2899,10909,10597,2230,84,23917,0,28,0,28,87,955,1042
2019-12-09,8,3902,5934,3138,11774,10997,2320,87,25279,63,1141,67,1271,72,730,802
2019-12-09,9,3889,5897,3080,11730,11088,2264,81,25265,260,3448,296,4004,50,519,569
2019-12-09,10,3854,5845,3000,11494,10988,2159,76,24812,427,4953,541,5921,28,320,348
2019-12-09,11,3817,5774,2909,11190,10848,2056,71,24261,490,5347,685,6522,14,217,231
2019-12-09,12,3786,5713,2807,10939,10727,1996,66,23823,521,5355,745,6621,7,197,204
2019-12-09,13,3759,5699,2732,10811,10689,1993,63,23652,548,5318,765,6631,6,205,211
2019-12-09,14,3752,5679,2667,10873,10716,2018,62,23764,575,5171,764,6510,5,249,254
2019-12-09,15,3769,5707,2614,11038,10867,2068,60,24129,550,4383,692,5625,6,325,331
2019-12-09,16,3846,5862,2634,11457,11142,2161,62,24920,337,2317,417,3071,8,402,410
2019-12-09,17,4147,6224,2786,12132,11794,2398,68,26491,73,428,93,594,14,454,468
2019-12-09,18,4412,6282,2965,13199,12998,2798,73,29165,0,1,0,1,23,462,485
2019-12-09,19,4431,6209,2985,13249,13061,2854,75,29336,0,0,0,0,34,369,403
2019-12-09,20,4387,6108,2928,12966,12876,2803,76,28820,0,0,0,0,44,207,251
2019-12-09,21,4288,5913,2840,12554,12545,2673,75,27943,0,0,0,0,53,106,159
2019-12-09,22,4116,5587,2689,11916,11956,2505,72,26545,0,0,0,0,58,84,142
2019-12-09,23,3904,5260,2493,11041,11104,2262,69,24573,0,0,0,0,50,77,127
2019-12-09,24,3707,5064,2326,10218,10275,2050,67,22706,0,0,0,0,32,72,104
2019-12-10,1,3583,5017,2258,9681,9608,1941,65,21392,0,0,0,0,29,67,96
2019-12-10,2,3515,4984,2222,9303,9235,1869,66,20571,0,0,0,0,33,55,88
2019-12-10,3,3484,4988,2222,9095,9033,1823,68,20117,0,0,0,0,35,48,83
2019-12-10,4,3497,5079,2255,9088,9004,1812,71,20071,0,0,0,0,26,46,72
2019-12-10,5,3572,5314,2376,9349,9284,1870,76,20676,0,0,0,0,17,45,62
2019-12-10,6,3753,5703,2656,10045,10038,2038,85,22303,0,0,0,0,17,48,65
2019-12-10,7,3974,6042,3027,11201,11094,2250,94,24739,0,31,0,31,16,56,72
2019-12-10,8,3991,6047,3240,11934,11388,2309,94,25822,48,1092,71,1211,16,61,77
2019-12-10,9,3945,5980,3164,12014,11338,2244,85,25778,225,3214,310,3749,17,56,73
2019-12-10,10,3886,5901,3065,11925,11206,2116,77,25421,415,4581,579,5575,16,52,68
2019-12-10,11,3834,5807,2960,11760,11088,2024,71,25040,513,4978,740,6231,19,52,71
2019-12-10,12,3779,5727,2847,11553,10987,1985,65,24688,553,4982,789,6324,22,51,73
2019-12-10,13,3744,5698,2772,11369,10958,1994,61,24480,591,4759,810,6160,22,45,67
2019-12-10,14,3726,5674,2704,11377,11033,2066,59,24632,631,4215,817,5663,22,38,60
2019-12-10,15,3726,5695,2664,11438,11203,2162,58,24958,577,3194,719,4490,24,30,54
2019-12-10,16,3817,5878,2689,11654,11455,2280,59,25545,324,1513,414,2251,26,27,53
2019-12-10,17,4119,6244,2839,12361,12038,2484,65,27046,64,226,92,382,31,32,63
2019-12-10,18,4373,6311,3000,13261,13108,2765,73,29304,0,0,0,0,31,36,67
2019-12-10,19,4393,6236,2990,13291,13179,2812,74,29452,0,0,0,0,30,48,78
2019-12-10,20,4354,6144,2924,13038,12997,2770,74,28976,0,0,0,0,36,44,80
2019-12-10,21,4271,5950,2840,12640,12668,2664,74,28141,0,0,0,0,43,43,86
2019-12-10,22,4108,5631,2697,12017,12086,2501,72,26777,0,0,0,0,44,42,86
2019-12-10,23,3898,5312,2504,11081,11241,2262,68,24749,0,0,0,0,46,41,87
2019-12-10,24,3705,5120,2335,10255,10398,2055,66,22870,0,0,0,0,46,51,97
2019-12-11,1,3535,5009,2208,9684,9916,1976,65,21741,0,0,0,0,58,168,226
2019-12-11,2,3464,4972,2162,9295,9554,1904,66,20915,0,0,0,0,51,246,297
2019-12-11,3,3439,4991,2152,9073,9363,1856,67,20457,0,0,0,0,41,323,364
2019-12-11,4,3456,5069,2183,9032,9320,1845,70,20366,0,0,0,0,36,382,418
2019-12-11,5,3535,5298,2293,9299,9586,1903,76,20960,0,0,0,0,35,464,499
2019-12-11,6,3701,5671,2558,9977,10323,2069,84,22549,0,0,0,0,36,496,532
2019-12-11,7,3919,6001,2921,11171,11372,2344,92,25078,0,23,0,23,37,467,504
2019-12-11,8,3921,6015,3125,11935,11656,2400,94,26186,54,1029,105,1188,37,485,522
2019-12-11,9,3865,5946,3059,11684,11499,2280,85,25647,238,3188,438,3864,39,514,553
2019-12-11,10,3802,5863,2980,11385,11176,2129,76,24868,410,4593,779,5782,40,399,439
2019-12-11,11,3743,5769,2892,11089,10997,2018,70,24276,493,4949,952,6394,41,227,268
2019-12-11,12,3686,5685,2799,10842,10868,1961,64,23833,552,4971,1001,6524,42,163,205
2019-12-11,13,3660,5660,2730,10754,10825,1957,60,23697,578,4949,1004,6531,42,187,229
2019-12-11,14,3663,5638,2678,10837,10921,1997,58,23915,550,4741,958,6249,45,202,247
2019-12-11,15,3682,5668,2647,11052,11074,2070,57,24352,441,3963,813,5217,50,225,275
2019-12-11,16,3778,5835,2662,11434,11353,2184,58,25125,236,2071,457,2764,54,257,311
2019-12-11,17,4084,6206,2815,12186,11931,2420,64,26697,50,358,94,502,56,311,367
2019-12-11,18,4333,6267,2956,13170,13105,2793,68,29235,0,1,0,1,61,388,449
2019-12-11,19,4347,6196,2945,13135,13162,2851,69,29315,0,0,0,0,68,402,470
2019-12-11,20,4305,6101,2867,12846,12942,2807,71,28766,0,0,0,0,72,387,459
2019-12-11,21,4220,5910,2780,12463,12613,2692,71,27937,0,0,0,0,78,354,432
2019-12-11,22,4058,5594,2639,11845,12041,2527,69,26588,0,0,0,0,81,296,377
2019-12-11,23,3857,5273,2447,10938,11230,2293,65,24624,0,0,0,0,81,247,328
2019-12-11,24,3658,5067,2268,10127,10390,2078,63,22756,0,0,0,0,80,215,295
2019-12-12,1,3530,4937,2145,9443,10039,1975,64,21619,0,0,0,0,97,476,573
2019-12-12,2,3458,4894,2092,9056,9648,1911,65,20780,0,0,0,0,120,612,732
2019-12-12,3,3413,4894,2076,8820,9416,1858,66,20260,0,0,0,0,121,740,861
2019-12-12,4,3424,4969,2093,8792,9362,1840,68,20163,0,0,0,0,109,862,971
2019-12-12,5,3499,5189,2193,9041,9613,1898,73,20725,0,0,0,0,113,960,1073
2019-12-12,6,3671,5561,2438,9687,10330,2068,81,22264,0,0,0,0,124,973,1097
2019-12-12,7,3887,5886,2787,10893,11391,2333,89,24806,0,22,0,22,132,1003,1135
2019-12-12,8,3892,5909,2980,11685,11687,2380,91,25946,65,830,120,1015,131,1049,1180
2019-12-12,9,3857,5867,2936,11662,11517,2254,83,25613,307,2553,514,3374,124,1035,1159
2019-12-12,10,3804,5803,2891,11485,11263,2104,76,25028,542,3818,911,5271,116,968,1084
2019-12-12,11,3747,5718,2823,11241,11089,1997,71,24497,630,4333,1084,6047,110,924,1034
2019-12-12,12,3692,5646,2742,11070,11029,1953,66,24220,657,4448,1121,6226,110,960,1070
2019-12-12,13,3672,5635,2690,11003,11007,1987,63,24160,683,4344,1127,6154,114,1071,1185
2019-12-12,14,3680,5625,2648,11164,11119,2094,61,24538,694,3995,1079,5768,116,1201,1317
2019-12-12,15,3707,5654,2617,11331,11286,2175,60,24948,630,3240,938,4808,113,1373,1486
2019-12-12,16,3793,5808,2641,11684,11568,2337,61,25748,364,1676,561,2601,109,1575,1684
2019-12-12,17,4089,6161,2788,12299,12120,2539,66,27123,73,281,127,481,113,1679,1792
2019-12-12,18,4322,6198,2919,13081,13252,2788,70,29288,0,0,0,0,121,1748,1869
2019-12-12,19,4325,6112,2897,12997,13279,2827,70,29270,0,0,0,0,134,1782,1916
2019-12-12,20,4275,6020,2818,12679,13060,2773,70,28679,0,0,0,0,163,1721,1884
2019-12-12,21,4190,5835,2737,12245,12707,2662,71,27781,0,0,0,0,194,1609,1803
2019-12-12,22,4035,5537,2603,11619,12142,2510,69,26436,0,0,0,0,210,1516,1726
2019-12-12,23,3851,5217,2419,10786,11310,2274,65,24533,0,0,0,0,211,1548,1759
2019-12-12,24,3651,5005,2246,9957,10467,2065,62,22649,0,0,0,0,196,1638,1834
2019-12-13,1,3498,4926,2197,9287,9747,1943,56,21132,0,0,0,0,176,1589,1765
2019-12-13,2,3422,4872,2145,8905,9354,1865,56,20277,0,0,0,0,160,1521,1681
2019-12-13,3,3388,4870,2126,8686,9123,1819,58,19783,0,0,0,0,154,1395,1549
2019-12-13,4,3398,4944,2147,8665,9060,1796,60,19678,0,0,0,0,166,1291,1457
2019-12-13,5,3470,5146,2246,8890,9314,1847,64,20212,0,0,0,0,173,1234,1407
2019-12-13,6,3636,5494,2481,9519,9971,1987,71,21648,0,0,0,0,170,1228,1398
2019-12-13,7,3857,5823,2818,10684,10975,2246,79,24078,0,19,0,19,173,1280,1453
2019-12-13,8,3861,5873,3042,11470,11268,2310,82,25222,46,1128,104,1278,164,1301,1465
2019-12-13,9,3836,5859,3009,11667,11199,2227,74,25265,213,3524,454,4191,140,1220,1360
2019-12-13,10,3793,5822,2956,11548,11029,2111,68,24852,363,5031,804,6198,120,1094,1214
2019-12-13,11,3738,5764,2890,11454,10900,2012,64,24525,418,5368,988,6774,109,1113,1222
2019-12-13,12,3678,5698,2803,11411,10801,1981,60,24348,445,5358,1072,6875,104,1264,1368
2019-12-13,13,3649,5682,2743,11361,10777,1990,57,24280,465,5330,1078,6873,106,1411,1517
2019-12-13,14,3645,5671,2687,11455,10917,2022,56,24551,462,5154,1022,6638,105,1576,1681
2019-12-13,15,3659,5706,2648,11451,11035,2084,56,24727,387,4302,878,5567,110,1684,1794
2019-12-13,16,3733,5849,2665,11685,11226,2194,57,25262,200,2217,500,2917,117,1709,1826
2019-12-13,17,4019,6181,2814,12303,11748,2415,62,26631,35,380,105,520,116,1737,1853
2019-12-13,18,4233,6189,2940,12908,12800,2695,66,28571,0,0,0,0,122,1721,1843
2019-12-13,19,4219,6077,2905,12737,12784,2726,65,28414,0,0,0,0,142,1682,1824
2019-12-13,20,4170,5951,2819,12366,12516,2670,64,27718,0,0,0,0,158,1721,1879
2019-12-13,21,4094,5786,2729,11914,12160,2568,63,26808,0,0,0,0,160,1773,1933
2019-12-13,22,3982,5549,2619,11410,11735,2446,61,25754,0,0,0,0,181,1815,1996
2019-12-13,23,3839,5275,2472,10684,11065,2262,57,24170,0,0,0,0,224,1880,2104
2019-12-13,24,3665,5068,2317,10003,10293,2066,54,22515,0,0,0,0,267,1933,2200
2019-12-14,1,3584,4914,2248,9495,9635,1957,52,21228,0,0,0,0,336,1978,2314
2019-12-14,2,3487,4844,2201,9053,9252,1867,51,20313,0,0,0,0,319,1995,2314
2019-12-14,3,3436,4824,2183,8788,8974,1806,53,19711,0,0,0,0,329,1993,2322
2019-12-14,4,3420,4856,2196,8672,8841,1779,54,19436,0,0,0,0,407,2011,2418
2019-12-14,5,3445,4950,2262,8719,8901,1792,56,19558,0,0,0,0,491,2027,2518
2019-12-14,6,3518,5100,2385,8982,9162,1846,60,20140,0,0,0,0,465,2051,2516
2019-12-14,7,3609,5288,2554,9466,9552,1945,65,21123,0,15,0,15,377,2120,2497
2019-12-14,8,3587,5419,2752,9948,9682,1980,67,21769,55,984,56,1095,317,2197,2514
2019-12-14,9,3615,5509,2866,10210,9859,1998,67,22224,256,3142,248,3646,283,2210,2493
2019-12-14,10,3641,5534,2878,10289,9897,1939,63,22280,461,4581,486,5528,253,2283,2536
2019-12-14,11,3624,5513,2821,10079,9503,1947,60,21680,572,4955,670,6197,223,2456,2679
2019-12-14,12,3602,5481,2728,9820,9299,1940,58,21210,650,4979,761,6390,207,2553,2760
2019-12-14,13,3577,5473,2637,9691,9257,1928,56,21028,721,4910,785,6416,219,2570,2789
2019-12-14,14,3562,5472,2553,9741,9458,1935,55,21283,775,4567,779,6121,252,2549,2801
2019-12-14,15,3578,5533,2503,9912,9613,1995,54,21667,738,3650,698,5086,314,2516,2830
2019-12-14,16,3672,5707,2538,10348,9913,2087,56,22496,447,1832,421,2700,413,2485,2898
2019-12-14,17,3967,6081,2694,11166,10654,2319,62,24288,97,304,98,499,503,2500,3003
2019-12-14,18,4218,6120,2825,12088,11738,2523,66,26502,0,0,0,0,573,2565,3138
2019-12-14,19,4199,6035,2798,12026,11841,2571,65,26592,0,0,0,0,612,2612,3224
2019-12-14,20,4143,5947,2732,11857,11628,2527,65,26166,0,0,0,0,643,2637,3280
2019-12-14,21,4071,5809,2668,11650,11327,2432,64,25569,0,0,0,0,692,2638,3330
2019-12-14,22,3974,5596,2582,11294,10971,2341,63,24760,0,0,0,0,693,2621,3314
2019-12-14,23,3839,5322,2446,10682,10454,2186,59,23471,0,0,0,0,667,2564,3231
2019-12-14,24,3692,5114,2316,10067,9841,2025,59,22082,0,0,0,0,623,2462,3085
2019-12-15,1,3612,5000,2287,9376,9505,1953,63,21009,0,0,0,0,494,2574,3068
2019-12-15,2,3529,4954,2249,8983,9127,1865,64,20150,0,0,0,0,384,2563,2947
2019-12-15,3,3478,4944,2244,8720,8850,1801,65,19546,0,0,0,0,292,2543,2835
2019-12-15,4,3464,4979,2265,8640,8784,1765,67,19351,0,0,0,0,218,2512,2730
2019-12-15,5,3489,5058,2335,8706,8778,1771,71,19438,0,0,0,0,159,2498,2657
2019-12-15,6,3548,5190,2451,8935,8996,1807,77,19919,0,0,0,0,115,2440,2555
2019-12-15,7,3620,5370,2607,9341,9258,1880,84,20659,0,16,0,16,101,2293,2394
2019-12-15,8,3613,5476,2807,9690,9218,1901,87,21004,138,1042,145,1325,96,2076,2172
2019-12-15,9,3643,5466,2925,9501,9107,1890,84,20674,576,3348,622,4546,72,2014,2086
2019-12-15,10,3659,5443,2926,9439,8942,1825,77,20373,903,4929,1057,6889,48,2180,2228
2019-12-15,11,3640,5384,2848,9167,8745,1747,72,19819,915,5374,1205,7494,37,2326,2363
2019-12-15,12,3620,5376,2749,8945,8652,1687,68,19442,852,5437,1226,7515,34,2333,2367
2019-12-15,13,3600,5341,2666,8951,8661,1675,66,19441,843,5466,1214,7523,33,2202,2235
2019-12-15,14,3599,5362,2594,8937,8744,1703,64,19537,837,5407,1163,7407,32,2046,2078
2019-12-15,15,3636,5423,2545,9248,8954,1791,63,20148,763,4663,1014,6440,31,1972,2003
2019-12-15,16,3734,5646,2594,9770,9332,1929,62,21191,465,2495,601,3561,31,1961,1992
2019-12-15,17,4040,6040,2763,10797,10284,2206,72,23454,102,469,137,708,31,1915,1946
2019-12-15,18,4317,6100,2928,12087,11700,2616,81,26580,0,2,0,2,27,1757,1784
2019-12-15,19,4331,6044,2923,12278,11933,2682,83,27072,0,0,0,0,26,1515,1541
2019-12-15,20,4296,5976,2887,12140,11819,2640,84,26780,0,0,0,0,28,1265,1293
2019-12-15,21,4225,5833,2822,11899,11634,2553,83,26264,0,0,0,0,30,983,1013
2019-12-15,22,4086,5576,2697,11447,11233,2427,81,25278,0,0,0,0,35,686,721
2019-12-15,23,3906,5297,2521,10715,10579,2237,77,23703,0,0,0,0,38,446,484
2019-12-15,24,3735,5129,2373,9991,9872,2053,75,22093,0,0,0,0,41,311,352
2019-12-16,1,3619,5044,2361,9518,9415,1916,73,21016,0,0,0,0,41,286,327
2019-12-16,2,3557,5030,2341,9195,9133,1859,75,20354,0,0,0,0,28,194,222
2019-12-16,3,3534,5062,2359,9046,8995,1821,77,20032,0,0,0,0,21,151,172
2019-12-16,4,3555,5172,2415,9099,9027,1816,80,20115,0,0,0,0,22,139,161
2019-12-16,5,3639,5419,2560,9435,9374,1877,86,20865,0,0,0,0,28,148,176
2019-12-16,6,3831,5815,2848,10204,10179,2063,95,22631,0,0,0,0,37,164,201
2019-12-16,7,4069,6163,3242,11477,11282,2352,104,25305,0,15,0,15,47,180,227
2019-12-16,8,4088,6192,3475,12282,11614,2413,107,26524,121,1211,153,1485,51,205,256
2019-12-16,9,4040,6143,3410,11937,11503,2272,98,25903,537,3838,666,5041,47,253,300
2019-12-16,10,3980,6072,3315,11376,11258,2085,90,24900,864,5465,1133,7462,35,325,360
2019-12-16,11,3921,5986,3205,10788,11052,1951,82,23964,908,5795,1292,7995,30,415,445
2019-12-16,12,3866,5911,3089,10398,10868,1877,76,23316,890,5774,1320,7984,31,521,552
2019-12-16,13,3829,5891,3008,10169,10758,1873,72,22971,904,5772,1319,7995,24,608,632
2019-12-16,14,3816,5871,2937,10198,10835,1946,69,23146,935,5731,1291,7957,20,673,693
2019-12-16,15,3822,5901,2875,10344,10997,2032,67,23532,869,5016,1139,7024,19,706,725
2019-12-16,16,3913,6069,2903,10871,11291,2159,64,24482,523,2751,661,3935,21,691,712
2019-12-16,17,4246,6460,3076,11952,12004,2406,77,26530,118,536,144,798,23,663,686
2019-12-16,18,4541,6512,3246,13451,13176,2821,85,29622,0,3,0,3,28,651,679
2019-12-16,19,4566,6433,3258,13620,13231,2886,88,29915,0,0,0,0,34,635,669
2019-12-16,20,4531,6342,3200,13424,13070,2835,89,29510,0,0,0,0,36,594,630
2019-12-16,21,4437,6150,3110,13038,12803,2719,88,28740,0,0,0,0,41,539,580
2019-12-16,22,4271,5824,2954,12412,12265,2559,86,27419,0,0,0,0,47,514,561
2019-12-16,23,4043,5492,2741,11481,11397,2319,82,25379,0,0,0,0,53,520,573
2019-12-16,24,3846,5300,2563,10629,10570,2112,81,23488,0,0,0,0,58,538,596
2019-12-17,1,3777,5277,2493,10266,10199,2028,86,22668,0,0,0,0,43,515,558
2019-12-17,2,3718,5242,2457,9903,9821,1950,88,21851,0,0,0,0,45,544,589
2019-12-17,3,3694,5251,2461,9693,9596,1903,90,21371,0,0,0,0,39,559,598
2019-12-17,4,3712,5339,2499,9693,9566,1899,93,21341,0,0,0,0,38,557,595
2019-12-17,5,3797,5567,2627,10023,9842,1969,100,22027,0,0,0,0,41,553,594
2019-12-17,6,3986,5954,2904,10735,10631,2160,109,23727,0,0,0,0,41,563,604
2019-12-17,7,4214,6281,3272,11928,11779,2433,117,26348,0,13,0,13,48,578,626
2019-12-17,8,4213,6300,3490,12676,12056,2497,120,27441,52,1017,81,1150,49,588,637
2019-12-17,9,4131,6239,3412,12598,11883,2361,108,27043,233,3354,362,3949,40,602,642
2019-12-17,10,4040,6162,3309,12383,11611,2202,96,26386,395,4756,646,5797,31,613,644
2019-12-17,11,3961,6064,3204,12100,11444,2095,87,25821,471,5107,778,6356,27,643,670
2019-12-17,12,3884,5964,3089,11848,11326,2001,81,25346,498,5124,823,6445,24,680,704
2019-12-17,13,3839,5928,3011,11675,11267,1983,76,25097,506,4924,816,6246,21,706,727
2019-12-17,14,3816,5906,2951,11657,11317,2036,74,25178,486,4432,768,5686,22,721,743
2019-12-17,15,3813,5940,2909,11652,11296,2103,73,25216,390,3468,638,4496,21,703,724
2019-12-17,16,3912,6126,2935,11910,11536,2238,71,25848,206,1765,341,2312,18,661,679
2019-12-17,17,4254,6511,3101,12640,12339,2506,84,27664,43,306,67,416,17,637,654
2019-12-17,18,4544,6574,3256,13601,13471,2905,94,30163,0,1,0,1,26,643,669
2019-12-17,19,4571,6494,3237,13739,13586,2939,93,30446,0,0,0,0,38,626,664
2019-12-17,20,4540,6408,3172,13513,13436,2883,92,30015,0,0,0,0,51,594,645
2019-12-17,21,4461,6213,3094,13121,13108,2773,92,29187,0,0,0,0,63,596,659
2019-12-17,22,4302,5887,2948,12507,12537,2618,89,27845,0,0,0,0,66,541,607
2019-12-17,23,4072,5563,2739,11552,11704,2374,86,25808,0,0,0,0,66,458,524
2019-12-17,24,3881,5364,2554,10743,10868,2154,84,23940,0,0,0,0,70,414,484
2019-12-18,1,3805,5266,2433,10097,10285,2078,89,22640,0,0,0,0,50,449,499
2019-12-18,2,3741,5228,2386,9721,9894,1999,91,21792,0,0,0,0,62,351,413
2019-12-18,3,3721,5237,2378,9468,9686,1957,93,21290,0,0,0,0,83,279,362
2019-12-18,4,3732,5323,2411,9448,9661,1949,97,21248,0,0,0,0,123,222,345
2019-12-18,5,3813,5550,2528,9676,9966,2029,104,21869,0,0,0,0,178,169,347
2019-12-18,6,3998,5929,2798,10348,10736,2219,112,23507,0,0,0,0,221,129,350
2019-12-18,7,4211,6257,3153,11556,11829,2523,120,26126,0,9,0,9,235,107,342
2019-12-18,8,4191,6271,3370,12367,12141,2580,120,27301,81,788,73,942,219,91,310
2019-12-18,9,4109,6207,3309,12207,11958,2421,110,26784,372,2442,350,3164,181,69,250
2019-12-18,10,4025,6123,3222,11959,11667,2234,98,26046,609,3616,688,4913,133,49,182
2019-12-18,11,3950,6016,3131,11642,11384,2106,89,25308,654,4174,908,5736,103,35,138
2019-12-18,12,3877,5915,3030,11409,11088,2008,82,24675,650,4395,1015,6060,88,29,117
2019-12-18,13,3840,5873,2965,11291,10961,1980,77,24397,649,4377,1054,6080,84,39,123
2019-12-18,14,3830,5856,2909,11308,11005,2011,74,24486,650,4197,1037,5884,86,72,158
2019-12-18,15,3836,5883,2885,11482,11124,2075,70,24840,593,3562,898,5053,89,137,226
2019-12-18,16,3949,6066,2926,11830,11414,2212,70,25613,345,1962,519,2826,94,193,287
2019-12-18,17,4294,6459,3088,12593,12207,2506,81,27474,71,383,116,570,82,268,350
2019-12-18,18,4578,6508,3231,13635,13410,2928,91,30155,0,0,0,0,67,427,494
2019-12-18,19,4602,6427,3208,13654,13584,2975,91,30393,0,0,0,0,70,559,629
2019-12-18,20,4570,6346,3132,13361,13472,2926,93,29937,0,0,0,0,76,602,678
2019-12-18,21,4486,6163,3045,12971,13184,2828,93,29156,0,0,0,0,82,585,667
2019-12-18,22,4324,5849,2894,12368,12659,2670,92,27867,0,0,0,0,85,530,615
2019-12-18,23,4094,5523,2689,11436,11840,2425,87,25868,0,0,0,0,84,496,580
2019-12-18,24,3900,5323,2497,10622,11012,2202,85,24005,0,0,0,0,80,572,652
2019-12-19,1,3823,5202,2387,9630,10278,2129,87,22215,0,0,0,0,92,523,615
2019-12-19,2,3748,5170,2336,9225,9863,2046,87,21318,0,0,0,0,69,452,521
2019-12-19,3,3708,5165,2316,9017,9655,2002,91,20863,0,0,0,0,62,428,490
2019-12-19,4,3723,5258,2337,8988,9616,1993,94,20790,0,0,0,0,55,398,453
2019-12-19,5,3805,5480,2440,9221,9917,2063,101,21401,0,0,0,0,42,331,373
2019-12-19,6,3969,5818,2666,9925,10664,2246,111,23044,0,0,0,0,34,262,296
2019-12-19,7,4149,6110,2961,11072,11659,2488,117,25442,0,8,0,8,32,218,250
2019-12-19,8,4148,6161,3153,11887,11914,2535,116,26549,104,1174,128,1406,30,168,198
2019-12-19,9,4096,6114,3163,11817,11715,2404,107,26139,465,3758,583,4806,29,98,127
2019-12-19,10,4026,6039,3127,11552,11378,2206,97,25329,743,5395,1035,7173,29,51,80
2019-12-19,11,3951,5934,3063,11218,11032,2067,86,24499,773,5765,1218,7756,28,46,74
2019-12-19,12,3885,5826,2965,10948,10700,1953,77,23772,742,5753,1271,7766,28,48,76
2019-12-19,13,3827,5788,2896,10763,10540,1913,72,23380,734,5763,1291,7788,26,48,74
2019-12-19,14,3805,5774,2846,10749,10601,1936,67,23445,736,5734,1257,7727,23,44,67
2019-12-19,15,3812,5784,2805,10964,10783,2036,65,23942,664,4985,1098,6747,22,41,63
2019-12-19,16,3901,5936,2812,11210,11123,2193,64,24683,386,2737,647,3770,23,43,66
2019-12-19,17,4204,6299,2935,12016,11908,2455,72,26545,82,550,147,779,26,53,79
2019-12-19,18,4490,6381,3073,13080,13272,2894,82,29425,0,3,0,3,31,63,94
2019-12-19,19,4508,6310,3033,13147,13450,2951,86,29728,0,0,0,0,38,74,112
2019-12-19,20,4472,6235,2955,12928,13292,2905,87,29306,0,0,0,0,44,89,133
2019-12-19,21,4403,6081,2887,12577,13014,2825,88,28596,0,0,0,0,46,98,144
2019-12-19,22,4271,5811,2755,12041,12505,2701,86,27424,0,0,0,0,48,105,153
2019-12-19,23,4088,5491,2581,11152,11719,2474,83,25519,0,0,0,0,50,112,162
2019-12-19,24,3901,5267,2409,10364,10885,2250,80,23673,0,0,0,0,49,115,164
2019-12-20,1,3781,5139,2219,9515,10221,2095,76,22002,0,0,0,0,60,134,194
2019-12-20,2,3704,5092,2150,9142,9799,2003,77,21122,0,0,0,0,68,133,201
2019-12-20,3,3663,5093,2121,8936,9619,1959,79,20696,0,0,0,0,79,126,205
2019-12-20,4,3670,5187,2132,8913,9565,1946,82,20607,0,0,0,0,80,126,206
2019-12-20,5,3748,5380,2213,9153,9818,2013,87,21170,0,0,0,0,68,130,198
2019-12-20,6,3905,5687,2401,9890,10458,2174,95,22723,0,0,0,0,60,129,189
2019-12-20,7,4092,5976,2659,11026,11429,2409,104,25078,0,8,0,8,58,129,187
2019-12-20,8,4091,6039,2846,11800,11672,2447,103,26140,74,1040,106,1220,50,124,174
2019-12-20,9,4055,6008,2880,11684,11536,2321,95,25735,340,3338,478,4156,42,114,156
2019-12-20,10,4000,5933,2877,11373,11301,2147,85,25005,600,4847,860,6307,36,105,141
2019-12-20,11,3929,5818,2843,11062,11007,2008,76,24254,688,5308,1044,7040,33,102,135
2019-12-20,12,3860,5699,2766,10805,10800,1929,68,23708,695,5331,1108,7134,34,103,137
2019-12-20,13,3800,5650,2701,10621,10680,1920,63,23394,711,5196,1137,7044,35,101,136
2019-12-20,14,3763,5634,2652,10620,10794,1955,58,23541,700,4950,1103,6753,35,97,132
2019-12-20,15,3764,5645,2610,10820,10919,2057,57,23964,581,4128,902,5611,37,89,126
2019-12-20,16,3846,5779,2629,11110,11140,2220,59,24633,317,2188,486,2991,41,82,123
2019-12-20,17,4122,6124,2752,11686,11815,2459,64,26118,66,415,99,580,42,80,122
2019-12-20,18,4380,6190,2874,12693,12953,2802,72,28615,0,0,0,0,40,82,122
2019-12-20,19,4382,6098,2816,12634,13002,2827,75,28626,0,0,0,0,40,82,122
2019-12-20,20,4341,5990,2730,12298,12790,2760,77,28013,0,0,0,0,44,89,133
2019-12-20,21,4280,5862,2658,11909,12470,2687,77,27234,0,0,0,0,48,97,145
2019-12-20,22,4187,5663,2553,11505,12099,2582,76,26350,0,0,0,0,49,103,152
2019-12-20,23,4048,5394,2425,10790,11449,2418,73,24819,0,0,0,0,48,107,155
2019-12-20,24,3890,5170,2266,10092,10669,2214,71,23140,0,0,0,0,48,106,154
2019-12-21,1,3752,5003,2062,9640,10185,2016,73,22037,0,0,0,0,55,130,185
2019-12-21,2,3662,4943,1986,9217,9719,1930,74,21068,0,0,0,0,55,128,183
2019-12-21,3,3614,4933,1950,8950,9440,1876,76,20470,0,0,0,0,55,124,179
2019-12-21,4,3600,4972,1943,8836,9321,1848,79,20212,0,0,0,0,54,120,174
2019-12-21,5,3629,5080,1982,8879,9392,1871,83,20352,0,0,0,0,53,122,175
2019-12-21,6,3706,5247,2071,9207,9727,1955,89,21106,0,0,0,0,50,69,119
2019-12-21,7,3805,5423,2198,9785,10283,2076,97,22367,0,6,0,6,51,153,204
2019-12-21,8,3777,5530,2369,10288,10385,2081,97,22981,48,710,77,835,59,158,217
2019-12-21,9,3776,5594,2489,10477,10300,2048,90,23040,237,2318,364,2919,73,162,235
2019-12-21,10,3771,5586,2562,10328,10055,1938,80,22526,421,3535,677,4633,80,151,231
2019-12-21,11,3721,5529,2578,9952,9865,1800,72,21809,498,4050,839,5387,76,144,220
2019-12-21,12,3674,5455,2546,9662,9675,1734,64,21256,526,4138,892,5556,71,137,208
2019-12-21,13,3628,5408,2508,9535,9555,1716,58,20984,528,4017,867,5412,66,121,187
2019-12-21,14,3617,5377,2463,9577,9533,1733,55,21024,478,3688,773,4939,60,103,163
2019-12-21,15,3635,5394,2438,9814,9636,1836,53,21466,357,2894,605,3856,59,84,143
2019-12-21,16,3745,5584,2477,10203,9944,2012,55,22339,187,1434,319,1940,66,77,143
2019-12-21,17,4053,5987,2625,10983,10659,2273,62,24100,42,245,64,351,74,84,158
2019-12-21,18,4300,6028,2737,12044,11946,2615,69,26792,0,1,0,1,82,105,187
2019-12-21,19,4278,5964,2676,12141,12063,2662,72,27064,0,0,0,0,91,140,231
2019-12-21,20,4230,5880,2597,11868,11885,2621,74,26572,0,0,0,0,94,184,278
2019-12-21,21,4169,5754,2528,11514,11581,2534,73,25829,0,0,0,0,93,216,309
2019-12-21,22,4082,5535,2438,11111,11232,2437,72,24979,0,0,0,0,94,238,332
2019-12-21,23,3952,5263,2304,10518,10728,2266,70,23693,0,0,0,0,103,250,353
2019-12-21,24,3799,5049,2165,9907,10058,2091,68,22244,0,0,0,0,140,238,378
2019-12-22,1,3693,4861,2018,9459,9517,1977,71,21164,0,0,0,0,98,195,293
2019-12-22,2,3612,4809,1963,9045,9128,1893,72,20277,0,0,0,0,193,173,366
2019-12-22,3,3562,4795,1936,8764,8874,1824,73,19684,0,0,0,0,424,166,590
2019-12-22,4,3545,4831,1938,8639,8742,1790,75,19393,0,0,0,0,669,192,861
2019-12-22,5,3568,4897,1987,8670,8747,1799,79,19436,0,0,0,0,783,221,1004
2019-12-22,6,3629,5012,2074,8846,8977,1834,86,19882,0,0,0,0,803,225,1028
2019-12-22,7,3698,5175,2202,9208,9283,1930,93,20657,0,4,0,4,805,234,1039
2019-12-22,8,3674,5278,2398,9688,9232,1941,93,21093,35,710,79,824,694,250,944
2019-12-22,9,3681,5279,2542,9819,9203,1920,87,21146,173,2423,360,2956,541,242,783
2019-12-22,10,3690,5255,2623,9942,9162,1844,78,21151,322,3650,588,4560,529,224,753
2019-12-22,11,3665,5195,2635,9937,9043,1756,71,20930,403,4023,651,5077,509,230,739
2019-12-22,12,3625,5186,2603,9803,8938,1699,64,20617,438,4045,657,5140,431,284,715
2019-12-22,13,3596,5162,2570,9787,8837,1699,60,20498,421,3832,583,4836,348,391,739
2019-12-22,14,3596,5185,2532,9718,8924,1743,57,20559,380,3265,477,4122,252,537,789
2019-12-22,15,3624,5254,2505,9896,9240,1828,56,21156,308,2358,376,3042,179,677,856
2019-12-22,16,3730,5478,2539,10236,9559,1965,57,21949,157,1101,203,1461,138,682,820
2019-12-22,17,4049,5876,2696,11140,10325,2223,64,23886,28,175,40,243,121,579,700
2019-12-22,18,4321,5914,2840,12304,11610,2603,71,26716,0,0,0,0,110,485,595
2019-12-22,19,4327,5850,2802,12487,11786,2666,72,27141,0,0,0,0,96,396,492
2019-12-22,20,4291,5791,2740,12333,11657,2625,75,26824,0,0,0,0,81,304,385
2019-12-22,21,4208,5656,2666,12033,11407,2525,74,26169,0,0,0,0,69,220,289
2019-12-22,22,4085,5398,2545,11611,11047,2386,73,25250,0,0,0,0,63,173,236
2019-12-22,23,3933,5114,2371,10831,10439,2187,70,23657,0,0,0,0,66,150,216
2019-12-22,24,3775,4934,2219,10063,9787,2006,69,22059,0,0,0,0,88,131,219
2019-12-23,1,3626,4787,2102,9581,9393,1951,69,21124,0,0,0,0,63,223,286
2019-12-23,2,3551,4762,2069,9255,9062,1877,70,20396,0,0,0,0,92,214,306
2019-12-23,3,3517,4774,2060,9070,8902,1829,71,20006,0,0,0,0,164,202,366
2019-12-23,4,3530,4877,2093,9097,8840,1814,73,19956,0,0,0,0,245,204,449
2019-12-23,5,3609,5120,2211,9404,9140,1854,77,20604,0,0,0,0,312,184,496
2019-12-23,6,3777,5467,2447,10095,9865,1993,84,22167,0,0,0,0,339,154,493
2019-12-23,7,3969,5774,2755,11296,10929,2218,92,24663,0,3,0,3,312,168,480
2019-12-23,8,3990,5863,2988,12169,11408,2327,96,26126,28,277,33,338,258,183,441
2019-12-23,9,3967,5860,3018,12277,11615,2331,91,26455,152,1006,167,1325,208,214,422
2019-12-23,10,3933,5836,2991,12018,11610,2249,86,26087,279,1589,327,2195,160,336,496
2019-12-23,11,3891,5782,2943,11672,11517,2148,80,25540,340,1826,460,2626,137,448,585
2019-12-23,12,3857,5706,2858,11323,11392,2066,76,24978,390,1965,529,2884,146,447,593
2019-12-23,13,3812,5692,2800,11123,11297,2039,73,24654,389,1818,486,2693,134,382,516
2019-12-23,14,3789,5682,2743,11111,11336,2036,71,24672,337,1482,404,2223,101,321,422
2019-12-23,15,3810,5691,2699,11208,11356,2100,72,24857,271,1172,314,1757,70,282,352
2019-12-23,16,3897,5835,2711,11537,11462,2200,74,25401,147,597,165,909,61,243,304
2019-12-23,17,4181,6189,2857,12269,12092,2422,75,26999,29,104,32,165,88,204,292
2019-12-23,18,4471,6247,3004,13482,13128,2832,83,29662,0,0,0,0,121,176,297
2019-12-23,19,4494,6163,3003,13642,13262,2892,82,30017,0,0,0,0,136,134,270
2019-12-23,20,4457,6077,2945,13436,13124,2841,80,29623,0,0,0,0,138,101,239
2019-12-23,21,4366,5918,2871,13055,12809,2716,79,28798,0,0,0,0,137,95,232
2019-12-23,22,4208,5625,2725,12474,12266,2561,77,27518,0,0,0,0,133,105,238
2019-12-23,23,4015,5289,2550,11553,11422,2329,75,25507,0,0,0,0,117,130,247
2019-12-23,24,3838,5066,2381,10751,10635,2122,73,23711,0,0,0,0,102,159,261
2019-12-24,1,3799,4952,2258,10197,9911,2010,80,22333,0,0,0,0,145,123,268
2019-12-24,2,3704,4888,2198,9809,9472,1913,81,21407,0,0,0,0,130,156,286
2019-12-24,3,3654,4879,2185,9557,9226,1859,82,20853,0,0,0,0,113,216,329
2019-12-24,4,3653,4924,2202,9474,9111,1831,85,20631,0,0,0,0,106,296,402
2019-12-24,5,3704,5067,2287,9617,9118,1867,88,20819,0,0,0,0,116,371,487
2019-12-24,6,3800,5271,2442,9992,9415,1970,93,21597,0,0,0,0,111,466,577
2019-12-24,7,3939,5486,2661,10709,9856,2171,98,22957,0,5,0,5,92,571,663
2019-12-24,8,3935,5607,2875,11412,10029,2276,101,23942,83,675,70,828,86,674,760
2019-12-24,9,3921,5649,2970,11476,10110,2245,96,24059,380,2379,354,3113,84,789,873
2019-12-24,10,3903,5630,2971,11302,10022,2093,93,23647,621,3637,689,4947,83,901,984
2019-12-24,11,3874,5573,2916,11045,9937,1958,87,23163,678,4091,899,5668,93,1066,1159
2019-12-24,12,3840,5450,2820,10785,9857,1856,79,22713,688,4305,988,5981,114,1272,1386
2019-12-24,13,3775,5388,2709,10720,9765,1813,74,22507,671,4423,982,6076,128,1461,1589
2019-12-24,14,3712,5352,2622,10803,9767,1863,70,22637,590,4402,877,5869,131,1661,1792
2019-12-24,15,3724,5397,2543,11058,9866,1955,69,23088,439,3777,669,4885,126,1810,1936
2019-12-24,16,3813,5548,2575,11359,10118,2099,67,23773,231,2024,354,2609,125,1840,1965
2019-12-24,17,4092,5824,2706,12133,10903,2200,77,25446,50,387,74,511,129,1789,1918
2019-12-24,18,4348,5772,2796,13134,12093,2617,87,28067,0,0,0,0,121,1714,1835
2019-12-24,19,4326,5645,2701,13079,12067,2622,86,27990,0,0,0,0,107,1631,1738
2019-12-24,20,4255,5579,2613,12802,11925,2528,86,27475,0,0,0,0,94,1545,1639
2019-12-24,21,4188,5511,2565,12466,11680,2430,87,26800,0,0,0,0,86,1448,1534
2019-12-24,22,4097,5379,2509,11997,11324,2377,87,25925,0,0,0,0,78,1348,1426
2019-12-24,23,3972,5184,2411,11284,10737,2274,84,24512,0,0,0,0,70,1285,1355
2019-12-24,24,3837,4976,2318,10584,10143,2124,81,23065,0,0,0,0,64,1238,1302
2019-12-25,1,3766,4737,2252,10063,9603,2024,78,21901,0,0,0,0,60,1452,1512
2019-12-25,2,3695,4658,2214,9699,9256,1916,77,21084,0,0,0,0,50,1394,1444
2019-12-25,3,3643,4642,2190,9445,8999,1855,78,20513,0,0,0,0,47,1361,1408
2019-12-25,4,3628,4676,2206,9324,8854,1819,79,20207,0,0,0,0,44,1340,1384
2019-12-25,5,3655,4770,2270,9408,8865,1841,83,20327,0,0,0,0,42,1339,1381
2019-12-25,6,3734,4931,2397,9678,9044,1910,89,20853,0,0,0,0,46,1323,1369
2019-12-25,7,3819,5109,2542,10181,9405,2018,94,21829,0,5,0,5,56,1293,1349
2019-12-25,8,3804,5189,2696,10636,9489,2078,98,22432,52,783,60,895,67,1275,1342
2019-12-25,9,3804,5199,2763,10807,9675,2085,93,22768,259,2687,306,3252,75,1172,1247
2019-12-25,10,3781,5132,2741,10942,9730,2063,89,22932,461,3996,591,5048,73,1067,1140
2019-12-25,11,3717,5065,2679,10875,9671,2018,83,22755,540,4331,750,5621,74,1046,1120
2019-12-25,12,3656,5019,2601,10754,9596,1967,78,22502,548,4358,797,5703,89,1053,1142
2019-12-25,13,3610,5004,2517,10581,9499,1929,74,22192,499,4232,731,5462,115,1054,1169
2019-12-25,14,3586,4973,2442,10541,9416,1958,72,22098,414,3807,596,4817,157,1021,1178
2019-12-25,15,3602,4993,2404,10427,9593,2043,68,22248,301,2996,443,3740,187,958,1145
2019-12-25,16,3700,5134,2432,10636,9861,2134,72,22824,151,1550,223,1924,177,856,1033
2019-12-25,17,3972,5462,2563,11255,10492,2279,81,24233,29,289,43,361,143,728,871
2019-12-25,18,4225,5540,2665,12061,11478,2413,87,26163,0,1,0,1,186,630,816
2019-12-25,19,4242,5527,2649,12080,11706,2483,87,26481,0,0,0,0,361,558,919
2019-12-25,20,4237,5499,2617,11934,11699,2494,87,26341,0,0,0,0,537,511,1048
2019-12-25,21,4204,5398,2577,11718,11509,2423,88,25862,0,0,0,0,654,512,1166
2019-12-25,22,4107,5173,2503,11346,11189,2332,86,25076,0,0,0,0,757,539,1296
2019-12-25,23,3971,4933,2375,10765,10616,2143,82,23722,0,0,0,0,802,607,1409
2019-12-25,24,3835,4786,2252,10098,9946,1978,81,22229,0,0,0,0,789,660,1449
2019-12-26,1,3644,4686,2267,9516,10125,1942,80,21789,0,0,0,0,803,701,1504
2019-12-26,2,3570,4660,2245,9153,9760,1878,80,21001,0,0,0,0,764,553,1317
2019-12-26,3,3539,4670,2241,8939,9508,1822,82,20481,0,0,0,0,705,420,1125
2019-12-26,4,3557,4756,2283,8945,9474,1804,85,20437,0,0,0,0,598,338,936
2019-12-26,5,3640,4950,2402,9227,9725,1864,88,21032,0,0,0,0,488,300,788
2019-12-26,6,3784,5219,2631,9842,10395,2016,93,22473,0,0,0,0,427,301,728
2019-12-26,7,3953,5456,2907,10833,11408,2325,100,24793,0,1,0,1,411,295,706
2019-12-26,8,3966,5537,3104,11518,11914,2468,103,26131,28,224,45,297,399,291,690
2019-12-26,9,3947,5549,3137,11352,12073,2460,101,26110,181,839,213,1233,339,306,645
2019-12-26,10,3915,5491,3094,10926,11973,2399,97,25523,380,1359,410,2149,273,328,601
2019-12-26,11,3870,5411,3015,10499,11856,2383,93,24959,517,1635,564,2716,293,351,644
2019-12-26,12,3826,5313,2903,10044,11666,2293,91,24221,594,1810,654,3058,362,379,741
2019-12-26,13,3794,5276,2806,9867,11503,2272,88,23861,657,1709,650,3016,387,409,796
2019-12-26,14,3782,5227,2720,9846,11546,2241,87,23848,721,1525,606,2852,371,432,803
2019-12-26,15,3802,5212,2655,10009,11472,2270,88,23966,714,1260,510,2484,348,443,791
2019-12-26,16,3895,5322,2670,10485,11694,2312,88,24701,471,622,305,1398,296,441,737
2019-12-26,17,4173,5664,2817,11392,12166,2393,98,26174,115,105,79,299,248,428,676
2019-12-26,18,4487,5744,2981,12620,13317,2776,102,28940,0,0,0,0,211,415,626
2019-12-26,19,4513,5704,2981,12833,13377,2814,99,29247,0,0,0,0,196,389,585
2019-12-26,20,4465,5630,2918,12667,13140,2769,98,28799,0,0,0,0,235,364,599
2019-12-26,21,4386,5472,2849,12343,12889,2675,96,28129,0,0,0,0,271,365,636
2019-12-26,22,4240,5212,2714,11797,12392,2549,93,26957,0,0,0,0,278,380,658
2019-12-26,23,4058,4941,2539,10961,11660,2333,89,25159,0,0,0,0,272,456,728
2019-12-26,24,3884,4785,2400,10211,10878,2137,87,23433,0,0,0,0,240,626,866
2019-12-27,1,3771,4873,2313,9510,9908,1995,86,21610,0,0,0,0,291,530,821
2019-12-27,2,3697,4849,2279,9197,9507,1913,86,20824,0,0,0,0,224,566,790
2019-12-27,3,3665,4858,2277,9004,9330,1875,89,20423,0,0,0,0,167,667,834
2019-12-27,4,3673,4935,2313,9015,9309,1869,92,20411,0,0,0,0,134,719,853
2019-12-27,5,3747,5112,2421,9294,9563,1928,97,20999,0,0,0,0,118,675,793
2019-12-27,6,3885,5344,2626,9899,10085,2083,103,22279,0,0,0,0,114,640,754
2019-12-27,7,4046,5582,2883,10884,10918,2296,111,24317,0,3,0,3,118,632,750
2019-12-27,8,4052,5684,3075,11512,11174,2345,111,25263,110,716,123,949,122,597,719
2019-12-27,9,4028,5721,3119,11338,11198,2257,105,25034,491,2485,561,3537,116,552,668
2019-12-27,10,3985,5674,3092,10871,10913,2079,98,24095,804,3813,1003,5620,93,526,619
2019-12-27,11,3917,5604,3018,10418,10670,1880,89,23189,853,4306,1188,6347,78,520,598
2019-12-27,12,3858,5507,2910,10002,10397,1754,82,22364,832,4460,1253,6545,74,537,611
2019-12-27,13,3800,5456,2807,9704,10209,1681,77,21802,837,4559,1269,6665,62,573,635
2019-12-27,14,3765,5410,2718,9618,10198,1661,74,21681,830,4601,1219,6650,47,640,687
2019-12-27,15,3766,5388,2659,9830,10233,1719,72,21983,738,4083,1064,5885,32,721,753
2019-12-27,16,3833,5493,2658,10228,10555,1851,76,22836,454,2339,640,3433,22,748,770
2019-12-27,17,4109,5836,2797,11161,11279,2119,85,24769,112,503,153,768,24,721,745
2019-12-27,18,4418,5907,2947,12359,12712,2555,94,27846,0,1,0,1,31,683,714
2019-12-27,19,4441,5833,2917,12491,12947,2647,94,28302,0,0,0,0,35,573,608
2019-12-27,20,4398,5723,2830,12255,12753,2618,95,27839,0,0,0,0,38,420,458
2019-12-27,21,4335,5584,2759,11961,12540,2551,95,27265,0,0,0,0,39,321,360
2019-12-27,22,4227,5387,2648,11540,12178,2463,94,26394,0,0,0,0,34,249,283
2019-12-27,23,4087,5152,2512,10918,11593,2303,90,25024,0,0,0,0,29,204,233
2019-12-27,24,3933,4981,2379,10299,10860,2123,87,23494,0,0,0,0,27,210,237
2019-12-28,1,3934,5070,2355,9811,10317,2073,83,22416,0,0,0,0,48,246,294
2019-12-28,2,3841,5022,2307,9444,9875,1992,83,21526,0,0,0,0,42,246,288
2019-12-28,3,3791,5019,2293,9242,9614,1936,86,21009,0,0,0,0,37,257,294
2019-12-28,4,3775,5062,2312,9188,9504,1908,88,20820,0,0,0,0,37,260,297
2019-12-28,5,3804,5167,2379,9281,9590,1943,92,21035,0,0,0,0,40,263,303
2019-12-28,6,3890,5313,2506,9534,9919,2026,98,21704,0,0,0,0,43,254,297
2019-12-28,7,4005,5509,2683,10043,10359,2154,106,22788,0,5,0,5,43,210,253
2019-12-28,8,3994,5623,2866,10460,10342,2184,107,23221,120,1031,135,1286,47,166,213
2019-12-28,9,3997,5683,2985,10417,10224,2114,101,22980,531,3487,608,4626,47,134,181
2019-12-28,10,3990,5670,2983,10129,9902,1980,92,22225,864,5137,1070,7071,32,95,127
2019-12-28,11,3943,5609,2913,9727,9524,1839,84,21299,906,5530,1256,7692,20,71,91
2019-12-28,12,3883,5535,2810,9216,9216,1742,78,20378,877,5547,1305,7729,20,83,103
2019-12-28,13,3813,5491,2699,8927,9020,1685,73,19831,886,5588,1316,7790,16,93,109
2019-12-28,14,3763,5464,2598,8864,8905,1660,69,19626,915,5600,1292,7807,11,104,115
2019-12-28,15,3763,5495,2545,9027,9045,1725,67,19993,865,4951,1146,6962,7,121,128
2019-12-28,16,3834,5681,2564,9552,9341,1886,67,20974,538,2843,694,4075,7,130,137
2019-12-28,17,4161,6070,2717,10632,10231,2191,77,23260,126,621,167,914,8,131,139
2019-12-28,18,4437,6089,2852,11975,11730,2616,86,26532,0,3,0,3,10,119,129
2019-12-28,19,4435,6023,2825,12060,12047,2696,88,27012,0,0,0,0,13,96,109
2019-12-28,20,4402,5956,2768,11781,11954,2675,89,26627,0,0,0,0,16,73,89
2019-12-28,21,4344,5839,2702,11506,11763,2604,88,26089,0,0,0,0,20,57,77
2019-12-28,22,4258,5618,2611,11208,11528,2509,87,25460,0,0,0,0,25,54,79
2019-12-28,23,4120,5352,2481,10646,11050,2346,84,24253,0,0,0,0,29,61,90
2019-12-28,24,3962,5158,2346,10110,10430,2165,81,22915,0,0,0,0,35,70,105
2019-12-29,1,3827,5128,2266,9602,9994,2052,80,21868,0,0,0,0,82,64,146
2019-12-29,2,3755,5086,2219,9198,9582,1966,80,20976,0,0,0,0,84,51,135
2019-12-29,3,3715,5075,2204,8920,9262,1910,82,20326,0,0,0,0,81,45,126
2019-12-29,4,3697,5110,2218,8794,9139,1881,84,20050,0,0,0,0,74,45,119
2019-12-29,5,3724,5187,2271,8857,9157,1905,88,20157,0,0,0,0,59,49,108
2019-12-29,6,3797,5313,2372,9054,9383,1960,94,20642,0,0,0,0,64,47,111
2019-12-29,7,3889,5486,2509,9390,9749,2067,102,21448,0,5,0,5,84,40,124
2019-12-29,8,3870,5597,2701,9760,9681,2083,103,21752,52,921,82,1055,95,42,137
2019-12-29,9,3864,5586,2837,9898,9636,1990,97,21755,271,3032,399,3702,98,42,140
2019-12-29,10,3858,5548,2864,9880,9359,1866,87,21322,504,4447,762,5713,81,45,126
2019-12-29,11,3828,5472,2815,9679,9097,1720,79,20696,616,4947,965,6528,66,63,129
2019-12-29,12,3773,5445,2743,9453,8875,1624,71,20147,653,5023,1061,6737,66,98,164
2019-12-29,13,3723,5400,2676,9433,8794,1589,67,20009,622,4927,1095,6644,64,135,199
2019-12-29,14,3706,5421,2615,9471,8711,1614,65,19988,529,4741,1011,6281,69,211,280
2019-12-29,15,3731,5500,2587,9617,8894,1695,63,20395,388,4015,788,5191,83,288,371
2019-12-29,16,3821,5713,2630,10082,9323,1838,62,21442,206,2208,423,2837,118,282,400
2019-12-29,17,4162,6113,2794,10956,10322,2141,74,23626,47,451,91,589,165,259,424
2019-12-29,18,4462,6146,2934,12113,11867,2609,82,26810,0,0,0,0,187,241,428
2019-12-29,19,4463,6086,2909,12231,12213,2695,83,27368,0,0,0,0,179,226,405
2019-12-29,20,4433,6028,2861,12042,12210,2672,84,27154,0,0,0,0,158,224,382
2019-12-29,21,4359,5888,2794,11736,11976,2581,82,26522,0,0,0,0,151,195,346
2019-12-29,22,4235,5638,2670,11264,11623,2448,81,25568,0,0,0,0,154,155,309
2019-12-29,23,4063,5359,2492,10542,11008,2245,78,24018,0,0,0,0,145,129,274
2019-12-29,24,3901,5190,2335,9879,10266,2052,76,22419,0,0,0,0,176,118,294
2019-12-30,1,3867,5083,2227,9577,9646,1922,82,21357,0,0,0,0,370,63,433
2019-12-30,2,3788,5060,2195,9235,9296,1843,83,20586,0,0,0,0,432,82,514
2019-12-30,3,3753,5068,2204,9087,9130,1805,85,20238,0,0,0,0,441,130,571
2019-12-30,4,3761,5163,2248,9117,9146,1796,88,20279,0,0,0,0,416,206,622
2019-12-30,5,3829,5357,2368,9391,9449,1849,93,20912,0,0,0,0,381,316,697
2019-12-30,6,3968,5625,2586,10070,10120,1996,99,22417,0,0,0,0,322,440,762
2019-12-30,7,4138,5889,2842,11113,11003,2171,107,24523,0,1,0,1,231,548,779
2019-12-30,8,4150,6021,3054,11876,11325,2258,111,25697,62,469,70,601,148,607,755
2019-12-30,9,4129,6100,3126,11823,11312,2257,105,25620,311,1751,349,2411,107,600,707
2019-12-30,10,4094,6099,3141,11536,11126,2144,99,25029,573,2874,665,4112,84,585,669
2019-12-30,11,4043,6066,3110,11163,10886,2025,91,24287,690,3413,848,4951,81,607,688
2019-12-30,12,3993,6023,3029,10816,10681,1946,86,23655,742,3602,942,5286,88,618,706
2019-12-30,13,3943,6012,2958,10608,10528,1908,82,23253,798,3610,965,5373,99,592,691
2019-12-30,14,3912,5999,2886,10611,10536,1929,80,23281,859,3528,935,5322,101,537,638
2019-12-30,15,3913,6025,2835,10763,10641,1985,79,23590,834,3025,830,4689,97,459,556
2019-12-30,16,3978,6176,2829,11159,10868,2085,77,24313,542,1677,521,2740,91,384,475
2019-12-30,17,4255,6562,2977,11985,11470,2309,87,25987,137,352,137,626,104,330,434
2019-12-30,18,4603,6659,3149,13174,12844,2724,94,28970,0,0,0,0,139,296,435
2019-12-30,19,4662,6570,3141,13373,13039,2820,94,29457,0,0,0,0,157,283,440
2019-12-30,20,4632,6434,3070,13098,12858,2780,93,28961,0,0,0,0,160,286,446
2019-12-30,21,4550,6246,2985,12695,12547,2652,91,28124,0,0,0,0,182,291,473
2019-12-30,22,4394,5950,2834,12069,12014,2504,90,26817,0,0,0,0,225,299,524
2019-12-30,23,4207,5633,2644,11163,11203,2287,87,24869,0,0,0,0,260,319,579
2019-12-30,24,4030,5413,2476,10388,10420,2087,84,23109,0,0,0,0,269,344,613
2019-12-31,1,3964,5268,2312,9539,9639,1952,83,21346,0,0,0,0,281,422,703
2019-12-31,2,3880,5206,2269,9160,9228,1863,84,20467,0,0,0,0,258,427,685
2019-12-31,3,3828,5197,2257,8955,8992,1821,86,19991,0,0,0,0,213,435,648
2019-12-31,4,3816,5246,2281,8900,8926,1832,88,19887,0,0,0,0,157,436,593
2019-12-31,5,3860,5421,2368,9052,9071,1834,92,20185,0,0,0,0,121,425,546
2019-12-31,6,3987,5643,2550,9451,9493,1991,99,21172,0,0,0,0,104,412,516
2019-12-31,7,4132,5845,2783,10126,10091,2159,105,22613,0,4,0,4,95,395,490
2019-12-31,8,4144,5970,2957,10643,10249,2228,105,23352,65,795,112,972,89,375,464
2019-12-31,9,4166,6058,2995,10664,10320,2200,101,23402,324,2830,528,3682,82,352,434
2019-12-31,10,4143,6033,2967,10406,10126,2066,92,22809,577,4314,957,5848,62,341,403
2019-12-31,11,4073,5969,2900,9993,9898,2005,82,22103,665,4789,1144,6598,45,349,394
2019-12-31,12,4003,5866,2808,9612,9640,1920,73,21372,692,4959,1202,6853,34,347,381
2019-12-31,13,3926,5819,2706,9411,9430,1891,67,20924,711,5078,1224,7013,20,316,336
2019-12-31,14,3877,5822,2598,9422,9363,1930,62,20910,713,5060,1179,6952,11,264,275
2019-12-31,15,3852,5809,2525,9679,9471,1999,60,21341,645,4448,1006,6099,7,206,213
2019-12-31,16,3919,5937,2541,10178,9804,2131,60,22319,403,2599,603,3605,7,146,153
2019-12-31,17,4187,6262,2679,11143,10490,2369,70,24218,101,595,148,844,10,121,131
2019-12-31,18,4489,6257,2864,12384,11981,2734,79,27321,0,2,0,2,13,129,142
2019-12-31,19,4484,6103,2814,12447,12028,2770,81,27460,0,0,0,0,13,143,156
2019-12-31,20,4401,5952,2669,12100,11649,2648,83,26612,0,0,0,0,12,139,151
2019-12-31,21,4305,5822,2574,11704,11215,2491,84,25628,0,0,0,0,14,110,124
2019-12-31,22,4194,5674,2456,11277,10793,2395,83,24682,0,0,0,0,30,88,118
2019-12-31,23,4105,5524,2361,10684,10360,2285,82,23542,0,0,0,0,45,77,122
2019-12-31,24,4015,5365,2273,10097,9956,2177,80,22443,0,0,0,0,53,67,120
2020-01-01,1,3917,5068,2082,9509,9629,2073,77,21435,0,0,0,0,72,67,139
2020-01-01,2,3838,4968,2025,9111,9268,1978,77,20588,0,0,0,0,84,72,156
2020-01-01,3,3773,4919,1982,8846,8969,1902,78,19945,0,0,0,0,92,95,187
2020-01-01,4,3736,4934,1978,8700,8789,1859,80,19578,0,0,0,0,95,149,244
2020-01-01,5,3741,5021,2017,8722,8758,1846,84,19557,0,0,0,0,99,337,436
2020-01-01,6,3788,5156,2120,8926,8903,1887,91,19951,0,0,0,0,106,464,570
2020-01-01,7,3827,5266,2253,9343,9104,2007,98,20693,0,4,0,4,121,493,614
2020-01-01,8,3743,5308,2353,9476,8828,1979,98,20511,83,837,102,1022,139,575,714
2020-01-01,9,3700,5361,2408,9324,8600,1887,92,20021,393,2841,508,3742,144,672,816
2020-01-01,10,3682,5359,2452,9161,8347,1795,84,19501,691,4274,946,5911,126,883,1009
2020-01-01,11,3656,5329,2484,8954,8221,1700,78,19065,777,4742,1139,6658,106,985,1091
2020-01-01,12,3625,5277,2469,8723,8142,1628,71,18678,785,4844,1194,6823,103,1170,1273
2020-01-01,13,3578,5256,2428,8658,8138,1639,65,18609,802,4818,1220,6840,102,1648,1750
2020-01-01,14,3574,5227,2373,8575,8238,1677,60,18659,813,4713,1205,6731,107,2068,2175
2020-01-01,15,3588,5272,2350,8728,8450,1785,57,19130,756,4086,1058,5900,106,2303,2409
2020-01-01,16,3674,5424,2385,9190,8791,1912,57,20071,467,2312,652,3431,95,2425,2520
2020-01-01,17,3942,5821,2519,10111,9460,2178,63,21944,109,506,166,781,87,2504,2591
2020-01-01,18,4265,5930,2682,11423,10842,2578,72,25049,0,0,0,0,83,2529,2612
2020-01-01,19,4300,5872,2675,11578,11094,2626,75,25508,0,0,0,0,91,2497,2588
2020-01-01,20,4265,5767,2590,11351,11000,2568,78,25135,0,0,0,0,104,2425,2529
2020-01-01,21,4203,5625,2509,11026,10752,2473,78,24467,0,0,0,0,110,2329,2439
2020-01-01,22,4095,5361,2387,10579,10389,2373,76,23551,0,0,0,0,125,2224,2349
2020-01-01,23,3988,5125,2236,9930,9855,2213,73,22209,0,0,0,0,139,2162,2301
2020-01-01,24,3842,4964,2097,9281,9264,2046,72,20804,0,0,0,0,126,2160,2286
2020-01-02,1,3510,4853,2055,8707,9124,1935,69,19962,0,0,0,0,94,2290,2384
2020-01-02,2,3448,4825,2022,8359,8816,1869,69,19245,0,0,0,0,85,2180,2265
2020-01-02,3,3427,4840,2009,8194,8607,1825,71,18829,0,0,0,0,71,2035,2106
2020-01-02,4,3452,4928,2036,8208,8571,1814,74,18794,0,0,0,0,64,1863,1927
2020-01-02,5,3550,5157,2147,8401,8829,1875,80,19310,0,0,0,0,70,1575,1645
2020-01-02,6,3723,5530,2411,9084,9566,2045,88,20908,0,0,0,0,75,1354,1429
2020-01-02,7,3957,5863,2780,10264,10700,2327,98,23515,0,5,0,5,88,1315,1403
2020-01-02,8,3945,5878,3007,11103,11034,2397,99,24760,64,958,70,1092,98,1271,1369
2020-01-02,9,3853,5816,2956,10945,10962,2280,91,24404,324,3262,338,3924,103,992,1095
2020-01-02,10,3769,5743,2888,10457,10683,2100,82,23448,562,4921,673,6156,104,633,737
2020-01-02,11,3702,5653,2807,10014,10429,1958,75,22600,638,5417,897,6952,85,400,485
2020-01-02,12,3655,5567,2709,9589,10250,1861,69,21894,662,5470,988,7120,62,276,338
2020-01-02,13,3628,5546,2638,9379,10197,1829,64,21594,691,5491,1016,7198,44,237,281
2020-01-02,14,3626,5512,2566,9349,10271,1867,61,21674,715,5368,993,7076,33,212,245
2020-01-02,15,3642,5508,2509,9529,10395,1922,59,22030,652,4591,851,6094,24,185,209
2020-01-02,16,3719,5592,2496,9885,10533,2026,59,22630,416,2620,525,3561,20,178,198
2020-01-02,17,3926,5836,2600,10705,10946,2199,63,24039,112,600,140,852,21,155,176
2020-01-02,18,4230,5948,2772,11860,12025,2556,70,26637,0,5,0,5,25,134,159
2020-01-02,19,4267,5878,2781,11959,12248,2665,74,27074,0,0,0,0,24,135,159
2020-01-02,20,4218,5792,2718,11704,12055,2619,76,26589,0,0,0,0,21,113,134
2020-01-02,21,4128,5597,2639,11360,11746,2518,75,25833,0,0,0,0,19,86,105
2020-01-02,22,3973,5324,2492,10849,11226,2366,73,24646,0,0,0,0,14,80,94
2020-01-02,23,3794,5068,2308,10064,10522,2170,70,22953,0,0,0,0,11,75,86
2020-01-02,24,3628,4927,2171,9357,9786,1995,68,21332,0,0,0,0,10,76,86
2020-01-03,1,3568,4887,2073,9063,9204,1939,66,20399,0,0,0,0,27,133,160
2020-01-03,2,3507,4862,2044,8742,8870,1873,67,19678,0,0,0,0,34,128,162
2020-01-03,3,3482,4892,2042,8538,8662,1820,69,19216,0,0,0,0,32,123,155
2020-01-03,4,3499,4964,2072,8529,8620,1806,72,19153,0,0,0,0,24,119,143
2020-01-03,5,3578,5171,2182,8783,8884,1859,78,19731,0,0,0,0,18,124,142
2020-01-03,6,3752,5518,2427,9465,9580,2021,86,21279,0,0,0,0,15,130,145
2020-01-03,7,3991,5837,2769,10545,10656,2302,95,23720,0,5,0,5,15,124,139
2020-01-03,8,3990,5869,2969,11224,11011,2367,95,24804,59,828,95,982,16,114,130
2020-01-03,9,3923,5822,2917,10982,10775,2235,88,24209,291,2778,443,3512,17,100,117
2020-01-03,10,3856,5746,2836,10411,10573,2060,79,23250,553,4166,843,5562,17,84,101
2020-01-03,11,3782,5642,2739,9954,10358,1913,71,22424,692,4647,1069,6408,15,76,91
2020-01-03,12,3714,5545,2625,9539,10225,1832,64,21790,737,4753,1148,6638,16,66,82
2020-01-03,13,3663,5504,2531,9331,10131,1802,59,21454,771,4782,1189,6742,25,52,77
2020-01-03,14,3640,5466,2439,9317,10188,1835,57,21523,787,4698,1181,6666,33,42,75
2020-01-03,15,3636,5447,2364,9447,10250,1910,54,21788,720,3988,1041,5749,37,39,76
2020-01-03,16,3691,5515,2350,9835,10406,2016,54,22438,461,2284,654,3399,37,41,78
2020-01-03,17,3885,5751,2451,10549,10874,2201,58,23808,118,541,172,831,43,43,86
2020-01-03,18,4179,5859,2619,11787,11690,2528,66,26197,0,0,0,0,55,58,113
2020-01-03,19,4217,5773,2617,11804,11833,2604,67,26434,0,0,0,0,64,63,127
2020-01-03,20,4173,5655,2551,11443,11574,2546,70,25758,0,0,0,0,77,59,136
2020-01-03,21,4097,5491,2464,11059,11242,2454,69,24951,0,0,0,0,93,56,149
2020-01-03,22,3988,5288,2343,10581,10834,2337,68,23947,0,0,0,0,108,63,171
2020-01-03,23,3855,5075,2200,9955,10266,2185,66,22581,0,0,0,0,127,78,205
2020-01-03,24,3704,4920,2075,9350,9678,2030,65,21248,0,0,0,0,150,101,251
2020-01-04,1,3647,4912,2105,8815,9354,1944,66,20284,0,0,0,0,173,248,421
2020-01-04,2,3566,4863,2058,8444,8961,1877,67,19443,0,0,0,0,212,364,576
2020-01-04,3,3527,4857,2032,8270,8703,1825,69,18959,0,0,0,0,230,510,740
2020-01-04,4,3520,4894,2037,8190,8588,1803,71,18743,0,0,0,0,224,652,876
2020-01-04,5,3552,4989,2088,8262,8666,1825,75,18906,0,0,0,0,203,745,948
2020-01-04,6,3625,5135,2189,8545,8979,1879,82,19551,0,0,0,0,161,862,1023
2020-01-04,7,3737,5324,2330,8980,9477,2000,90,20614,0,5,0,5,113,1018,1131
2020-01-04,8,3718,5458,2515,9377,9470,2017,92,21061,67,938,104,1109,81,1157,1238
2020-01-04,9,3730,5512,2646,9442,9291,1958,84,20883,344,3104,476,3924,62,1215,1277
2020-01-04,10,3725,5510,2690,9337,9099,1846,76,20464,631,4535,873,6039,46,1188,1234
2020-01-04,11,3677,5462,2673,9031,8907,1707,66,19817,727,4958,1061,6746,46,1143,1189
2020-01-04,12,3648,5406,2615,8758,8764,1597,60,19284,728,5030,1113,6871,67,1166,1233
2020-01-04,13,3616,5367,2548,8529,8697,1544,56,18924,738,5026,1122,6886,85,1220,1305
2020-01-04,14,3606,5342,2481,8518,8674,1530,54,18878,737,4875,1063,6675,81,1233,1314
2020-01-04,15,3627,5342,2433,8622,8747,1587,52,19104,639,4140,880,5659,63,1205,1268
2020-01-04,16,3692,5450,2442,8986,9095,1716,55,19948,383,2345,533,3261,46,1085,1131
2020-01-04,17,3904,5729,2552,9784,9757,1926,59,21619,95,522,143,760,37,836,873
2020-01-04,18,4201,5867,2687,11137,10960,2290,66,24550,0,2,0,2,32,636,668
2020-01-04,19,4205,5799,2657,11233,11146,2438,66,24985,0,0,0,0,27,512,539
2020-01-04,20,4144,5706,2590,10940,10973,2414,68,24494,0,0,0,0,31,396,427
2020-01-04,21,4063,5563,2520,10594,10708,2335,67,23807,0,0,0,0,53,284,337
2020-01-04,22,3961,5374,2419,10237,10339,2243,65,22988,0,0,0,0,95,179,274
2020-01-04,23,3826,5166,2279,9737,9906,2103,63,21908,0,0,0,0,140,154,294
2020-01-04,24,3691,4999,2163,9249,9347,1969,62,20732,0,0,0,0,181,188,369
2020-01-05,1,3573,4877,2147,9268,9266,1956,65,20599,0,0,0,0,255,423,678
2020-01-05,2,3503,4835,2115,8864,8894,1884,67,19747,0,0,0,0,297,627,924
2020-01-05,3,3464,4828,2100,8586,8639,1819,69,19151,0,0,0,0,299,943,1242
2020-01-05,4,3455,4860,2120,8493,8490,1783,71,18876,0,0,0,0,280,1311,1591
2020-01-05,5,3482,4930,2177,8484,8470,1800,76,18868,0,0,0,0,221,1542,1763
2020-01-05,6,3547,5043,2280,8664,8589,1850,83,19225,0,0,0,0,175,1586,1761
2020-01-05,7,3641,5222,2421,9083,8815,1935,91,19962,0,3,0,3,159,1617,1776
2020-01-05,8,3610,5328,2611,9442,8832,1946,93,20351,112,802,76,990,128,1689,1817
2020-01-05,9,3610,5336,2743,9436,8699,1891,87,20167,511,2780,368,3659,100,1726,1826
2020-01-05,10,3615,5335,2787,9182,8508,1770,78,19585,853,4259,705,5817,79,1735,1814
2020-01-05,11,3591,5296,2744,8757,8344,1644,71,18860,919,4799,899,6617,71,1825,1896
2020-01-05,12,3567,5303,2667,8420,8255,1567,65,18339,903,4929,988,6820,83,1960,2043
2020-01-05,13,3537,5285,2597,8280,8259,1572,61,18203,921,4916,1042,6879,107,2040,2147
2020-01-05,14,3531,5304,2523,8294,8306,1594,59,18289,972,4775,1073,6820,117,2027,2144
2020-01-05,15,3557,5358,2483,8595,8491,1696,57,18883,952,4105,981,6038,110,1958,2068
2020-01-05,16,3627,5496,2487,9107,8857,1829,59,19890,647,2390,627,3664,101,1885,1986
2020-01-05,17,3853,5773,2608,10086,9556,2054,64,21795,175,565,170,910,91,1852,1943
2020-01-05,18,4182,5906,2794,11471,10860,2457,70,24895,0,4,0,4,80,1877,1957
2020-01-05,19,4213,5834,2800,11815,11116,2566,73,25606,0,0,0,0,79,1890,1969
2020-01-05,20,4165,5744,2754,11684,10997,2514,75,25307,0,0,0,0,102,1790,1892
2020-01-05,21,4078,5583,2678,11387,10745,2406,72,24651,0,0,0,0,147,1458,1605
2020-01-05,22,3935,5347,2541,10941,10328,2287,70,23668,0,0,0,0,191,1015,1206
2020-01-05,23,3787,5112,2366,10208,9821,2128,67,22270,0,0,0,0,224,682,906
2020-01-05,24,3642,4966,2226,9494,9211,1982,66,20798,0,0,0,0,239,547,786
2020-01-06,1,3558,4877,2124,9421,8795,1882,65,20205,0,0,0,0,173,344,517
2020-01-06,2,3498,4859,2096,9034,8506,1827,66,19471,0,0,0,0,142,339,481
2020-01-06,3,3478,4888,2106,8870,8363,1791,68,19131,0,0,0,0,112,339,451
2020-01-06,4,3500,4992,2150,8913,8374,1786,71,19183,0,0,0,0,87,343,430
2020-01-06,5,3588,5231,2278,9246,8687,1847,77,19902,0,0,0,0,66,344,410
2020-01-06,6,3774,5612,2535,10039,9452,2021,87,21637,0,0,0,0,52,335,387
2020-01-06,7,4027,5967,2892,11337,10590,2321,98,24384,0,5,0,5,38,322,360
2020-01-06,8,4032,6014,3119,12152,11017,2382,98,25688,124,1091,131,1346,25,311,336
2020-01-06,9,3966,5985,3085,11790,11011,2249,89,25176,539,3676,605,4820,18,301,319
2020-01-06,10,3895,5941,3032,11181,10850,2072,80,24220,876,5380,1078,7334,14,305,319
2020-01-06,11,3834,5872,2967,10640,10710,1944,73,23407,931,5777,1271,7979,11,327,338
2020-01-06,12,3778,5812,2875,10207,10609,1873,68,22800,907,5804,1328,8039,10,345,355
2020-01-06,13,3746,5799,2810,9979,10584,1894,64,22565,926,5854,1345,8125,8,354,362
2020-01-06,14,3720,5778,2742,10045,10665,1927,61,22743,985,5844,1330,8159,7,342,349
2020-01-06,15,3714,5784,2680,10217,10782,2019,59,23116,973,5263,1214,7450,7,300,307
2020-01-06,16,3775,5870,2677,10509,10919,2156,60,23683,666,3262,789,4717,11,259,270
2020-01-06,17,3974,6140,2790,11407,11331,2337,65,25178,182,831,213,1226,17,239,256
2020-01-06,18,4280,6270,2975,12644,12455,2660,72,27867,0,12,0,12,23,226,249
2020-01-06,19,4338,6183,2987,12969,12562,2721,77,28364,0,0,0,0,28,216,244
2020-01-06,20,4295,6066,2918,12797,12298,2643,77,27851,0,0,0,0,30,212,242
2020-01-06,21,4204,5857,2824,12475,11919,2532,75,27037,0,0,0,0,29,205,234
2020-01-06,22,4043,5552,2664,11877,11321,2400,72,25707,0,0,0,0,27,198,225
2020-01-06,23,3843,5268,2464,11042,10526,2190,69,23864,0,0,0,0,25,195,220
2020-01-06,24,3673,5090,2300,10251,9834,2017,68,22207,0,0,0,0,24,192,216
2020-01-07,1,3615,4986,2151,9593,9303,1950,71,20956,0,0,0,0,14,212,226
2020-01-07,2,3560,4947,2107,9272,8948,1881,72,20221,0,0,0,0,16,197,213
2020-01-07,3,3539,4959,2094,9149,8693,1838,75,19809,0,0,0,0,20,178,198
2020-01-07,4,3563,5048,2123,9107,8611,1835,78,19675,0,0,0,0,25,165,190
2020-01-07,5,3647,5272,2230,9401,8823,1904,84,20256,0,0,0,0,28,160,188
2020-01-07,6,3844,5648,2482,10093,9539,2080,95,21852,0,0,0,0,30,156,186
2020-01-07,7,4073,5975,2820,11376,10648,2368,105,24554,0,5,0,5,31,149,180
2020-01-07,8,4071,6000,3021,12098,10967,2433,105,25646,90,1017,109,1216,32,135,167
2020-01-07,9,3983,5959,2983,11776,11099,2298,95,25307,404,3446,504,4354,37,122,159
2020-01-07,10,3893,5907,2937,11236,10852,2138,84,24349,676,5060,920,6656,39,100,139
2020-01-07,11,3823,5832,2881,10691,10631,2019,75,23457,746,5428,1103,7277,42,82,124
2020-01-07,12,3760,5764,2804,10270,10481,1934,68,22794,753,5423,1145,7321,56,70,126
2020-01-07,13,3714,5748,2750,10067,10450,1927,63,22550,757,5433,1147,7337,78,55,133
2020-01-07,14,3696,5730,2691,10089,10547,1947,60,22681,745,5321,1088,7154,114,41,155
2020-01-07,15,3699,5737,2635,10217,10691,2028,58,23033,662,4580,928,6170,188,32,220
2020-01-07,16,3773,5845,2634,10598,10894,2156,59,23744,430,2707,581,3718,313,34,347
2020-01-07,17,3975,6100,2739,11319,11327,2345,63,25093,122,678,159,959,448,52,500
2020-01-07,18,4285,6224,2909,12631,12397,2670,71,27809,0,9,0,9,541,99,640
2020-01-07,19,4342,6133,2909,12908,12528,2751,75,28300,0,0,0,0,577,182,759
2020-01-07,20,4302,6024,2847,12665,12311,2698,77,27786,0,0,0,0,567,311,878
2020-01-07,21,4214,5815,2754,12270,11956,2588,75,26944,0,0,0,0,530,464,994
2020-01-07,22,4059,5520,2598,11683,11446,2413,73,25654,0,0,0,0,469,593,1062
2020-01-07,23,3868,5243,2405,10771,10678,2194,70,23758,0,0,0,0,420,737,1157
2020-01-07,24,3704,5066,2249,10000,9931,2010,69,22063,0,0,0,0,391,974,1365
2020-01-08,1,3592,4938,2166,9470,9096,1964,72,20653,0,0,0,0,253,1103,1356
2020-01-08,2,3531,4896,2123,9128,8753,1904,74,19904,0,0,0,0,236,1515,1751
2020-01-08,3,3504,4896,2107,8938,8546,1856,76,19463,0,0,0,0,240,1846,2086
2020-01-08,4,3528,4981,2130,8927,8514,1838,79,19396,0,0,0,0,231,2035,2266
2020-01-08,5,3612,5197,2228,9208,8793,1896,85,20027,0,0,0,0,203,2082,2285
2020-01-08,6,3797,5559,2476,9895,9544,2068,94,21651,0,0,0,0,186,2131,2317
2020-01-08,7,4042,5894,2819,11031,10688,2360,104,24231,0,5,0,5,168,2226,2394
2020-01-08,8,4026,5932,3036,11941,11033,2437,103,25558,95,977,92,1164,145,2271,2416
2020-01-08,9,3932,5908,3020,11823,10893,2325,95,25172,437,3290,425,4152,129,2192,2321
2020-01-08,10,3846,5877,2980,11474,10670,2164,86,24427,712,4940,767,6419,123,1851,1974
2020-01-08,11,3783,5831,2934,11063,10464,2041,78,23681,737,5442,914,7093,115,1663,1778
2020-01-08,12,3734,5780,2868,10711,10299,1952,71,23068,708,5514,956,7178,109,1843,1952
2020-01-08,13,3698,5776,2823,10505,10229,1923,67,22755,686,5552,943,7181,119,2091,2210
2020-01-08,14,3685,5761,2775,10409,10280,1920,64,22707,624,5432,852,6908,136,2324,2460
2020-01-08,15,3691,5773,2738,10394,10395,1977,62,22863,532,4734,701,5967,146,2459,2605
2020-01-08,16,3754,5870,2757,10699,10589,2085,62,23473,368,2809,446,3623,140,2556,2696
2020-01-08,17,3964,6120,2860,11479,11040,2288,66,24918,115,675,128,918,167,2654,2821
2020-01-08,18,4287,6219,3023,12638,12184,2671,74,27609,0,10,0,10,243,2696,2939
2020-01-08,19,4338,6126,3014,12855,12311,2778,79,28059,0,0,0,0,307,2638,2945
2020-01-08,20,4300,6012,2938,12598,12095,2716,81,27540,0,0,0,0,340,2527,2867
2020-01-08,21,4210,5807,2837,12204,11737,2582,79,26658,0,0,0,0,360,2467,2827
2020-01-08,22,4051,5515,2683,11602,11176,2406,77,25315,0,0,0,0,383,2499,2882
2020-01-08,23,3857,5239,2484,10714,10413,2196,73,23451,0,0,0,0,401,2541,2942
2020-01-08,24,3694,5069,2326,9938,9682,2010,72,21754,0,0,0,0,416,2559,2975
2020-01-09,1,3584,4938,2305,9411,9113,1984,74,20614,0,0,0,0,318,2605,2923
2020-01-09,2,3525,4904,2273,9093,8742,1913,74,19856,0,0,0,0,260,2522,2782
2020-01-09,3,3495,4920,2262,8895,8531,1862,75,19396,0,0,0,0,244,2383,2627
2020-01-09,4,3517,5007,2293,8864,8482,1840,78,19297,0,0,0,0,261,2297,2558
2020-01-09,5,3604,5223,2404,9119,8741,1887,83,19865,0,0,0,0,254,2255,2509
2020-01-09,6,3791,5584,2670,9775,9481,2036,92,21413,0,0,0,0,228,2234,2462
2020-01-09,7,4041,5920,3033,10865,10629,2306,102,23934,0,5,0,5,242,2239,2481
2020-01-09,8,4044,5953,3255,11722,11016,2416,102,25296,23,848,49,920,287,2245,2532
2020-01-09,9,3971,5918,3206,11699,10935,2390,96,25157,148,2970,236,3354,246,2161,2407
2020-01-09,10,3893,5872,3144,11554,10764,2332,89,24775,308,4505,434,5247,165,2177,2342
2020-01-09,11,3842,5807,3071,11352,10580,2238,83,24287,418,4879,569,5866,146,2446,2592
2020-01-09,12,3795,5739,2975,11082,10424,2168,77,23781,490,4863,667,6020,209,2613,2822
2020-01-09,13,3760,5729,2908,10789,10337,2181,73,23408,514,4752,719,5985,308,2660,2968
2020-01-09,14,3743,5709,2840,10635,10311,2242,69,23285,518,4414,735,5667,366,2725,3091
2020-01-09,15,3740,5715,2800,10546,10370,2310,67,23319,474,3663,673,4810,344,2814,3158
2020-01-09,16,3803,5805,2809,10799,10454,2368,66,23718,311,2163,440,2914,240,2897,3137
2020-01-09,17,4011,6045,2919,11465,10928,2514,70,25011,89,548,124,761,143,2867,3010
2020-01-09,18,4327,6144,3087,12582,11934,2785,84,27420,0,1,0,1,99,2738,2837
2020-01-09,19,4369,6062,3090,12787,12139,2788,87,27836,0,0,0,0,87,2531,2618
2020-01-09,20,4326,5962,3027,12548,11944,2698,87,27313,0,0,0,0,90,2236,2326
2020-01-09,21,4239,5760,2938,12176,11642,2585,86,26524,0,0,0,0,94,1891,1985
2020-01-09,22,4083,5483,2779,11614,11129,2443,82,25303,0,0,0,0,101,1551,1652
2020-01-09,23,3889,5221,2586,10752,10412,2231,79,23504,0,0,0,0,115,1315,1430
2020-01-09,24,3733,5071,2429,10009,9700,2052,78,21874,0,0,0,0,132,1216,1348
2020-01-10,1,3676,5049,2354,9393,9198,1979,76,20686,0,0,0,0,140,1113,1253
2020-01-10,2,3620,5019,2319,9096,8848,1911,77,19974,0,0,0,0,107,1025,1132
2020-01-10,3,3593,5035,2314,8937,8657,1866,79,19582,0,0,0,0,77,802,879
2020-01-10,4,3612,5117,2349,8960,8630,1854,82,19568,0,0,0,0,56,581,637
2020-01-10,5,3696,5321,2466,9227,8930,1911,88,20197,0,0,0,0,38,389,427
2020-01-10,6,3868,5662,2711,9895,9669,2082,96,21779,0,0,0,0,30,312,342
2020-01-10,7,4106,5988,3057,11065,10765,2370,107,24349,0,5,0,5,24,261,285
2020-01-10,8,4114,6027,3264,11753,11031,2430,107,25365,99,1062,103,1264,17,170,187
2020-01-10,9,4042,5998,3218,11595,10749,2279,98,24753,442,3548,507,4497,18,116,134
2020-01-10,10,3965,5944,3137,11110,10360,2081,87,23669,737,5205,951,6893,25,86,111
2020-01-10,11,3887,5875,3045,10614,10047,1922,79,22689,806,5597,1172,7575,33,68,101
2020-01-10,12,3815,5792,2936,10192,9796,1813,72,21900,806,5627,1255,7688,41,73,114
2020-01-10,13,3764,5763,2848,9972,9663,1776,66,21504,833,5708,1289,7830,56,71,127
2020-01-10,14,3733,5731,2768,9921,9720,1810,62,21541,871,5729,1276,7876,67,61,128
2020-01-10,15,3729,5726,2701,9883,9863,1884,59,21719,815,5191,1164,7170,73,49,122
2020-01-10,16,3795,5789,2704,10310,10118,2015,59,22541,529,3304,780,4613,91,40,131
2020-01-10,17,3995,6033,2793,11097,10673,2233,64,24108,143,909,223,1275,118,35,153
2020-01-10,18,4307,6131,2953,12280,11907,2620,74,26925,0,19,0,19,162,39,201
2020-01-10,19,4350,6038,2929,12373,12094,2711,79,27300,0,0,0,0,217,68,285
2020-01-10,20,4306,5910,2845,12068,11826,2645,81,26665,0,0,0,0,250,110,360
2020-01-10,21,4234,5729,2758,11735,11503,2557,81,25923,0,0,0,0,266,145,411
2020-01-10,22,4116,5514,2635,11301,11078,2446,80,24948,0,0,0,0,278,190,468
2020-01-10,23,3966,5294,2480,10644,10481,2277,78,23516,0,0,0,0,283,292,575
2020-01-10,24,3816,5137,2331,9964,9795,2108,77,21983,0,0,0,0,293,496,789
2020-01-11,1,3723,5023,2242,9432,9363,2015,79,20926,0,0,0,0,191,789,980
2020-01-11,2,3644,4982,2187,9084,8981,1942,79,20126,0,0,0,0,186,1069,1255
2020-01-11,3,3609,4974,2160,8853,8735,1887,81,19593,0,0,0,0,189,1298,1487
2020-01-11,4,3607,5008,2167,8769,8624,1867,84,19382,0,0,0,0,198,1442,1640
2020-01-11,5,3647,5088,2215,8866,8710,1894,89,19594,0,0,0,0,222,1542,1764
2020-01-11,6,3724,5226,2320,9204,9036,1951,95,20319,0,0,0,0,276,1656,1932
2020-01-11,7,3841,5403,2464,9753,9489,2090,103,21467,0,5,0,5,343,1767,2110
2020-01-11,8,3850,5536,2649,10207,9481,2098,104,21919,58,1066,114,1238,422,1857,2279
2020-01-11,9,3838,5613,2774,10289,9242,1977,96,21651,284,3569,514,4367,488,1950,2438
2020-01-11,10,3818,5599,2827,10137,9038,1816,85,21110,501,5203,883,6587,476,2075,2551
2020-01-11,11,3773,5550,2804,9896,8804,1685,73,20488,587,5569,1002,7158,445,2237,2682
2020-01-11,12,3732,5482,2736,9588,8527,1624,66,19834,646,5611,1034,7291,380,2429,2809
2020-01-11,13,3693,5440,2661,9396,8362,1615,63,19464,696,5671,1017,7384,281,2578,2859
2020-01-11,14,3666,5410,2591,9310,8367,1628,60,19393,728,5645,915,7288,219,2660,2879
2020-01-11,15,3673,5412,2549,9417,8440,1735,59,19678,686,5104,774,6564,159,2694,2853
2020-01-11,16,3739,5532,2573,9642,8722,1919,61,20374,461,3240,518,4219,113,2661,2774
2020-01-11,17,3957,5814,2683,10327,9370,2171,66,21971,134,863,154,1151,113,2629,2742
2020-01-11,18,4265,5937,2823,11425,10743,2558,73,24838,0,11,0,11,131,2609,2740
2020-01-11,19,4271,5867,2787,11609,11073,2598,78,25398,0,0,0,0,143,2453,2596
2020-01-11,20,4221,5773,2715,11345,10906,2525,79,24896,0,0,0,0,148,2222,2370
2020-01-11,21,4156,5632,2638,11002,10634,2451,79,24204,0,0,0,0,160,1953,2113
2020-01-11,22,4057,5432,2531,10625,10295,2361,77,23397,0,0,0,0,176,1584,1760
2020-01-11,23,3914,5207,2392,10135,9831,2222,75,22294,0,0,0,0,180,1257,1437
2020-01-11,24,3786,5031,2261,9611,9300,2069,74,21087,0,0,0,0,176,1118,1294
2020-01-12,1,3692,4948,2211,9393,8918,1965,72,20371,0,0,0,0,173,772,945
2020-01-12,2,3627,4904,2167,9029,8564,1897,73,19585,0,0,0,0,166,649,815
2020-01-12,3,3593,4897,2148,8818,8317,1836,75,19068,0,0,0,0,152,731,883
2020-01-12,4,3585,4926,2166,8731,8207,1807,78,18844,0,0,0,0,144,917,1061
2020-01-12,5,3621,4993,2215,8785,8238,1830,83,18957,0,0,0,0,155,1099,1254
2020-01-12,6,3697,5103,2311,9089,8479,1888,89,19566,0,0,0,0,163,1153,1316
2020-01-12,7,3781,5268,2448,9528,8862,1986,98,20498,0,5,0,5,165,1121,1286
2020-01-12,8,3757,5382,2627,9937,8789,1993,99,20849,97,1056,121,1274,171,1143,1314
2020-01-12,9,3742,5401,2760,9866,8554,1903,93,20446,426,3506,544,4476,163,1175,1338
2020-01-12,10,3720,5386,2817,9555,8284,1789,82,19735,722,5093,978,6793,147,1148,1295
2020-01-12,11,3685,5339,2795,9182,7990,1642,74,18911,811,5451,1171,7433,150,1169,1319
2020-01-12,12,3647,5339,2731,8881,7775,1554,67,18303,816,5497,1219,7532,163,1264,1427
2020-01-12,13,3609,5317,2678,8742,7711,1542,62,18078,831,5558,1235,7624,181,1366,1547
2020-01-12,14,3592,5336,2623,8698,7720,1559,58,18060,863,5502,1221,7586,212,1486,1698
2020-01-12,15,3610,5381,2588,8826,7894,1653,56,18457,842,4946,1120,6908,249,1592,1841
2020-01-12,16,3682,5514,2624,9248,8290,1787,58,19410,596,3193,765,4554,323,1611,1934
2020-01-12,17,3920,5794,2738,10504,9084,2029,63,21708,174,884,224,1282,392,1655,2047
2020-01-12,18,4264,5927,2910,11700,10644,2451,70,24894,0,9,0,9,439,1732,2171
2020-01-12,19,4295,5867,2901,12025,11086,2568,74,25781,0,0,0,0,501,1791,2292
2020-01-12,20,4252,5785,2845,11837,11020,2529,74,25487,0,0,0,0,542,1852,2394
2020-01-12,21,4172,5627,2765,11474,10773,2422,74,24770,0,0,0,0,551,1882,2433
2020-01-12,22,4035,5391,2625,10891,10386,2308,72,23684,0,0,0,0,526,1951,2477
2020-01-12,23,3870,5153,2449,10146,9837,2141,69,22216,0,0,0,0,501,2035,2536
2020-01-12,24,3723,4999,2308,9443,9238,1978,67,20751,0,0,0,0,491,2104,2595
2020-01-13,1,3625,4921,2212,9338,8941,1940,68,20315,0,0,0,0,336,2016,2352
2020-01-13,2,3569,4895,2190,8986,8643,1881,69,19606,0,0,0,0,325,2033,2358
2020-01-13,3,3552,4919,2195,8807,8511,1844,71,19261,0,0,0,0,330,2053,2383
2020-01-13,4,3577,5019,2241,8842,8542,1831,73,19317,0,0,0,0,333,2025,2358
2020-01-13,5,3667,5252,2370,9150,8857,1890,79,20001,0,0,0,0,314,1979,2293
2020-01-13,6,3856,5628,2638,9872,9619,2051,87,21651,0,0,0,0,283,1970,2253
2020-01-13,7,4101,5982,3004,11043,10557,2328,98,24051,0,6,0,6,251,2026,2277
2020-01-13,8,4116,6044,3234,11943,10983,2414,100,25470,98,1062,115,1275,235,2079,2314
2020-01-13,9,4037,6039,3216,11829,10909,2300,92,25159,454,3548,520,4522,219,1970,2189
2020-01-13,10,3958,6010,3160,11491,10669,2143,85,24416,755,5183,915,6853,206,1646,1852
2020-01-13,11,3890,5964,3101,11136,10421,1971,79,23638,814,5583,1067,7464,208,1221,1429
2020-01-13,12,3826,5927,3018,10723,10207,1862,74,22893,805,5638,1099,7542,210,946,1156
2020-01-13,13,3792,5927,2959,10481,10108,1835,69,22519,820,5691,1106,7617,220,914,1134
2020-01-13,14,3767,5913,2900,10537,10116,1855,66,22606,852,5670,1085,7607,234,977,1211
2020-01-13,15,3767,5932,2853,10576,10216,1950,64,22843,824,5158,997,6979,228,1087,1315
2020-01-13,16,3820,6028,2863,10867,10438,2131,65,23534,594,3345,701,4640,255,1197,1452
2020-01-13,17,4035,6283,2981,11532,10947,2361,69,24944,184,917,215,1316,309,1304,1613
2020-01-13,18,4359,6396,3151,12631,12176,2768,77,27690,0,11,0,11,328,1373,1701
2020-01-13,19,4414,6299,3156,12944,12380,2807,82,28244,0,0,0,0,316,1353,1669
2020-01-13,20,4373,6175,3082,12735,12193,2719,82,27758,0,0,0,0,315,1332,1647
2020-01-13,21,4283,5961,2978,12328,11863,2615,81,26921,0,0,0,0,330,1344,1674
2020-01-13,22,4119,5653,2812,11677,11296,2468,78,25556,0,0,0,0,352,1378,1730
2020-01-13,23,3913,5361,2606,10794,10520,2254,75,23672,0,0,0,0,401,1474,1875
2020-01-13,24,3745,5174,2451,9976,9780,2072,72,21928,0,0,0,0,458,1578,2036
2020-01-14,1,3677,5016,2416,9456,9221,1979,73,20764,0,0,0,0,360,1499,1859
2020-01-14,2,3615,4968,2384,9142,8868,1907,74,20028,0,0,0,0,312,1539,1851
2020-01-14,3,3588,4974,2376,8965,8673,1855,77,19604,0,0,0,0,263,1635,1898
2020-01-14,4,3609,5057,2412,8967,8649,1838,80,19566,0,0,0,0,248,1701,1949
2020-01-14,5,3693,5269,2528,9253,8942,1898,87,20209,0,0,0,0,288,1738,2026
2020-01-14,6,3878,5634,2795,9788,9726,2076,96,21710,0,0,0,0,334,1775,2109
2020-01-14,7,4119,5966,3162,11057,10900,2376,107,24470,0,4,0,4,379,1797,2176
2020-01-14,8,4112,6011,3371,11885,11242,2455,105,25726,60,1042,124,1226,410,1808,2218
2020-01-14,9,4016,5995,3338,11860,11061,2299,96,25348,305,3482,548,4335,394,1815,2209
2020-01-14,10,3918,5958,3272,11538,10786,2093,85,24536,546,5085,963,6594,383,1806,2189
2020-01-14,11,3841,5902,3198,11159,10527,1953,75,23746,622,5476,1133,7231,364,1861,2225
2020-01-14,12,3785,5858,3112,10844,10328,1855,68,23129,645,5539,1175,7359,311,1967,2278
2020-01-14,13,3748,5861,3053,10627,10258,1820,65,22808,693,5574,1172,7439,264,2019,2283
2020-01-14,14,3724,5861,2999,10557,10310,1846,62,22814,755,5462,1124,7341,233,2023,2256
2020-01-14,15,3726,5887,2958,10515,10431,1931,60,22971,753,4893,1012,6658,215,1983,2198
2020-01-14,16,3770,5994,2978,10658,10638,2071,61,23462,557,3207,699,4463,191,1910,2101
2020-01-14,17,3989,6245,3097,11284,11111,2275,65,24770,175,916,212,1303,163,1880,2043
2020-01-14,18,4334,6346,3293,12400,12272,2658,73,27433,0,9,0,9,159,1887,2046
2020-01-14,19,4388,6250,3289,12957,12467,2792,75,28321,0,0,0,0,178,1891,2069
2020-01-14,20,4353,6127,3219,12782,12282,2724,77,27898,0,0,0,0,195,1872,2067
2020-01-14,21,4266,5917,3118,12398,11948,2614,77,27070,0,0,0,0,200,1856,2056
2020-01-14,22,4106,5622,2947,11768,11394,2460,75,25731,0,0,0,0,191,1843,2034
2020-01-14,23,3909,5344,2743,10836,10623,2238,73,23801,0,0,0,0,170,1745,1915
2020-01-14,24,3745,5167,2584,10037,9874,2054,72,22073,0,0,0,0,142,1527,1669
2020-01-15,1,3649,5057,2577,9574,9344,1972,71,21000,0,0,0,0,133,1404,1537
2020-01-15,2,3596,5013,2546,9251,8990,1903,73,20256,0,0,0,0,106,1248,1354
2020-01-15,3,3571,5023,2546,9091,8790,1856,76,19851,0,0,0,0,84,1144,1228
2020-01-15,4,3590,5105,2590,9125,8760,1845,79,19844,0,0,0,0,73,1052,1125
2020-01-15,5,3678,5330,2724,9432,9049,1913,85,20510,0,0,0,0,66,929,995
2020-01-15,6,3876,5698,2997,10170,10046,2098,94,22442,0,0,0,0,62,763,825
2020-01-15,7,4110,6038,3376,11409,11123,2394,105,25066,0,5,0,5,58,579,637
2020-01-15,8,4085,6073,3590,12275,11477,2460,106,26359,116,1043,139,1298,50,380,430
2020-01-15,9,3985,6040,3539,12070,11230,2288,96,25726,492,3426,620,4538,39,181,220
2020-01-15,10,3891,5998,3441,11628,10823,2061,85,24627,802,4910,1089,6801,28,52,80
2020-01-15,11,3814,5939,3340,11202,10554,1900,76,23762,874,5244,1284,7402,23,16,39
2020-01-15,12,3749,5868,3230,10867,10341,1793,70,23104,867,5182,1339,7388,25,18,43
2020-01-15,13,3704,5845,3154,10686,10253,1757,64,22795,871,5046,1352,7269,27,22,49
2020-01-15,14,3679,5822,3089,10659,10307,1789,61,22849,870,4772,1327,6969,28,25,53
2020-01-15,15,3670,5829,3044,10709,10435,1860,59,23100,811,4064,1220,6095,32,27,59
2020-01-15,16,3714,5935,3070,10984,10658,2000,60,23737,570,2546,852,3968,42,27,69
2020-01-15,17,3933,6191,3168,11616,11133,2206,65,25056,171,698,260,1129,48,27,75
2020-01-15,18,4273,6309,3354,12736,12300,2588,73,27732,0,2,0,2,56,26,82
2020-01-15,19,4337,6225,3345,13127,12513,2728,76,28481,0,0,0,0,84,25,109
2020-01-15,20,4303,6118,3268,12935,12316,2687,77,28044,0,0,0,0,128,28,156
2020-01-15,21,4219,5918,3174,12553,11959,2573,76,27189,0,0,0,0,184,36,220
2020-01-15,22,4059,5626,3005,11909,11399,2410,75,25822,0,0,0,0,248,55,303
2020-01-15,23,3858,5348,2799,11018,10623,2202,72,23942,0,0,0,0,332,87,419
2020-01-15,24,3701,5174,2625,10191,9872,2027,70,22188,0,0,0,0,460,125,585
2020-01-16,1,3627,5027,2498,9743,9409,2027,74,21317,0,0,0,0,314,87,401
2020-01-16,2,3564,4983,2454,9401,9054,1963,75,20559,0,0,0,0,388,117,505
2020-01-16,3,3539,4998,2444,9222,8836,1914,78,20117,0,0,0,0,418,145,563
2020-01-16,4,3560,5081,2476,9221,8797,1897,81,20035,0,0,0,0,477,176,653
2020-01-16,5,3644,5297,2587,9517,9078,1952,87,20693,0,0,0,0,590,205,795
2020-01-16,6,3829,5662,2847,10240,9805,2114,96,22308,0,0,0,0,702,226,928
2020-01-16,7,4069,5977,3206,11403,10938,2380,105,24885,0,5,0,5,750,239,989
2020-01-16,8,4067,6005,3403,12251,11299,2476,107,26178,94,877,118,1089,747,254,1001
2020-01-16,9,3986,5961,3361,12145,11158,2382,97,25833,444,3050,546,4040,681,277,958
2020-01-16,10,3898,5891,3304,11950,10897,2271,87,25236,729,4672,966,6367,516,308,824
2020-01-16,11,3827,5800,3233,11810,10665,2159,78,24743,753,5182,1109,7044,365,400,765
2020-01-16,12,3771,5714,3142,11678,10452,2052,71,24291,721,5248,1127,7096,287,573,860
2020-01-16,13,3736,5699,3091,11531,10346,2034,67,24013,648,5268,1067,6983,308,784,1092
2020-01-16,14,3723,5677,3038,11478,10341,2079,65,23998,480,5228,901,6609,331,983,1314
2020-01-16,15,3729,5679,3001,11421,10407,2151,62,24075,302,4691,711,5704,301,1122,1423
2020-01-16,16,3771,5772,3012,11554,10649,2261,62,24564,156,3012,418,3586,326,1212,1538
2020-01-16,17,3981,6005,3126,12008,11177,2464,66,25769,40,825,98,963,362,1320,1682
2020-01-16,18,4313,6113,3298,12956,12275,2802,74,28165,0,8,0,8,341,1453,1794
2020-01-16,19,4358,6027,3291,13247,12506,2846,74,28722,0,0,0,0,313,1583,1896
2020-01-16,20,4317,5926,3222,13024,12299,2752,77,28197,0,0,0,0,307,1656,1963
2020-01-16,21,4225,5740,3120,12607,11968,2650,76,27349,0,0,0,0,304,1663,1967
2020-01-16,22,4066,5465,2964,11962,11410,2497,75,25990,0,0,0,0,289,1675,1964
2020-01-16,23,3876,5196,2761,11063,10630,2279,71,24091,0,0,0,0,260,1737,1997
2020-01-16,24,3721,5019,2595,10223,9863,2094,69,22308,0,0,0,0,234,1908,2142
2020-01-17,1,3690,4958,2532,9960,9401,2017,70,21508,0,0,0,0,146,2179,2325
2020-01-17,2,3621,4914,2495,9595,9096,1943,71,20773,0,0,0,0,112,2290,2402
2020-01-17,3,3584,4920,2489,9436,8925,1893,72,20395,0,0,0,0,84,2208,2292
2020-01-17,4,3591,4991,2527,9440,8934,1881,75,20399,0,0,0,0,78,1914,1992
2020-01-17,5,3667,5184,2648,9720,9174,1914,80,20955,0,0,0,0,84,1605,1689
2020-01-17,6,3836,5521,2899,10423,9866,2011,87,22445,0,0,0,0,73,1392,1465
2020-01-17,7,4065,5841,3259,11551,10842,2291,97,24845,0,5,0,5,47,1129,1176
2020-01-17,8,4078,5904,3479,12308,11184,2458,99,26107,87,942,100,1129,28,939,967
2020-01-17,9,4019,5906,3445,12014,10942,2416,93,25514,394,3050,454,3898,18,911,929
2020-01-17,10,3954,5880,3366,11515,10646,2247,85,24527,691,4503,846,6040,15,886,901
2020-01-17,11,3889,5838,3275,11008,10367,2095,79,23588,809,5063,1062,6934,15,563,578
2020-01-17,12,3841,5789,3164,10596,10122,1966,74,22803,834,5249,1142,7225,15,190,205
2020-01-17,13,3797,5780,3081,10346,10002,1876,69,22330,839,5303,1197,7339,14,100,114
2020-01-17,14,3768,5766,3009,10317,9983,1879,64,22287,835,5269,1219,7323,14,103,117
2020-01-17,15,3762,5777,2959,10447,10002,1932,62,22484,788,4778,1143,6709,14,108,122
2020-01-17,16,3812,5844,2960,10763,10195,2014,62,23078,577,3180,823,4580,14,96,110
2020-01-17,17,4004,6064,3074,11335,10730,2210,66,24402,185,914,258,1357,15,96,111
2020-01-17,18,4316,6142,3226,12404,11853,2558,75,26954,0,4,0,4,20,112,132
2020-01-17,19,4357,6029,3188,12748,12091,2670,80,27660,0,0,0,0,24,124,148
2020-01-17,20,4313,5894,3097,12521,11846,2609,81,27123,0,0,0,0,25,123,148
2020-01-17,21,4235,5713,3004,12104,11531,2507,81,26289,0,0,0,0,24,119,143
2020-01-17,22,4111,5504,2871,11576,11103,2403,80,25221,0,0,0,0,20,113,133
2020-01-17,23,3954,5288,2702,10952,10506,2245,77,23847,0,0,0,0,17,104,121
2020-01-17,24,3809,5122,2544,10278,9815,2080,75,22311,0,0,0,0,17,95,112
2020-01-18,1,3750,5006,2430,10026,9594,2011,74,21920,0,0,0,0,30,140,170
2020-01-18,2,3673,4952,2375,9605,9207,1934,75,20848,0,0,0,0,27,135,162
2020-01-18,3,3637,4968,2353,9382,9018,1882,77,20385,0,0,0,0,27,121,148
2020-01-18,4,3631,4992,2366,9291,8923,1853,79,20174,0,0,0,0,26,116,142
2020-01-18,5,3669,5086,2428,9415,9011,1881,84,20419,0,0,0,0,26,122,148
2020-01-18,6,3755,5227,2538,9762,9273,1947,90,21099,0,0,0,0,29,131,160
2020-01-18,7,3868,5409,2692,10335,9671,2081,98,22213,0,7,0,7,32,140,172
2020-01-18,8,3864,5530,2860,10831,9713,2088,101,22761,61,1061,90,1212,32,154,186
2020-01-18,9,3860,5606,2978,10745,9619,1964,92,22460,295,3406,419,4120,30,161,191
2020-01-18,10,3834,5602,3017,10432,9390,1813,82,21745,544,4896,774,6214,29,170,199
2020-01-18,11,3780,5554,2980,10078,9062,1683,72,20924,655,5241,966,6862,28,202,230
2020-01-18,12,3714,5486,2899,9719,8821,1596,65,20232,673,5292,1039,7004,27,224,251
2020-01-18,13,3651,5445,2816,9521,8776,1576,58,19962,676,5328,1065,7069,23,222,245
2020-01-18,14,3597,5414,2732,9486,8771,1607,55,19953,662,5272,1040,6974,18,206,224
2020-01-18,15,3579,5404,2671,9598,8902,1742,54,20328,572,4654,895,6121,14,179,193
2020-01-18,16,3627,5517,2700,10016,9231,1913,56,21257,375,2927,588,3890,12,162,174
2020-01-18,17,3814,5788,2794,10805,9832,2137,61,22893,113,816,179,1108,12,164,176
2020-01-18,18,4156,5925,2957,11985,11031,2477,69,25629,0,8,0,8,17,179,196
2020-01-18,19,4198,5874,2924,12390,11325,2589,73,26426,0,0,0,0,25,198,223
2020-01-18,20,4158,5795,2858,12243,11163,2535,74,26052,0,0,0,0,30,217,247
2020-01-18,21,4102,5661,2778,11926,10884,2460,74,25397,0,0,0,0,34,226,260
2020-01-18,22,4010,5471,2670,11484,10511,2378,73,24531,0,0,0,0,37,219,256
2020-01-18,23,3881,5253,2529,10880,10000,2230,71,23257,0,0,0,0,36,215,251
2020-01-18,24,3754,5085,2394,10231,9425,2080,70,21906,0,0,0,0,33,218,251
2020-01-19,1,3619,4923,2289,9716,9038,1930,70,20781,0,0,0,0,21,244,265
2020-01-19,2,3552,4887,2239,9344,8700,1858,71,20001,0,0,0,0,21,237,258
2020-01-19,3,3521,4883,2225,9136,8458,1800,73,19495,0,0,0,0,23,236,259
2020-01-19,4,3519,4916,2240,9050,8335,1775,75,19264,0,0,0,0,23,244,267
2020-01-19,5,3550,4997,2298,9161,8365,1787,80,19420,0,0,0,0,22,259,281
2020-01-19,6,3623,5105,2402,9471,8627,1843,86,20055,0,0,0,0,25,285,310
2020-01-19,7,3700,5264,2560,9871,8979,1957,94,20937,0,8,0,8,28,300,328
2020-01-19,8,3670,5367,2749,10167,9025,1958,97,21323,54,1049,89,1192,30,301,331
2020-01-19,9,3654,5366,2875,10143,8745,1879,89,20884,240,3239,383,3862,30,298,328
2020-01-19,10,3617,5330,2919,10039,8644,1829,79,20619,412,4608,676,5696,28,297,325
2020-01-19,11,3568,5262,2884,9819,8545,1766,70,20228,493,4996,815,6304,22,309,331
2020-01-19,12,3535,5237,2825,9538,8457,1725,63,19810,532,5012,844,6388,15,307,322
2020-01-19,13,3500,5195,2761,9454,8561,1721,58,19823,532,4835,783,6150,14,294,308
2020-01-19,14,3469,5196,2698,9472,8675,1737,56,19968,473,4377,667,5517,15,274,289
2020-01-19,15,3476,5224,2647,9583,8921,1825,54,20411,363,3529,539,4431,16,269,285
2020-01-19,16,3530,5346,2656,9891,9196,1938,55,21108,232,2067,346,2645,14,300,314
2020-01-19,17,3752,5632,2771,10582,9694,2104,60,22468,74,522,101,697,13,324,337
2020-01-19,18,4080,5782,2957,11825,10801,2362,67,25083,0,2,0,2,11,338,349
2020-01-19,19,4124,5742,2955,12315,11158,2513,67,26080,0,0,0,0,11,364,375
2020-01-19,20,4083,5673,2910,12239,11037,2478,66,25847,0,0,0,0,11,372,383
2020-01-19,21,4006,5525,2826,11892,10707,2365,68,25060,0,0,0,0,11,346,357
2020-01-19,22,3877,5300,2681,11310,10267,2235,66,23905,0,0,0,0,11,302,313
2020-01-19,23,3722,5077,2497,10537,9757,2068,63,22453,0,0,0,0,10,264,274
2020-01-19,24,3576,4957,2354,9865,9158,1920,62,21032,0,0,0,0,9,236,245
2020-01-20,1,3517,4911,2205,9537,9068,1877,62,20623,0,0,0,0,18,192,210
2020-01-20,2,3448,4899,2182,9219,8771,1826,63,19961,0,0,0,0,21,159,180
2020-01-20,3,3418,4939,2181,9077,8611,1759,65,19589,0,0,0,0,20,129,149
2020-01-20,4,3431,5028,2216,9042,8528,1747,67,19460,0,0,0,0,19,99,118
2020-01-20,5,3497,5215,2327,9306,8824,1806,70,20068,0,0,0,0,17,79,96
2020-01-20,6,3640,5497,2560,9878,9374,1935,76,21316,0,0,0,0,15,67,82
2020-01-20,7,3795,5746,2834,10743,10224,2115,83,23208,0,4,0,4,18,63,81
2020-01-20,8,3813,5857,3026,11310,10487,2187,87,24140,24,409,33,466,18,58,76
2020-01-20,9,3799,5893,3095,11472,10696,2201,81,24522,131,1344,161,1636,18,58,76
2020-01-20,10,3781,5863,3108,11399,10648,2182,75,24345,242,2081,331,2654,22,73,95
2020-01-20,11,3760,5809,3057,11185,10533,2041,69,23884,318,2451,501,3270,21,76,97
2020-01-20,12,3705,5715,2952,10982,10408,1969,63,23477,375,2686,599,3660,16,70,86
2020-01-20,13,3689,5664,2867,10854,10369,2015,59,23359,364,2699,561,3624,14,67,81
2020-01-20,14,3683,5595,2794,10867,10438,2082,56,23518,324,2402,480,3206,14,70,84
2020-01-20,15,3691,5583,2735,10881,10521,2163,54,23706,275,1927,404,2606,17,108,125
2020-01-20,16,3731,5661,2743,11047,10739,2220,55,24127,176,1153,260,1589,26,153,179
2020-01-20,17,3903,5928,2846,11633,11096,2353,59,25216,52,301,75,428,34,170,204
2020-01-20,18,4225,6087,3033,12687,12059,2636,67,27512,0,1,0,1,36,167,203
2020-01-20,19,4287,6021,3050,13091,12324,2736,68,28270,0,0,0,0,37,206,243
2020-01-20,20,4240,5913,2986,12832,12108,2670,68,27724,0,0,0,0,38,288,326
2020-01-20,21,4149,5698,2904,12386,11730,2550,67,26812,0,0,0,0,41,350,391
2020-01-20,22,3988,5406,2732,11736,11153,2380,66,25415,0,0,0,0,45,450,495
2020-01-20,23,3780,5141,2526,10804,10445,2171,64,23557,0,0,0,0,51,555,606
2020-01-20,24,3614,4982,2356,10059,9758,1983,63,21941,0,0,0,0,67,604,671
2020-01-21,1,3512,4899,2173,9693,9267,1914,60,21002,0,0,0,0,80,902,982
2020-01-21,2,3444,4879,2133,9312,8908,1854,60,20194,0,0,0,0,80,995,1075
2020-01-21,3,3413,4880,2121,9099,8704,1805,62,19732,0,0,0,0,75,1107,1182
2020-01-21,4,3429,4962,2150,9090,8656,1785,64,19662,0,0,0,0,74,1215,1289
2020-01-21,5,3508,5178,2257,9360,8914,1839,69,20260,0,0,0,0,89,1319,1408
2020-01-21,6,3683,5550,2511,10029,9632,1982,76,21785,0,0,0,0,109,1433,1542
2020-01-21,7,3911,5870,2859,11152,10732,2257,84,24266,0,4,0,4,126,1518,1644
2020-01-21,8,3929,5897,3052,11991,11101,2361,88,25568,56,767,86,909,157,1509,1666
2020-01-21,9,3878,5855,3023,12038,11089,2309,82,25588,274,2621,391,3286,195,1411,1606
2020-01-21,10,3814,5789,2975,11918,10966,2237,75,25245,491,3901,738,5130,220,1306,1526
2020-01-21,11,3758,5711,2915,11767,10787,2124,70,24796,573,4345,959,5877,217,1369,1586
2020-01-21,12,3713,5644,2840,11573,10654,2035,66,24388,601,4582,1062,6245,215,1630,1845
2020-01-21,13,3679,5635,2790,11429,10537,1993,64,24083,596,4698,1089,6383,225,1928,2153
2020-01-21,14,3662,5610,2741,11431,10578,2022,62,24167,549,4629,1054,6232,238,2071,2309
2020-01-21,15,3675,5613,2695,11340,10600,2091,60,24158,449,4206,931,5586,237,2072,2309
2020-01-21,16,3729,5692,2706,11443,10778,2204,60,24557,276,2874,634,3784,191,1987,2178
2020-01-21,17,3917,5936,2804,11902,11158,2393,64,25569,79,850,198,1127,140,1909,2049
2020-01-21,18,4215,6060,2966,12927,12135,2522,70,27716,0,6,0,6,123,1870,1993
2020-01-21,19,4264,5980,2970,13324,12377,2655,71,28471,0,0,0,0,120,1818,1938
2020-01-21,20,4218,5878,2908,13098,12189,2618,70,28039,0,0,0,0,126,1793,1919
2020-01-21,21,4127,5676,2810,12626,11824,2502,70,27090,0,0,0,0,131,1822,1953
2020-01-21,22,3963,5382,2643,11935,11270,2337,68,25709,0,0,0,0,125,1921,2046
2020-01-21,23,3778,5106,2442,10966,10505,2131,65,23722,0,0,0,0,115,2021,2136
2020-01-21,24,3606,4932,2278,10170,9771,1956,63,22020,0,0,0,0,104,2077,2181
2020-01-22,1,3489,4886,2185,9644,9239,1937,60,20916,0,0,0,0,82,2342,2424
2020-01-22,2,3426,4851,2138,9297,8889,1898,61,20173,0,0,0,0,72,2291,2363
2020-01-22,3,3400,4855,2125,9083,8684,1842,63,19700,0,0,0,0,63,2214,2277
2020-01-22,4,3418,4936,2155,9046,8638,1824,66,19602,0,0,0,0,56,2144,2200
2020-01-22,5,3502,5153,2264,9284,8892,1874,72,20151,0,0,0,0,49,2110,2159
2020-01-22,6,3691,5519,2523,10022,9612,1990,80,21732,0,0,0,0,42,1981,2023
2020-01-22,7,3926,5844,2885,11239,10704,2272,89,24331,0,6,0,6,39,1811,1850
2020-01-22,8,3937,5876,3093,12079,11093,2365,91,25655,65,828,80,973,40,1388,1428
2020-01-22,9,3869,5847,3044,11875,11020,2240,84,25246,332,2776,394,3502,45,929,974
2020-01-22,10,3790,5801,2987,11538,10835,2067,75,24543,635,4427,791,5853,48,615,663
2020-01-22,11,3730,5745,2917,11201,10641,1974,69,23913,776,5201,1051,7028,47,514,561
2020-01-22,12,3670,5686,2833,10850,10497,1907,64,23345,805,5416,1157,7378,45,528,573
2020-01-22,13,3636,5680,2775,10628,10459,1890,61,23066,818,5523,1174,7515,41,631,672
2020-01-22,14,3620,5661,2716,10580,10529,1922,59,23117,829,5533,1152,7514,34,715,749
2020-01-22,15,3629,5671,2689,10638,10657,2015,58,23395,811,5107,1075,6993,27,723,750
2020-01-22,16,3681,5756,2697,10893,10864,2159,58,24007,635,3543,802,4980,22,706,728
2020-01-22,17,3877,5982,2788,11538,11280,2372,62,25286,220,1095,274,1589,18,673,691
2020-01-22,18,4176,6094,2957,12618,12270,2691,68,27675,0,16,0,16,23,641,664
2020-01-22,19,4220,6012,2953,13018,12523,2773,69,28410,0,0,0,0,33,560,593
2020-01-22,20,4179,5907,2879,12777,12297,2712,68,27883,0,0,0,0,36,429,465
2020-01-22,21,4099,5710,2785,12340,11909,2590,69,26935,0,0,0,0,37,318,355
2020-01-22,22,3944,5422,2628,11693,11344,2453,67,25584,0,0,0,0,47,275,322
2020-01-22,23,3765,5156,2428,10829,10571,2241,65,23733,0,0,0,0,57,264,321
2020-01-22,24,3607,4991,2268,10076,9833,2021,63,22023,0,0,0,0,56,235,291
2020-01-23,1,3492,4865,2119,9411,9229,1925,61,20654,0,0,0,0,45,271,316
2020-01-23,2,3435,4825,2072,9087,8892,1871,62,19941,0,0,0,0,39,194,233
2020-01-23,3,3407,4834,2057,8905,8712,1824,64,19533,0,0,0,0,33,162,195
2020-01-23,4,3426,4920,2085,8880,8676,1812,67,19463,0,0,0,0,30,147,177
2020-01-23,5,3509,5136,2187,9164,8923,1869,72,20056,0,0,0,0,27,144,171
2020-01-23,6,3690,5507,2442,9857,9613,2047,80,21625,0,0,0,0,23,43,66
2020-01-23,7,3928,5824,2784,11194,10639,2317,90,24267,0,9,0,9,16,139,155
2020-01-23,8,3928,5857,2969,11937,10925,2388,90,25369,58,1182,105,1345,13,135,148
2020-01-23,9,3853,5827,2926,11781,10841,2294,83,25029,251,3782,466,4499,12,122,134
2020-01-23,10,3773,5776,2879,11431,10583,2103,74,24221,447,5473,846,6766,12,117,129
2020-01-23,11,3705,5708,2815,11096,10310,1974,67,23476,575,5928,1027,7530,13,121,134
2020-01-23,12,3652,5635,2730,10784,10210,1891,61,22976,647,5968,1081,7696,16,115,131
2020-01-23,13,3611,5621,2676,10614,10219,1873,59,22793,675,5994,1116,7785,18,95,113
2020-01-23,14,3591,5598,2621,10590,10314,1930,57,22921,660,5952,1103,7715,19,76,95
2020-01-23,15,3595,5596,2562,10717,10474,2024,55,23299,588,5510,984,7082,21,59,80
2020-01-23,16,3640,5665,2565,10963,10772,2154,55,23974,422,3852,708,4982,22,47,69
2020-01-23,17,3816,5887,2658,11720,11171,2345,59,25323,140,1214,246,1600,25,43,68
2020-01-23,18,4113,5997,2819,12610,12132,2635,65,27471,0,33,0,33,31,58,89
2020-01-23,19,4162,5918,2823,12941,12431,2766,66,28231,0,0,0,0,40,90,130
2020-01-23,20,4117,5826,2762,12700,12222,2689,65,27704,0,0,0,0,48,107,155
2020-01-23,21,4036,5634,2672,12251,11859,2578,64,26780,0,0,0,0,58,94,152
2020-01-23,22,3881,5361,2524,11629,11322,2392,63,25434,0,0,0,0,73,81,154
2020-01-23,23,3711,5104,2336,10817,10522,2188,60,23615,0,0,0,0,89,87,176
2020-01-23,24,3553,4946,2178,10053,9772,2008,59,21920,0,0,0,0,102,102,204
2020-01-24,1,3441,4870,2038,9481,9268,1940,57,20789,0,0,0,0,125,143,268
2020-01-24,2,3374,4836,1984,9146,8976,1872,58,20099,0,0,0,0,143,214,357
2020-01-24,3,3348,4846,1965,8949,8768,1819,60,19644,0,0,0,0,146,319,465
2020-01-24,4,3365,4928,1987,8920,8711,1808,63,19549,0,0,0,0,147,453,600
2020-01-24,5,3440,5129,2079,9178,8937,1857,68,20086,0,0,0,0,145,601,746
2020-01-24,6,3608,5469,2303,9867,9598,2002,76,21583,0,0,0,0,141,692,833
2020-01-24,7,3836,5782,2624,11035,10631,2261,86,24060,0,9,0,9,140,733,873
2020-01-24,8,3846,5834,2823,11685,10814,2321,86,24935,85,984,118,1187,132,780,912
2020-01-24,9,3796,5808,2808,11539,10674,2205,78,24524,363,3217,502,4082,118,793,911
2020-01-24,10,3733,5760,2775,10994,10417,2048,69,23562,622,4795,892,6309,104,767,871
2020-01-24,11,3672,5696,2721,10530,10198,1910,61,22737,755,5259,1061,7075,77,882,959
2020-01-24,12,3622,5622,2644,10151,10050,1833,56,22141,809,5289,1108,7206,58,1136,1194
2020-01-24,13,3591,5595,2585,9923,10016,1802,52,21847,839,5381,1143,7363,58,1383,1441
2020-01-24,14,3581,5567,2529,9925,10112,1836,51,21986,861,5387,1132,7380,49,1574,1623
2020-01-24,15,3596,5550,2482,10053,10198,1904,49,22249,831,4891,1050,6772,40,1630,1670
2020-01-24,16,3650,5609,2478,10393,10440,2022,49,22957,657,3413,772,4842,35,1497,1532
2020-01-24,17,3804,5810,2561,11198,10788,2207,53,24297,251,1117,276,1644,34,1425,1459
2020-01-24,18,4072,5904,2708,12254,11702,2488,60,26534,2,31,3,36,39,1490,1529
2020-01-24,19,4099,5803,2702,12494,11922,2601,61,27117,0,0,0,0,42,1552,1594
2020-01-24,20,4047,5679,2629,12226,11660,2542,60,26524,0,0,0,0,41,1583,1624
2020-01-24,21,3971,5508,2540,11803,11292,2444,58,25625,0,0,0,0,39,1463,1502
2020-01-24,22,3856,5300,2417,11311,10942,2333,58,24675,0,0,0,0,39,1228,1267
2020-01-24,23,3742,5085,2265,10596,10316,2175,56,23181,0,0,0,0,43,996,1039
2020-01-24,24,3594,4919,2128,9929,9645,2017,56,21685,0,0,0,0,47,822,869
2020-01-25,1,3485,4773,2035,9432,9259,1923,57,20699,0,0,0,0,70,944,1014
2020-01-25,2,3402,4726,1981,9049,8861,1850,58,19853,0,0,0,0,63,833,896
2020-01-25,3,3363,4717,1962,8800,8599,1794,60,19293,0,0,0,0,53,771,824
2020-01-25,4,3354,4755,1968,8698,8465,1775,62,19036,0,0,0,0,48,672,720
2020-01-25,5,3382,4844,2015,8748,8537,1787,65,19178,0,0,0,0,44,562,606
2020-01-25,6,3463,4989,2119,9040,8850,1834,70,19834,0,0,0,0,38,534,572
2020-01-25,7,3544,5156,2262,9569,9279,1953,78,20919,0,6,0,6,42,519,561
2020-01-25,8,3531,5293,2420,10060,9314,1968,80,21483,80,1087,97,1264,40,360,400
2020-01-25,9,3552,5356,2537,10185,9352,1904,74,21563,350,3579,471,4400,26,153,179
2020-01-25,10,3549,5354,2587,10112,9124,1776,66,21109,590,5213,889,6692,18,65,83
2020-01-25,11,3519,5308,2558,9879,8976,1647,59,20589,667,5643,1105,7415,14,44,58
2020-01-25,12,3482,5247,2491,9540,8909,1557,55,20098,694,5712,1182,7588,15,45,60
2020-01-25,13,3449,5210,2417,9397,8914,1506,52,19897,731,5768,1206,7705,17,44,61
2020-01-25,14,3432,5182,2343,9349,8962,1513,50,19905,747,5750,1191,7688,18,40,58
2020-01-25,15,3446,5182,2282,9476,9123,1570,49,20248,693,5339,1097,7129,16,31,47
2020-01-25,16,3499,5270,2297,9824,9394,1713,50,21010,494,3711,782,4987,17,27,44
2020-01-25,17,3675,5491,2393,10466,9919,1935,54,22408,189,1155,297,1641,21,39,60
2020-01-25,18,3969,5656,2538,11409,10791,2254,62,24545,17,28,27,72,33,59,92
2020-01-25,19,3992,5609,2525,11808,11085,2422,63,25405,0,0,0,0,59,78,137
2020-01-25,20,3928,5521,2461,11567,10882,2402,61,24940,0,0,0,0,85,85,170
2020-01-25,21,3851,5389,2380,11167,10577,2304,59,24135,0,0,0,0,109,89,198
2020-01-25,22,3744,5206,2276,10681,10201,2214,57,23180,0,0,0,0,130,105,235
2020-01-25,23,3650,4991,2146,10145,9732,2075,56,22035,0,0,0,0,149,122,271
2020-01-25,24,3512,4826,2025,9539,9174,1943,55,20737,0,0,0,0,173,162,335
2020-01-26,1,3402,4727,1895,9018,8832,1895,55,19827,0,0,0,0,184,130,314
2020-01-26,2,3320,4686,1847,8653,8476,1826,56,19039,0,0,0,0,237,204,441
2020-01-26,3,3276,4676,1829,8432,8225,1772,57,18513,0,0,0,0,259,262,521
2020-01-26,4,3266,4707,1835,8308,8094,1737,60,18226,0,0,0,0,263,344,607
2020-01-26,5,3291,4772,1881,8364,8099,1732,64,18286,0,0,0,0,258,466,724
2020-01-26,6,3357,4881,1968,8567,8267,1772,69,18703,0,0,0,0,240,633,873
2020-01-26,7,3428,5030,2100,8987,8550,1856,77,19498,0,8,0,8,221,938,1159
2020-01-26,8,3403,5142,2257,9403,8533,1870,78,19932,33,1041,70,1144,226,1217,1443
2020-01-26,9,3429,5156,2384,9530,8506,1828,74,20010,200,3387,302,3889,255,1309,1564
2020-01-26,10,3444,5140,2448,9515,8376,1716,68,19712,429,4952,529,5910,310,1391,1701
2020-01-26,11,3433,5094,2435,9395,8193,1599,61,19280,583,5378,661,6622,351,1643,1994
2020-01-26,12,3414,5092,2390,9189,8039,1526,57,18851,653,5428,752,6833,363,1982,2345
2020-01-26,13,3402,5068,2341,9046,7987,1525,55,18648,686,5509,785,6980,375,2196,2571
2020-01-26,14,3412,5084,2289,9022,8009,1531,53,18657,721,5411,778,6910,415,2295,2710
2020-01-26,15,3445,5113,2254,9107,8198,1639,51,19042,738,5021,736,6495,464,2383,2847
2020-01-26,16,3523,5256,2267,9400,8473,1788,52,19749,588,3488,545,4621,466,2475,2941
2020-01-26,17,3693,5503,2368,9997,9067,2000,56,21149,264,1074,229,1567,446,2523,2969
2020-01-26,18,3989,5649,2537,11183,10309,2328,64,23911,41,27,32,100,453,2531,2984
2020-01-26,19,3997,5607,2561,11734,10914,2483,64,25223,0,0,0,0,472,2610,3082
2020-01-26,20,3933,5522,2521,11586,10855,2450,63,24981,0,0,0,0,477,2688,3165
2020-01-26,21,3856,5365,2444,11233,10586,2340,60,24247,0,0,0,0,446,2687,3133
2020-01-26,22,3721,5132,2306,10752,10260,2217,58,23316,0,0,0,0,413,2633,3046
2020-01-26,23,3596,4907,2131,10046,9724,2057,56,21910,0,0,0,0,357,2534,2891
2020-01-26,24,3449,4768,1997,9359,9105,1914,55,20461,0,0,0,0,288,2427,2715
2020-01-27,1,3352,4652,1929,9042,8628,1847,53,19598,0,0,0,0,289,2279,2568
2020-01-27,2,3293,4644,1902,8779,8372,1803,54,19035,0,0,0,0,270,2101,2371
2020-01-27,3,3272,4674,1903,8620,8225,1764,56,18695,0,0,0,0,276,1931,2207
2020-01-27,4,3287,4776,1944,8653,8311,1751,58,18806,0,0,0,0,274,1826,2100
2020-01-27,5,3369,5004,2064,8953,8608,1795,63,19447,0,0,0,0,275,1855,2130
2020-01-27,6,3552,5391,2328,9696,9350,1955,71,21100,0,0,0,0,285,1781,2066
2020-01-27,7,3794,5726,2704,10894,10477,2233,81,23714,0,8,0,8,294,1656,1950
2020-01-27,8,3804,5776,2918,11705,10880,2313,82,25019,132,1179,133,1444,295,1651,1946
2020-01-27,9,3759,5756,2884,11504,10684,2185,76,24497,574,3788,600,4962,277,1618,1895
2020-01-27,10,3702,5720,2838,11109,10526,1996,70,23741,936,5466,1060,7462,241,1501,1742
2020-01-27,11,3656,5671,2774,10657,10366,1869,65,22991,995,5895,1242,8132,246,1277,1523
2020-01-27,12,3612,5617,2692,10269,10207,1795,62,22369,970,5952,1294,8216,264,1049,1313
2020-01-27,13,3588,5608,2633,10048,10201,1794,60,22141,970,6113,1316,8399,263,957,1220
2020-01-27,14,3577,5580,2576,10030,10278,1828,58,22229,975,6076,1292,8343,256,1038,1294
2020-01-27,15,3593,5572,2520,10159,10434,1908,56,22594,966,5759,1211,7936,243,1166,1409
2020-01-27,16,3645,5625,2514,10527,10675,2052,57,23344,769,4157,905,5831,249,1215,1464
2020-01-27,17,3815,5846,2608,11295,11058,2234,61,24678,339,1328,382,2049,285,1383,1668
2020-01-27,18,4075,5974,2754,12383,12020,2538,68,27036,45,36,53,134,328,1644,1972
2020-01-27,19,4119,5906,2778,12868,12368,2690,68,28023,0,0,0,0,370,1779,2149
2020-01-27,20,4066,5796,2723,12654,12185,2634,67,27568,0,0,0,0,407,1805,2212
2020-01-27,21,3975,5589,2631,12201,11795,2512,65,26603,0,0,0,0,421,1729,2150
2020-01-27,22,3812,5288,2474,11534,11212,2378,63,25215,0,0,0,0,426,1589,2015
2020-01-27,23,3639,5017,2281,10633,10414,2177,59,23311,0,0,0,0,417,1437,1854
2020-01-27,24,3466,4861,2125,9858,9683,2003,58,21630,0,0,0,0,391,1290,1681
2020-01-28,1,3408,4840,2017,9356,9341,1890,58,20680,0,0,0,0,351,1029,1380
2020-01-28,2,3348,4813,1974,9053,8980,1830,59,19963,0,0,0,0,283,800,1083
2020-01-28,3,3320,4828,1959,8886,8840,1789,62,19616,0,0,0,0,254,670,924
2020-01-28,4,3342,4918,1979,8882,8813,1785,64,19580,0,0,0,0,242,748,990
2020-01-28,5,3423,5138,2073,9152,9083,1844,70,20184,0,0,0,0,217,875,1092
2020-01-28,6,3613,5510,2316,9975,9826,2014,78,21922,0,0,0,0,179,953,1132
2020-01-28,7,3852,5831,2658,11161,10893,2300,87,24468,0,8,0,8,170,987,1157
2020-01-28,8,3868,5862,2844,11941,11201,2351,89,25614,87,1246,78,1411,177,1005,1182
2020-01-28,9,3807,5813,2818,11799,11053,2188,82,25166,401,3867,349,4617,169,978,1147
2020-01-28,10,3735,5756,2777,11457,10819,1997,73,24393,722,5360,663,6745,151,974,1125
2020-01-28,11,3676,5693,2725,11067,10690,1858,66,23721,855,5686,868,7409,138,1090,1228
2020-01-28,12,3627,5624,2659,10710,10601,1779,62,23198,877,5705,982,7564,145,1223,1368
2020-01-28,13,3594,5607,2617,10515,10594,1751,60,22977,886,5801,1069,7756,167,1370,1537
2020-01-28,14,3579,5580,2577,10537,10739,1805,58,23190,907,5691,1116,7714,203,1604,1807
2020-01-28,15,3589,5577,2538,10604,10892,1893,57,23502,912,5350,1075,7337,240,1843,2083
2020-01-28,16,3639,5651,2539,10851,11032,2020,57,24001,734,3911,822,5467,270,1976,2246
2020-01-28,17,3804,5869,2630,11558,11439,2195,61,25297,320,1336,370,2026,305,2051,2356
2020-01-28,18,4090,6003,2778,12560,12245,2490,67,27391,39,66,56,161,345,2097,2442
2020-01-28,19,4147,5935,2802,12932,12527,2642,68,28197,0,0,0,0,364,2138,2502
2020-01-28,20,4108,5830,2753,12752,12276,2602,67,27725,0,0,0,0,372,2202,2574
2020-01-28,21,4023,5621,2659,12293,11883,2497,65,26766,0,0,0,0,340,2274,2614
2020-01-28,22,3863,5323,2501,11646,11327,2336,64,25403,0,0,0,0,267,2332,2599
2020-01-28,23,3690,5059,2310,10860,10619,2131,61,23698,0,0,0,0,202,2380,2582
2020-01-28,24,3529,4901,2160,10077,9864,1959,60,21988,0,0,0,0,157,2420,2577
2020-01-29,1,3472,4858,2099,9634,9497,1922,61,21142,0,0,0,0,179,2280,2459
2020-01-29,2,3414,4829,2060,9348,9257,1860,63,20555,0,0,0,0,130,2229,2359
2020-01-29,3,3385,4840,2051,9157,9131,1814,64,20193,0,0,0,0,94,2203,2297
2020-01-29,4,3403,4920,2082,9124,9087,1803,67,20109,0,0,0,0,72,2191,2263
2020-01-29,5,3487,5142,2191,9398,9337,1859,72,20693,0,0,0,0,83,2122,2205
2020-01-29,6,3661,5511,2444,10145,9959,2025,81,22236,0,0,0,0,113,2002,2115
2020-01-29,7,3879,5829,2802,11386,10955,2297,90,24756,0,7,0,7,118,1845,1963
2020-01-29,8,3881,5861,2995,12017,11342,2364,91,25845,112,1179,95,1386,113,1499,1612
2020-01-29,9,3819,5825,2951,11720,11219,2207,84,25263,445,3840,414,4699,92,988,1080
2020-01-29,10,3750,5778,2891,11209,10926,2030,77,24271,690,5535,733,6958,89,614,703
2020-01-29,11,3702,5725,2818,10769,10688,1895,70,23451,736,5949,893,7578,104,491,595
2020-01-29,12,3665,5662,2736,10380,10527,1825,66,22827,749,5989,966,7704,119,554,673
2020-01-29,13,3643,5650,2675,10139,10503,1803,64,22536,783,6105,1029,7917,130,674,804
2020-01-29,14,3640,5628,2620,10092,10614,1838,62,22633,806,6014,1064,7884,119,758,877
2020-01-29,15,3653,5637,2578,10266,10779,1920,61,23052,792,5675,1003,7470,113,798,911
2020-01-29,16,3721,5711,2566,10674,10970,2066,61,23799,647,4181,755,5583,129,771,900
2020-01-29,17,3897,5913,2636,11414,11291,2238,65,25035,306,1526,337,2169,127,775,902
2020-01-29,18,4178,6041,2804,12232,12070,2533,71,26934,44,112,51,207,139,847,986
2020-01-29,19,4236,5973,2834,12688,12425,2677,72,27889,0,0,0,0,150,852,1002
2020-01-29,20,4192,5867,2779,12494,12246,2629,73,27469,0,0,0,0,150,718,868
2020-01-29,21,4100,5671,2688,12089,11862,2503,72,26554,0,0,0,0,160,529,689
2020-01-29,22,3936,5378,2537,11481,11402,2351,71,25332,0,0,0,0,172,416,588
2020-01-29,23,3748,5114,2342,10682,10623,2151,68,23551,0,0,0,0,174,370,544
2020-01-29,24,3582,4959,2186,9932,9831,1986,66,21842,0,0,0,0,167,362,529
2020-01-30,1,3479,4891,2102,9487,9570,1964,62,21110,0,0,0,0,142,321,463
2020-01-30,2,3416,4861,2062,9181,9255,1906,63,20432,0,0,0,0,132,300,432
2020-01-30,3,3389,4876,2052,9010,9062,1850,65,20017,0,0,0,0,104,318,422
2020-01-30,4,3410,4965,2080,8986,9049,1830,69,19966,0,0,0,0,78,376,454
2020-01-30,5,3495,5180,2188,9265,9248,1884,74,20500,0,0,0,0,66,358,424
2020-01-30,6,3683,5547,2446,10008,9967,2048,83,22133,0,0,0,0,51,289,340
2020-01-30,7,3920,5860,2814,11205,11045,2315,94,24690,0,10,0,10,40,252,292
2020-01-30,8,3927,5887,2994,11828,11306,2351,93,25622,118,1245,142,1505,36,227,263
2020-01-30,9,3862,5855,2943,11509,11032,2163,84,24825,500,3877,592,4969,35,203,238
2020-01-30,10,3782,5800,2875,10949,10657,1972,74,23681,808,5493,997,7298,29,154,183
2020-01-30,11,3711,5736,2789,10465,10396,1851,66,22806,872,5893,1129,7894,20,110,130
2020-01-30,12,3654,5665,2696,10063,10269,1792,60,22215,872,5926,1154,7952,20,94,114
2020-01-30,13,3615,5654,2629,9862,10251,1777,57,21975,889,6084,1178,8151,20,83,103
2020-01-30,14,3598,5630,2568,9886,10376,1815,55,22164,885,5982,1156,8023,15,78,93
2020-01-30,15,3603,5627,2518,10066,10567,1930,54,22665,856,5574,1072,7502,14,81,95
2020-01-30,16,3647,5697,2500,10481,10963,2112,54,23639,710,4027,811,5548,16,78,94
2020-01-30,17,3820,5889,2565,11127,11393,2351,57,24956,346,1414,365,2125,22,76,98
2020-01-30,18,4103,6016,2731,12118,12325,2639,64,27174,49,95,58,202,29,100,129
2020-01-30,19,4166,5950,2773,12632,12646,2724,65,28095,0,0,0,0,38,159,197
2020-01-30,20,4127,5851,2726,12441,12517,2655,64,27705,0,0,0,0,43,212,255
2020-01-30,21,4048,5656,2645,11985,12135,2550,64,26762,0,0,0,0,48,232,280
2020-01-30,22,3898,5380,2496,11369,11685,2417,63,25561,0,0,0,0,59,264,323
2020-01-30,23,3732,5124,2311,10543,10862,2213,60,23706,0,0,0,0,62,306,368
2020-01-30,24,3572,4978,2159,9810,10022,2038,59,21957,0,0,0,0,50,331,381
2020-01-31,1,3477,4901,2024,9417,9511,1940,60,20956,0,0,0,0,32,325,357
2020-01-31,2,3415,4881,1974,9095,9144,1882,61,20211,0,0,0,0,22,320,342
2020-01-31,3,3391,4896,1960,8892,8914,1836,64,19734,0,0,0,0,13,319,332
2020-01-31,4,3412,4984,1986,8845,8810,1820,67,19571,0,0,0,0,11,313,324
2020-01-31,5,3495,5193,2081,9092,9053,1870,72,20115,0,0,0,0,9,307,316
2020-01-31,6,3670,5538,2311,9785,9709,2023,81,21626,0,0,0,0,7,301,308
2020-01-31,7,3887,5833,2636,10985,10724,2278,91,24105,0,14,0,14,7,295,302
2020-01-31,8,3886,5865,2817,11652,11052,2310,91,25134,116,1320,155,1591,7,293,300
2020-01-31,9,3828,5827,2780,11299,10803,2125,82,24365,484,4110,639,5233,7,282,289
2020-01-31,10,3761,5754,2729,10724,10513,1935,72,23292,788,5775,1076,7639,8,267,275
2020-01-31,11,3685,5664,2656,10244,10336,1837,64,22509,860,6141,1231,8232,7,260,267
2020-01-31,12,3621,5570,2568,9813,10234,1796,59,21938,855,6182,1260,8297,8,250,258
2020-01-31,13,3579,5529,2493,9585,10200,1801,55,21672,863,6307,1281,8451,10,234,244
2020-01-31,14,3565,5496,2439,9597,10389,1852,54,21919,862,6222,1261,8345,12,209,221
2020-01-31,15,3572,5478,2395,9741,10587,1966,52,22376,853,5866,1188,7907,15,179,194
2020-01-31,16,3621,5519,2386,10144,10765,2153,52,23142,713,4393,913,6019,15,150,165
2020-01-31,17,3778,5710,2448,10762,11126,2364,56,24349,347,1693,414,2454,17,124,141
2020-01-31,18,4036,5837,2555,11752,11883,2612,63,26337,55,158,67,280,19,114,133
2020-01-31,19,4088,5760,2588,12221,12271,2648,64,27231,0,0,0,0,21,118,139
2020-01-31,20,4044,5636,2530,11970,11982,2562,64,26604,0,0,0,0,23,122,145
2020-01-31,21,3970,5470,2452,11505,11576,2447,64,25620,0,0,0,0,21,121,142
2020-01-31,22,3860,5260,2336,10970,11182,2338,64,24581,0,0,0,0,21,119,140
2020-01-31,23,3747,5048,2191,10346,10568,2183,61,23186,0,0,0,0,23,118,141
2020-01-31,24,3601,4895,2056,9745,9884,2024,60,21740,0,0,0,0,24,119,143
2020-02-01,1,3483,4821,1953,9458,9328,1929,59,20806,0,0,0,0,28,83,111
2020-02-01,2,3409,4786,1895,9095,8926,1847,60,19960,0,0,0,0,29,81,110
2020-02-01,3,3378,4781,1865,8905,8667,1792,62,19459,0,0,0,0,29,86,115
2020-02-01,4,3373,4824,1866,8764,8547,1757,65,19164,0,0,0,0,32,98,130
2020-02-01,5,3405,4916,1910,8835,8647,1772,70,19352,0,0,0,0,37,112,149
2020-02-01,6,3489,5064,2010,9149,8908,1836,76,19996,0,0,0,0,38,129,167
2020-02-01,7,3576,5216,2170,9714,9225,1939,85,20990,0,18,0,18,38,143,181
2020-02-01,8,3538,5336,2327,10017,9208,1912,84,21252,135,1443,189,1767,40,151,191
2020-02-01,9,3545,5389,2424,9992,9082,1792,76,20986,548,4395,747,5690,41,142,183
2020-02-01,10,3530,5377,2458,9691,8871,1652,67,20309,870,6109,1197,8176,36,131,167
2020-02-01,11,3497,5325,2441,9112,8775,1567,60,19541,936,6479,1335,8750,32,134,166
2020-02-01,12,3441,5248,2386,8816,8798,1528,56,19225,937,6501,1376,8814,38,135,173
2020-02-01,13,3392,5189,2326,8639,8853,1526,53,19100,954,6537,1389,8880,49,132,181
2020-02-01,14,3371,5138,2269,8588,9013,1587,51,19266,974,6489,1370,8833,56,128,184
2020-02-01,15,3381,5108,2231,8776,9339,1710,50,19902,1001,6194,1319,8514,58,121,179
2020-02-01,16,3429,5188,2235,9169,9618,1937,50,20801,851,4714,1037,6602,59,107,166
2020-02-01,17,3544,5344,2310,10137,10069,2161,54,22457,424,1999,498,2921,62,90,152
2020-02-01,18,3857,5554,2439,10940,10759,2406,60,24192,76,261,92,429,64,88,152
2020-02-01,19,3943,5564,2457,11494,11328,2496,62,25408,0,0,0,0,72,98,170
2020-02-01,20,3860,5502,2401,11265,11066,2426,61,24845,0,0,0,0,104,94,198
2020-02-01,21,3811,5383,2345,10947,10770,2330,60,24134,0,0,0,0,167,78,245
2020-02-01,22,3719,5193,2253,10550,10425,2235,58,23297,0,0,0,0,231,66,297
2020-02-01,23,3631,4987,2125,10039,9990,2093,56,22205,0,0,0,0,278,63,341
2020-02-01,24,3495,4817,2019,9478,9422,1952,54,20935,0,0,0,0,323,65,388
2020-02-02,1,3433,4678,1995,9332,8958,1884,57,20258,0,0,0,0,323,47,370
2020-02-02,2,3362,4638,1959,8989,8605,1795,58,19474,0,0,0,0,337,35,372
2020-02-02,3,3319,4629,1943,8771,8344,1745,60,18947,0,0,0,0,356,28,384
2020-02-02,4,3302,4659,1957,8650,8165,1712,63,18617,0,0,0,0,452,44,496
2020-02-02,5,3327,4719,2012,8682,8179,1718,67,18673,0,0,0,0,559,83,642
2020-02-02,6,3393,4834,2122,8897,8396,1756,73,19150,0,0,0,0,610,160,770
2020-02-02,7,3461,4970,2286,9269,8704,1834,82,19916,0,21,0,21,646,300,946
2020-02-02,8,3425,5066,2492,9503,8509,1806,80,19929,78,1467,156,1701,690,481,1171
2020-02-02,9,3441,5087,2623,9591,8381,1692,73,19780,319,4396,597,5312,749,642,1391
2020-02-02,10,3464,5078,2670,9555,8220,1554,65,19424,566,6055,952,7573,839,747,1586
2020-02-02,11,3451,5043,2654,9299,8055,1461,59,18904,726,6383,1066,8175,892,954,1846
2020-02-02,12,3458,5045,2602,8995,7860,1421,56,18366,816,6362,1098,8276,898,1422,2320
2020-02-02,13,3460,5023,2536,8831,7949,1434,54,18304,890,6334,1134,8358,916,2017,2933
2020-02-02,14,3454,5038,2474,8736,8119,1478,52,18419,955,6160,1118,8233,890,2432,3322
2020-02-02,15,3491,5073,2427,8837,8346,1601,50,18864,983,5777,1059,7819,814,2572,3386
2020-02-02,16,3576,5182,2432,9178,8688,1816,51,19762,837,4313,824,5974,746,2597,3343
2020-02-02,17,3708,5344,2506,10056,9222,2027,54,21398,423,1754,385,2562,760,2662,3422
2020-02-02,18,4028,5547,2661,11243,10214,2330,60,23876,75,205,68,348,793,2765,3558
2020-02-02,19,4084,5548,2711,11993,11004,2498,62,25585,0,0,0,0,779,2834,3613
2020-02-02,20,4005,5482,2686,11935,10882,2444,62,25354,0,0,0,0,707,2853,3560
2020-02-02,21,3886,5339,2615,11676,10646,2349,60,24774,0,0,0,0,577,2802,3379
2020-02-02,22,3754,5115,2480,11174,10267,2234,57,23770,0,0,0,0,459,2680,3139
2020-02-02,23,3637,4891,2300,10487,9705,2073,54,22346,0,0,0,0,371,2547,2918
2020-02-02,24,3505,4776,2175,9818,9159,1929,54,20987,0,0,0,0,309,2403,2712
2020-02-03,1,3488,4717,2220,9671,8858,1858,64,20478,0,0,0,0,153,2387,2540
2020-02-03,2,3429,4719,2208,9396,8617,1797,66,19903,0,0,0,0,141,2227,2368
2020-02-03,3,3401,4756,2222,9296,8522,1761,68,19674,0,0,0,0,158,2087,2245
2020-02-03,4,3415,4864,2281,9349,8561,1748,70,19755,0,0,0,0,190,1988,2178
2020-02-03,5,3493,5101,2416,9699,8886,1796,76,20484,0,0,0,0,236,1932,2168
2020-02-03,6,3689,5497,2706,10501,9635,1946,84,22194,0,0,0,0,341,1907,2248
2020-02-03,7,3924,5837,3098,11821,10763,2207,96,24913,0,20,0,20,504,1763,2267
2020-02-03,8,3952,5888,3313,12535,11076,2303,98,26048,209,1200,197,1606,606,1452,2058
2020-02-03,9,3932,5865,3249,11901,10877,2245,92,25146,780,3490,761,5031,674,1033,1707
2020-02-03,10,3922,5859,3161,11101,10514,2186,85,23915,1145,4856,1212,7213,787,712,1499
2020-02-03,11,3928,5859,3061,10539,10152,2117,81,22917,1161,5280,1351,7792,909,524,1433
2020-02-03,12,3901,5824,2952,10087,9951,2056,78,22201,1124,5383,1393,7900,931,452,1383
2020-02-03,13,3879,5811,2872,9852,9819,2013,73,21791,1118,5451,1420,7989,931,508,1439
2020-02-03,14,3854,5774,2801,9827,9921,2026,70,21871,1124,5405,1419,7948,924,588,1512
2020-02-03,15,3855,5767,2761,9975,9989,2083,69,22148,1144,5094,1379,7617,922,655,1577
2020-02-03,16,3903,5803,2765,10437,10204,2202,70,22946,992,3927,1112,6031,924,727,1651
2020-02-03,17,4023,5936,2835,11470,10735,2366,77,24679,521,1732,561,2814,912,802,1714
2020-02-03,18,4318,6110,2991,12590,11745,2624,86,27073,99,222,109,430,910,822,1732
2020-02-03,19,4455,6079,3069,13337,12278,2756,92,28490,0,0,0,0,945,798,1743
2020-02-03,20,4423,5974,3028,13202,12162,2685,92,28168,0,0,0,0,983,719,1702
2020-02-03,21,4333,5770,2946,12854,11893,2581,88,27444,0,0,0,0,994,574,1568
2020-02-03,22,4160,5468,2791,12208,11476,2445,85,26242,0,0,0,0,983,491,1474
2020-02-03,23,3935,5200,2588,11253,10752,2235,82,24349,0,0,0,0,967,492,1459
2020-02-03,24,3766,5064,2436,10463,10082,2058,80,22711,0,0,0,0,961,501,1462
2020-02-04,1,3744,5089,2403,9982,9569,1987,85,21655,0,0,0,0,979,380,1359
2020-02-04,2,3702,5091,2378,9652,9251,1917,87,20939,0,0,0,0,958,352,1310
2020-02-04,3,3698,5115,2382,9518,9066,1875,89,20581,0,0,0,0,945,338,1283
2020-02-04,4,3729,5213,2429,9540,9000,1867,93,20533,0,0,0,0,956,316,1272
2020-02-04,5,3829,5444,2556,9850,9297,1933,99,21213,0,0,0,0,962,276,1238
2020-02-04,6,4015,5832,2842,10608,10078,2111,108,22932,0,0,0,0,947,251,1198
2020-02-04,7,4248,6132,3241,11911,11228,2396,119,25683,0,36,0,36,919,224,1143
2020-02-04,8,4225,6138,3442,12546,11306,2435,116,26430,215,1654,235,2104,877,192,1069
2020-02-04,9,4120,6059,3344,11955,11099,2225,109,25427,786,4767,876,6429,783,221,1004
2020-02-04,10,4014,5964,3223,11116,10615,1999,99,23860,1141,6437,1340,8918,733,331,1064
2020-02-04,11,3933,5864,3102,10461,10229,1842,92,22659,1153,6743,1448,9344,746,449,1195
2020-02-04,12,3862,5755,2981,9950,9947,1752,86,21775,1111,6716,1460,9287,678,519,1197
2020-02-04,13,3811,5709,2899,9655,9742,1709,82,21231,1096,6679,1459,9234,529,518,1047
2020-02-04,14,3781,5659,2833,9616,9746,1724,78,21201,1089,6574,1426,9089,399,483,882
2020-02-04,15,3767,5650,2771,9757,9889,1823,77,21605,1090,6234,1360,8684,317,450,767
2020-02-04,16,3818,5712,2775,10135,10115,2023,75,22396,947,4861,1092,6900,243,425,668
2020-02-04,17,3986,5855,2845,11024,10875,2261,81,24279,508,2210,553,3271,183,384,567
2020-02-04,18,4334,6080,2996,12250,11916,2586,90,26870,99,310,105,514,149,372,521
2020-02-04,19,4485,6085,3068,13047,12478,2770,96,28419,0,0,0,0,134,344,478
2020-02-04,20,4461,6012,3024,12947,12376,2732,97,28180,0,0,0,0,121,285,406
2020-02-04,21,4394,5828,2942,12639,12200,2658,97,27622,0,0,0,0,120,260,380
2020-02-04,22,4235,5540,2786,12048,11742,2529,95,26441,0,0,0,0,126,286,412
2020-02-04,23,4012,5282,2581,11148,11067,2325,91,24662,0,0,0,0,127,315,442
2020-02-04,24,3847,5145,2412,10383,10336,2145,89,22988,0,0,0,0,120,310,430
2020-02-05,1,3795,5183,2295,10465,10294,2051,86,22923,0,0,0,0,95,276,371
2020-02-05,2,3742,5182,2258,10120,9985,1983,88,22203,0,0,0,0,76,266,342
2020-02-05,3,3732,5197,2251,9965,9869,1947,90,21899,0,0,0,0,66,256,322
2020-02-05,4,3762,5288,2285,9970,9886,1942,94,21919,0,0,0,0,63,252,315
2020-02-05,5,3851,5510,2395,10292,10217,2009,100,22646,0,0,0,0,74,245,319
2020-02-05,6,4050,5889,2656,11130,10970,2228,110,24458,0,0,0,0,99,236,335
2020-02-05,7,4267,6184,3024,12448,12019,2547,121,27156,0,43,0,43,107,217,324
2020-02-05,8,4236,6190,3190,13055,12340,2593,117,28126,187,1519,175,1881,89,177,266
2020-02-05,9,4119,6116,3114,12137,12000,2366,107,26637,691,4226,660,5577,65,134,199
2020-02-05,10,3999,6011,3019,11135,11431,2082,95,24772,1053,5688,1064,7805,47,92,139
2020-02-05,11,3890,5898,2920,10276,10921,1880,85,23189,1133,6026,1221,8380,38,71,109
2020-02-05,12,3793,5791,2816,9817,10590,1780,76,22291,1127,6071,1280,8478,29,79,108
2020-02-05,13,3736,5744,2747,9568,10457,1750,70,21872,1122,6015,1311,8448,18,103,121
2020-02-05,14,3705,5705,2686,9619,10419,1787,65,21918,1119,5833,1300,8252,11,148,159
2020-02-05,15,3687,5700,2639,9766,10469,1905,61,22234,1119,5454,1247,7820,9,211,220
2020-02-05,16,3737,5756,2642,10173,10725,2090,61,23076,948,4202,994,6144,8,317,325
2020-02-05,17,3896,5905,2697,11043,11289,2312,65,24737,481,1881,498,2860,10,475,485
2020-02-05,18,4229,6119,2846,12358,12353,2647,72,27457,88,245,98,431,16,715,731
2020-02-05,19,4390,6113,2917,13311,13031,2803,81,29253,0,0,0,0,26,1025,1051
2020-02-05,20,4369,6029,2869,13254,12950,2756,84,29072,0,0,0,0,34,1258,1292
2020-02-05,21,4311,5850,2790,12959,12726,2680,85,28478,0,0,0,0,39,1347,1386
2020-02-05,22,4160,5560,2640,12320,12263,2548,84,27242,0,0,0,0,40,1296,1336
2020-02-05,23,3957,5287,2451,11427,11434,2340,80,25308,0,0,0,0,39,1134,1173
2020-02-05,24,3794,5115,2283,10641,10756,2148,77,23650,0,0,0,0,37,980,1017
2020-02-06,1,3729,5045,2142,10193,10238,2055,72,22577,0,0,0,0,49,628,677
2020-02-06,2,3665,5030,2092,9824,9931,1985,72,21832,0,0,0,0,50,616,666
2020-02-06,3,3637,5035,2079,9633,9716,1943,74,21386,0,0,0,0,50,630,680
2020-02-06,4,3652,5116,2107,9619,9664,1935,77,21315,0,0,0,0,53,615,668
2020-02-06,5,3736,5336,2205,9920,9872,1996,82,21890,0,0,0,0,54,567,621
2020-02-06,6,3922,5700,2460,10716,10547,2190,91,23564,0,0,0,0,53,485,538
2020-02-06,7,4132,5992,2821,12013,11672,2495,102,26301,0,39,0,39,54,365,419
2020-02-06,8,4082,6015,2997,12636,11993,2528,98,27275,232,1552,226,2010,53,244,297
2020-02-06,9,3981,5967,2930,12079,11676,2316,89,26180,849,4452,844,6145,46,136,182
2020-02-06,10,3881,5884,2866,11159,11122,2061,81,24443,1233,6043,1301,8577,35,67,102
2020-02-06,11,3800,5783,2791,10420,10822,1860,72,23198,1222,6402,1420,9044,29,44,73
2020-02-06,12,3726,5697,2701,10031,10490,1782,67,22394,1174,6468,1453,9095,27,46,73
2020-02-06,13,3670,5674,2644,9914,10295,1764,63,22058,1164,6496,1459,9119,20,60,80
2020-02-06,14,3640,5653,2588,9901,10314,1798,61,22103,1172,6461,1432,9065,12,90,102
2020-02-06,15,3624,5658,2546,10087,10422,1895,58,22494,1197,6184,1384,8765,7,146,153
2020-02-06,16,3656,5706,2536,10448,10702,2072,57,23312,1033,4793,1111,6937,5,231,236
2020-02-06,17,3785,5823,2579,11040,11235,2295,59,24658,547,2163,567,3277,6,367,373
2020-02-06,18,4094,6019,2718,12442,12188,2620,65,27335,111,330,117,558,8,616,624
2020-02-06,19,4255,6000,2795,13267,12847,2772,68,28974,0,9,0,9,11,877,888
2020-02-06,20,4234,5902,2751,13168,12771,2708,69,28736,0,10,0,10,17,894,911
2020-02-06,21,4171,5721,2675,12856,12514,2618,70,28078,0,0,0,0,26,719,745
2020-02-06,22,4023,5450,2536,12252,11990,2482,68,26812,0,0,0,0,32,545,577
2020-02-06,23,3842,5184,2350,11352,11295,2272,65,25004,0,0,0,0,29,394,423
2020-02-06,24,3682,5009,2191,10586,10558,2089,63,23317,0,0,0,0,22,265,287
2020-02-07,1,3580,4916,2025,9992,9886,2017,57,21963,0,0,0,0,37,183,220
2020-02-07,2,3516,4884,1970,9656,9532,1947,58,21197,0,0,0,0,25,166,191
2020-02-07,3,3488,4883,1949,9466,9331,1903,61,20760,0,0,0,0,19,164,183
2020-02-07,4,3500,4958,1972,9473,9224,1889,64,20651,0,0,0,0,15,167,182
2020-02-07,5,3573,5170,2057,9754,9478,1948,69,21250,0,0,0,0,12,159,171
2020-02-07,6,3745,5494,2286,10472,10175,2123,78,22848,0,0,0,0,9,136,145
2020-02-07,7,3965,5785,2631,11827,11199,2397,87,25515,0,53,0,53,8,112,120
2020-02-07,8,3926,5839,2829,12436,11565,2429,85,26534,241,1689,242,2172,9,91,100
2020-02-07,9,3855,5830,2790,11919,11314,2254,76,25582,870,4708,883,6461,10,54,64
2020-02-07,10,3788,5784,2742,11161,10924,2034,67,24206,1255,6340,1339,8934,10,28,38
2020-02-07,11,3729,5719,2679,10554,10662,1869,61,23166,1271,6688,1451,9410,8,24,32
2020-02-07,12,3676,5648,2601,10108,10378,1752,56,22314,1229,6695,1480,9404,6,23,29
2020-02-07,13,3626,5631,2536,9820,10171,1734,54,21799,1223,6700,1483,9406,5,22,27
2020-02-07,14,3594,5612,2480,9897,10196,1765,52,21932,1234,6660,1459,9353,5,23,28
2020-02-07,15,3587,5613,2416,10105,10316,1851,51,22349,1257,6408,1412,9077,6,28,34
2020-02-07,16,3612,5634,2390,10481,10500,2016,52,23071,1095,5041,1143,7279,8,44,52
2020-02-07,17,3709,5735,2434,11130,10826,2225,53,24255,591,2318,595,3504,16,93,109
2020-02-07,18,3976,5911,2557,12150,11556,2534,59,26318,121,368,126,615,31,195,226
2020-02-07,19,4113,5861,2622,12736,12189,2676,61,27681,0,11,0,11,55,320,375
2020-02-07,20,4079,5727,2563,12543,11920,2592,61,27135,0,13,0,13,85,405,490
2020-02-07,21,4017,5563,2491,12151,11609,2505,59,26344,0,0,0,0,111,421,532
2020-02-07,22,3901,5360,2379,11662,11208,2403,58,25343,0,0,0,0,133,396,529
2020-02-07,23,3762,5140,2231,10968,10681,2240,55,23954,0,0,0,0,155,393,548
2020-02-07,24,3621,4963,2103,10218,10015,2075,55,22373,0,0,0,0,167,405,572
2020-02-08,1,3516,4852,2068,9627,9485,1983,57,21161,0,0,0,0,132,291,423
2020-02-08,2,3435,4805,2023,9251,9090,1904,58,20307,0,0,0,0,139,334,473
2020-02-08,3,3399,4793,2000,9025,8835,1852,61,19773,0,0,0,0,142,482,624
2020-02-08,4,3385,4828,2011,8961,8728,1821,64,19574,0,0,0,0,131,672,803
2020-02-08,5,3414,4916,2059,9082,8871,1843,68,19864,0,0,0,0,119,859,978
2020-02-08,6,3493,5067,2170,9446,9178,1910,74,20608,0,0,0,0,110,1088,1198
2020-02-08,7,3574,5226,2336,10099,9547,2048,83,21777,0,64,0,64,94,1330,1424
2020-02-08,8,3556,5355,2513,10511,9588,2046,82,22227,234,1738,247,2219,73,1477,1550
2020-02-08,9,3565,5441,2611,10138,9361,1926,73,21498,840,4749,897,6486,59,1420,1479
2020-02-08,10,3562,5460,2640,9554,9121,1752,65,20492,1220,6335,1351,8906,52,1315,1367
2020-02-08,11,3532,5435,2611,8961,8983,1615,58,19618,1249,6657,1460,9366,57,1413,1470
2020-02-08,12,3479,5397,2546,8590,8727,1539,55,18911,1213,6655,1488,9356,66,1674,1740
2020-02-08,13,3440,5364,2484,8350,8575,1497,52,18475,1209,6660,1492,9361,78,1953,2031
2020-02-08,14,3419,5348,2422,8315,8585,1504,51,18457,1222,6605,1461,9288,96,2149,2245
2020-02-08,15,3425,5369,2383,8419,8664,1596,50,18732,1235,6320,1408,8963,106,2245,2351
2020-02-08,16,3493,5439,2393,8758,8976,1786,49,19580,1068,4975,1139,7182,111,2278,2389
2020-02-08,17,3600,5582,2455,9794,9472,2008,54,21344,577,2316,591,3484,130,2295,2425
2020-02-08,18,3896,5793,2566,10975,10505,2340,60,23900,119,384,125,628,162,2315,2477
2020-02-08,19,3999,5786,2614,11699,11257,2513,63,25550,0,9,0,9,204,2281,2485
2020-02-08,20,3926,5681,2563,11509,11052,2457,62,25099,0,8,0,8,301,2236,2537
2020-02-08,21,3869,5549,2502,11251,10785,2376,60,24491,0,0,0,0,472,2255,2727
2020-02-08,22,3771,5368,2405,10931,10429,2285,58,23714,0,0,0,0,711,2330,3041
2020-02-08,23,3655,5155,2274,10384,10001,2143,55,22592,0,0,0,0,934,2401,3335
2020-02-08,24,3533,4990,2160,9817,9486,2004,53,21370,0,0,0,0,1047,2419,3466
2020-02-09,1,3503,4812,2090,9316,9333,1937,58,20654,0,0,0,0,1218,2394,3612
2020-02-09,2,3439,4781,2058,9022,9060,1860,59,20005,0,0,0,0,1229,2343,3572
2020-02-09,3,3394,4778,2052,8801,8795,1802,61,19458,0,0,0,0,1232,2189,3421
2020-02-09,4,3381,4812,2075,8698,8661,1772,63,19195,0,0,0,0,1233,1883,3116
2020-02-09,5,3401,4881,2141,8778,8648,1776,67,19269,0,0,0,0,1234,1439,2673
2020-02-09,6,3462,5004,2259,9032,8808,1821,73,19735,0,0,0,0,1235,1068,2303
2020-02-09,7,3521,5150,2436,9432,9084,1918,81,20515,0,61,0,61,1237,981,2218
2020-02-09,8,3506,5260,2626,9647,9106,1990,82,20826,230,1318,223,1771,1239,934,2173
2020-02-09,9,3540,5265,2717,9349,9126,2032,79,20586,823,3443,800,5066,1237,896,2133
2020-02-09,10,3584,5252,2715,8780,9046,2038,72,19936,1181,4657,1203,7041,1235,1158,2393
2020-02-09,11,3588,5218,2640,8276,8943,2021,67,19308,1193,5042,1306,7541,1236,1445,2681
2020-02-09,12,3576,5199,2542,7933,8810,1993,64,18801,1153,5168,1327,7648,1234,1500,2734
2020-02-09,13,3575,5166,2458,7790,8764,1966,62,18582,1148,5183,1308,7639,1230,1483,2713
2020-02-09,14,3580,5168,2378,7800,8710,1985,61,18558,1155,4979,1239,7373,1225,1495,2720
2020-02-09,15,3607,5191,2318,8026,8809,1994,60,18893,1171,4480,1163,6814,1213,1509,2722
2020-02-09,16,3645,5273,2312,8559,9061,2065,61,19756,1032,3237,917,5186,1191,1462,2653
2020-02-09,17,3753,5405,2394,9399,9657,2204,64,21333,573,1347,457,2377,1155,1353,2508
2020-02-09,18,4022,5638,2564,10730,10694,2456,72,23971,122,174,93,389,1111,1237,2348
2020-02-09,19,4156,5658,2680,11569,11449,2601,77,25715,0,0,0,0,1075,1155,2230
2020-02-09,20,4136,5591,2679,11478,11424,2564,77,25562,0,0,0,0,1045,1070,2115
2020-02-09,21,4095,5456,2626,11255,11059,2469,75,24877,0,0,0,0,1027,974,2001
2020-02-09,22,3959,5233,2498,10839,10623,2350,72,23895,0,0,0,0,1012,903,1915
2020-02-09,23,3786,5021,2325,10182,10047,2180,68,22487,0,0,0,0,993,854,1847
2020-02-09,24,3637,4904,2189,9599,9506,2012,66,21193,0,0,0,0,985,786,1771
2020-02-10,1,3510,4837,2109,9113,8931,1914,65,20027,0,0,0,0,1077,722,1799
2020-02-10,2,3459,4849,2089,8853,8645,1860,65,19427,0,0,0,0,1070,603,1673
2020-02-10,3,3442,4891,2103,8742,8552,1817,67,19182,0,0,0,0,1061,548,1609
2020-02-10,4,3471,5014,2156,8771,8566,1814,71,19227,0,0,0,0,1057,612,1669
2020-02-10,5,3555,5248,2291,9090,8891,1867,75,19930,0,0,0,0,1050,682,1732
2020-02-10,6,3748,5642,2573,9811,9641,2037,83,21576,0,0,0,0,1034,646,1680
2020-02-10,7,3956,5950,2970,11062,10645,2305,91,24109,0,19,0,19,1006,574,1580
2020-02-10,8,3961,5979,3187,11708,11047,2399,90,25254,282,912,261,1455,963,566,1529
2020-02-10,9,3907,5931,3091,11211,11006,2328,84,24630,965,2677,916,4558,901,581,1482
2020-02-10,10,3845,5860,2982,10482,10795,2201,78,23556,1350,3809,1362,6521,839,718,1557
2020-02-10,11,3786,5772,2874,9874,10591,2109,72,22645,1356,4231,1473,7060,826,1028,1854
2020-02-10,12,3729,5688,2760,9416,10463,2061,66,22008,1307,4448,1502,7257,847,1277,2124
2020-02-10,13,3684,5655,2682,9206,10361,2042,62,21674,1299,4527,1520,7346,855,1375,2230
2020-02-10,14,3646,5614,2610,9209,10389,2091,60,21754,1304,4473,1502,7279,844,1361,2205
2020-02-10,15,3633,5594,2538,9412,10458,2180,59,22116,1319,4223,1444,6986,802,1289,2091
2020-02-10,16,3666,5642,2533,9945,10637,2264,59,22911,1176,3326,1191,5693,749,1139,1888
2020-02-10,17,3789,5772,2580,10912,10984,2408,62,24375,668,1599,642,2909,722,887,1609
2020-02-10,18,4101,6002,2739,12192,11756,2663,68,26683,144,271,142,557,754,684,1438
2020-02-10,19,4292,5997,2873,12940,12401,2784,71,28199,0,4,0,4,826,709,1535
2020-02-10,20,4279,5900,2857,12792,12271,2755,73,27893,0,5,0,5,881,833,1714
2020-02-10,21,4195,5702,2788,12398,11933,2656,72,27062,0,0,0,0,893,841,1734
2020-02-10,22,4032,5403,2634,11778,11431,2511,70,25793,0,0,0,0,880,749,1629
2020-02-10,23,3834,5142,2439,10882,10668,2292,66,23911,0,0,0,0,874,628,1502
2020-02-10,24,3667,5001,2284,10143,9958,2101,65,22268,0,0,0,0,873,502,1375
2020-02-11,1,3598,4984,2190,9705,9468,1984,60,21220,0,0,0,0,850,278,1128
2020-02-11,2,3536,4980,2156,9426,9171,1916,62,20578,0,0,0,0,829,334,1163
2020-02-11,3,3509,5006,2156,9290,9072,1876,63,20304,0,0,0,0,820,351,1171
2020-02-11,4,3525,5105,2192,9297,9080,1875,66,20322,0,0,0,0,789,359,1148
2020-02-11,5,3603,5338,2312,9579,9385,1935,71,20973,0,0,0,0,768,393,1161
2020-02-11,6,3788,5728,2583,10275,10099,2112,79,22568,0,0,0,0,762,413,1175
2020-02-11,7,3999,6018,2967,11420,11219,2383,88,25111,0,71,0,71,684,431,1115
2020-02-11,8,3983,6026,3153,11989,11452,2411,88,25948,278,1708,261,2247,541,464,1005
2020-02-11,9,3932,5954,3054,11415,10981,2214,81,24695,947,4608,897,6452,414,496,910
2020-02-11,10,3879,5873,2935,10531,10637,1994,74,23243,1319,6207,1321,8847,330,535,865
2020-02-11,11,3833,5779,2825,9942,10399,1821,70,22241,1323,6583,1424,9330,329,576,905
2020-02-11,12,3773,5685,2712,9501,10256,1723,65,21555,1273,6620,1458,9351,336,584,920
2020-02-11,13,3733,5646,2636,9278,10175,1690,62,21217,1262,6640,1476,9378,295,528,823
2020-02-11,14,3712,5599,2568,9372,10273,1722,61,21442,1268,6611,1442,9321,218,422,640
2020-02-11,15,3706,5590,2504,9581,10362,1837,59,21851,1286,6396,1377,9059,117,291,408
2020-02-11,16,3748,5633,2480,10045,10558,2016,59,22686,1150,5186,1130,7466,52,165,217
2020-02-11,17,3867,5748,2541,10895,11043,2238,62,24243,657,2553,622,3832,33,89,122
2020-02-11,18,4134,5991,2694,12067,11908,2560,68,26610,144,452,141,737,38,73,111
2020-02-11,19,4307,5990,2818,12790,12445,2719,75,28034,0,3,0,3,44,98,142
2020-02-11,20,4283,5904,2791,12672,12260,2680,77,27690,0,4,0,4,44,138,182
2020-02-11,21,4207,5711,2724,12304,12021,2591,76,26994,0,0,0,0,44,187,231
2020-02-11,22,4048,5418,2574,11769,11507,2453,73,25804,0,0,0,0,43,244,287
2020-02-11,23,3849,5155,2385,10974,10767,2247,69,24059,0,0,0,0,46,296,342
2020-02-11,24,3681,5001,2226,10342,10133,2062,67,22608,0,0,0,0,51,357,408
2020-02-12,1,3546,4920,2133,9950,9700,1983,63,21706,0,0,0,0,118,407,525
2020-02-12,2,3494,4914,2096,9641,9363,1919,65,21004,0,0,0,0,99,441,540
2020-02-12,3,3478,4924,2089,9521,9276,1872,68,20752,0,0,0,0,81,400,481
2020-02-12,4,3503,5014,2119,9536,9290,1865,71,20784,0,0,0,0,76,332,408
2020-02-12,5,3595,5237,2232,9829,9550,1920,78,21395,0,0,0,0,86,338,424
2020-02-12,6,3790,5612,2504,10553,10225,2119,87,23001,0,0,0,0,99,365,464
2020-02-12,7,4012,5902,2885,11806,11286,2411,98,25623,0,119,0,119,104,379,483
2020-02-12,8,3977,5920,3085,12417,11613,2454,95,26605,265,1925,257,2447,103,372,475
2020-02-12,9,3886,5861,2988,11840,11451,2270,85,25651,900,4865,878,6643,93,284,377
2020-02-12,10,3793,5778,2882,11023,11028,2011,76,24144,1261,6406,1304,8971,85,162,247
2020-02-12,11,3716,5687,2784,10357,10635,1835,68,22902,1275,6755,1420,9450,86,98,184
2020-02-12,12,3643,5597,2692,9939,10386,1757,63,22155,1233,6756,1447,9436,81,87,168
2020-02-12,13,3599,5567,2628,9715,10248,1727,60,21753,1220,6723,1453,9396,74,125,199
2020-02-12,14,3577,5535,2570,9765,10324,1769,59,21922,1207,6607,1413,9227,65,197,262
2020-02-12,15,3566,5534,2520,9975,10365,1876,57,22278,1180,6304,1344,8828,53,283,336
2020-02-12,16,3601,5573,2475,10415,10581,2046,57,23105,1019,5016,1099,7134,41,363,404
2020-02-12,17,3721,5684,2542,11194,10949,2256,60,24468,563,2424,584,3571,37,408,445
2020-02-12,18,4006,5918,2686,12260,11868,2603,66,26802,114,438,125,677,42,504,546
2020-02-12,19,4186,5918,2810,13075,12454,2746,69,28348,0,4,0,4,51,524,575
2020-02-12,20,4172,5829,2789,12920,12266,2694,69,27955,0,5,0,5,61,463,524
2020-02-12,21,4106,5647,2719,12577,11956,2600,69,27210,0,0,0,0,71,355,426
2020-02-12,22,3958,5364,2574,12009,11437,2462,68,25985,0,0,0,0,78,258,336
2020-02-12,23,3774,5100,2388,11144,10744,2253,65,24217,0,0,0,0,80,173,253
2020-02-12,24,3620,4947,2238,10405,10107,2070,63,22653,0,0,0,0,76,100,176
2020-02-13,1,3491,4912,2190,9821,9739,1969,63,21607,0,0,0,0,45,65,110
2020-02-13,2,3441,4897,2160,9531,9348,1908,64,20869,0,0,0,0,36,47,83
2020-02-13,3,3419,4917,2160,9330,9143,1868,66,20420,0,0,0,0,38,40,78
2020-02-13,4,3443,5014,2200,9268,9058,1851,69,20257,0,0,0,0,45,41,86
2020-02-13,5,3532,5241,2316,9566,9337,1906,75,20893,0,0,0,0,55,48,103
2020-02-13,6,3723,5611,2590,10302,10067,2104,85,22567,0,0,0,0,68,58,126
2020-02-13,7,3938,5895,2978,11541,11119,2409,95,25176,0,128,0,128,78,65,143
2020-02-13,8,3903,5924,3165,12195,11511,2434,92,26258,275,1941,267,2483,86,64,150
2020-02-13,9,3826,5870,3067,11558,11241,2233,83,25120,922,4813,892,6627,81,56,137
2020-02-13,10,3748,5800,2953,10827,10911,2105,74,23918,1284,6331,1300,8915,62,59,121
2020-02-13,11,3680,5712,2838,10242,10638,1958,67,22908,1297,6707,1406,9410,51,68,119
2020-02-13,12,3615,5618,2725,9815,10451,1904,62,22240,1253,6743,1438,9434,58,67,125
2020-02-13,13,3572,5583,2649,9612,10339,1885,59,21907,1245,6737,1446,9428,76,60,136
2020-02-13,14,3551,5551,2580,9702,10409,1909,58,22089,1250,6622,1403,9275,82,53,135
2020-02-13,15,3538,5540,2516,9834,10448,1986,56,22332,1268,6278,1338,8884,97,49,146
2020-02-13,16,3565,5570,2489,10305,10676,2112,56,23156,1139,4972,1101,7212,129,45,174
2020-02-13,17,3679,5664,2546,11131,11018,2256,59,24477,660,2425,590,3675,147,44,191
2020-02-13,18,3940,5896,2690,12157,11908,2532,65,26670,149,437,130,716,182,47,229
2020-02-13,19,4116,5893,2797,12816,12560,2715,67,28165,0,3,0,3,264,52,316
2020-02-13,20,4094,5810,2765,12652,12370,2657,67,27753,0,4,0,4,357,65,422
2020-02-13,21,4026,5631,2704,12322,12042,2564,67,27006,0,0,0,0,375,75,450
2020-02-13,22,3881,5361,2569,11779,11565,2431,66,25855,0,0,0,0,347,75,422
2020-02-13,23,3710,5112,2388,10931,10841,2228,63,24071,0,0,0,0,323,68,391
2020-02-13,24,3551,4956,2247,10228,10153,2053,61,22501,0,0,0,0,291,61,352
2020-02-14,1,3465,4856,2162,9617,9729,1965,61,21389,0,0,0,0,274,101,375
2020-02-14,2,3408,4833,2129,9297,9452,1898,63,20729,0,0,0,0,231,138,369
2020-02-14,3,3386,4848,2120,9166,9244,1857,66,20346,0,0,0,0,183,169,352
2020-02-14,4,3413,4941,2148,9146,9208,1842,70,20277,0,0,0,0,142,173,315
2020-02-14,5,3498,5155,2254,9400,9427,1892,76,20803,0,0,0,0,116,137,253
2020-02-14,6,3678,5496,2498,10054,10070,2059,85,22276,0,0,0,0,87,97,184
2020-02-14,7,3878,5771,2853,11201,11087,2326,94,24721,0,122,0,122,60,76,136
2020-02-14,8,3860,5809,3050,11734,11360,2348,90,25545,262,1924,280,2466,43,66,109
2020-02-14,9,3792,5770,2967,11208,11005,2161,80,24465,874,4881,936,6691,34,55,89
2020-02-14,10,3728,5697,2872,10420,10618,1906,71,23022,1229,6465,1361,9055,35,38,73
2020-02-14,11,3670,5598,2778,9854,10354,1732,63,22012,1258,6810,1466,9534,31,33,64
2020-02-14,12,3605,5500,2680,9423,10151,1637,58,21279,1216,6815,1498,9529,19,46,65
2020-02-14,13,3564,5456,2608,9173,10017,1623,55,20878,1199,6817,1514,9530,14,79,93
2020-02-14,14,3543,5416,2551,9196,10090,1657,53,21007,1173,6748,1478,9399,14,168,182
2020-02-14,15,3536,5401,2485,9397,10199,1757,52,21414,1131,6476,1400,9007,15,369,384
2020-02-14,16,3555,5400,2475,9748,10398,1930,52,22135,990,5244,1146,7380,15,634,649
2020-02-14,17,3649,5493,2531,10499,10794,2169,55,23527,583,2637,620,3840,16,835,851
2020-02-14,18,3892,5716,2650,11527,11527,2476,60,25599,139,493,137,769,14,949,963
2020-02-14,19,4052,5697,2745,12226,12181,2633,63,27110,0,4,0,4,15,1005,1020
2020-02-14,20,4023,5587,2697,12044,12045,2560,63,26719,0,5,0,5,19,994,1013
2020-02-14,21,3960,5433,2621,11719,11717,2477,62,25988,0,0,0,0,30,979,1009
2020-02-14,22,3850,5230,2499,11285,11299,2377,62,25037,0,0,0,0,44,1013,1057
2020-02-14,23,3719,5028,2346,10643,10674,2220,59,23604,0,0,0,0,60,1029,1089
2020-02-14,24,3582,4881,2211,10015,10024,2058,58,22162,0,0,0,0,76,968,1044
2020-02-15,1,3495,4794,2115,9651,9477,1970,59,21173,0,0,0,0,89,1149,1238
2020-02-15,2,3426,4764,2077,9309,9171,1896,60,20455,0,0,0,0,82,1196,1278
2020-02-15,3,3394,4763,2066,9075,8930,1844,64,19925,0,0,0,0,70,1241,1311
2020-02-15,4,3392,4813,2088,9065,8837,1816,67,19796,0,0,0,0,63,1178,1241
2020-02-15,5,3429,4910,2152,9234,8868,1839,72,20022,0,0,0,0,63,1024,1087
2020-02-15,6,3509,5073,2281,9556,9187,1911,78,20742,0,0,0,0,64,814,878
2020-02-15,7,3578,5209,2458,9981,9495,2041,87,21616,0,161,0,161,60,728,788
2020-02-15,8,3536,5337,2624,10170,9452,2021,85,21741,257,2065,266,2588,50,727,777
2020-02-15,9,3543,5380,2701,9888,9296,1862,76,21134,795,4998,873,6666,39,574,613
2020-02-15,10,3534,5378,2685,9463,9026,1662,68,20227,1108,6473,1266,8847,27,396,423
2020-02-15,11,3507,5329,2610,9004,8796,1519,60,19388,1184,6795,1354,9333,24,307,331
2020-02-15,12,3444,5261,2510,8669,8571,1452,57,18759,1171,6777,1377,9325,32,267,299
2020-02-15,13,3395,5204,2413,8437,8512,1424,54,18436,1160,6685,1413,9258,43,340,383
2020-02-15,14,3366,5156,2324,8487,8562,1441,53,18553,1141,6479,1381,9001,57,537,594
2020-02-15,15,3370,5141,2266,8685,8716,1539,52,19000,1099,6161,1301,8561,71,774,845
2020-02-15,16,3412,5179,2264,9129,8962,1723,51,19870,947,5001,1078,7026,83,998,1081
2020-02-15,17,3523,5300,2330,9828,9481,1951,55,21326,531,2549,586,3666,97,1225,1322
2020-02-15,18,3786,5555,2451,10834,10380,2278,61,23561,114,497,127,738,125,1357,1482
2020-02-15,19,3927,5567,2549,11606,11215,2491,64,25382,0,8,0,8,176,1400,1576
2020-02-15,20,3885,5481,2511,11496,11066,2448,63,25080,0,7,0,7,246,1466,1712
2020-02-15,21,3831,5355,2447,11176,10779,2375,62,24403,0,0,0,0,311,1501,1812
2020-02-15,22,3734,5164,2350,10801,10458,2291,60,23624,0,0,0,0,361,1543,1904
2020-02-15,23,3635,4958,2225,10288,9957,2151,57,22461,0,0,0,0,430,1620,2050
2020-02-15,24,3497,4785,2117,9690,9474,2009,54,21233,0,0,0,0,505,1650,2155
2020-02-16,1,3402,4675,2025,9462,8919,1926,54,20378,0,0,0,0,470,1505,1975
2020-02-16,2,3334,4642,1987,9093,8591,1851,56,19610,0,0,0,0,504,1526,2030
2020-02-16,3,3292,4634,1974,8897,8343,1801,58,19111,0,0,0,0,534,1614,2148
2020-02-16,4,3277,4663,1992,8776,8219,1775,60,18842,0,0,0,0,578,1614,2192
2020-02-16,5,3307,4730,2048,8777,8186,1787,64,18823,0,0,0,0,618,1536,2154
2020-02-16,6,3371,4839,2152,9025,8381,1846,70,19331,0,0,0,0,644,1502,2146
2020-02-16,7,3407,4951,2305,9416,8677,1928,77,20111,0,172,0,172,622,1488,2110
2020-02-16,8,3364,5064,2466,9532,8568,1870,77,20055,222,2050,256,2528,530,1472,2002
2020-02-16,9,3373,5087,2562,9377,8429,1714,70,19601,717,4954,801,6472,408,1395,1803
2020-02-16,10,3382,5066,2570,9000,8176,1547,63,18794,1056,6425,1173,8654,308,1361,1669
2020-02-16,11,3361,5025,2509,8615,8011,1418,57,18109,1154,6715,1296,9165,250,1462,1712
2020-02-16,12,3333,5022,2432,8253,7818,1362,54,17498,1145,6704,1320,9169,217,1691,1908
2020-02-16,13,3326,5003,2371,8129,7776,1344,52,17309,1141,6673,1348,9162,199,1950,2149
2020-02-16,14,3338,5013,2320,8190,7888,1378,51,17507,1107,6496,1314,8917,189,2105,2294
2020-02-16,15,3373,5051,2282,8383,8109,1476,49,18017,1005,6101,1211,8317,177,2199,2376
2020-02-16,16,3437,5124,2297,8845,8517,1671,49,19083,798,4849,986,6633,164,2243,2407
2020-02-16,17,3525,5248,2366,9698,9038,1920,51,20707,415,2399,536,3350,190,2249,2439
2020-02-16,18,3789,5499,2524,10735,10054,2262,57,23107,80,449,119,648,231,2274,2505
2020-02-16,19,3891,5519,2652,11747,11010,2498,60,25315,0,7,0,7,243,2314,2557
2020-02-16,20,3832,5439,2637,11733,10872,2455,60,25121,0,5,0,5,235,2324,2559
2020-02-16,21,3791,5289,2572,11428,10615,2371,58,24471,0,0,0,0,213,2334,2547
2020-02-16,22,3683,5061,2440,10923,10219,2254,55,23452,0,0,0,0,182,2327,2509
2020-02-16,23,3575,4845,2272,10217,9730,2079,52,22079,0,0,0,0,162,2305,2467
2020-02-16,24,3441,4716,2146,9578,9182,1933,50,20742,0,0,0,0,162,2273,2435
2020-02-17,1,3367,4706,2103,9213,8813,1877,47,19949,0,0,0,0,199,2111,2310
2020-02-17,2,3301,4693,2081,8909,8513,1823,47,19292,0,0,0,0,195,2026,2221
2020-02-17,3,3265,4716,2088,8811,8290,1780,48,18930,0,0,0,0,199,1979,2178
2020-02-17,4,3273,4807,2129,8812,8199,1762,50,18824,0,0,0,0,222,1864,2086
2020-02-17,5,3330,4984,2246,9014,8369,1794,55,19232,0,0,0,0,263,1711,1974
2020-02-17,6,3455,5244,2477,9503,8815,1900,62,20280,0,0,0,0,330,1416,1746
2020-02-17,7,3562,5430,2760,10222,9413,2043,68,21746,0,190,0,190,413,1026,1439
2020-02-17,8,3550,5572,2960,10587,9545,2037,70,22239,297,2053,272,2622,485,712,1197
2020-02-17,9,3585,5665,2997,10582,9601,1928,67,22179,910,4821,847,6578,491,391,882
2020-02-17,10,3614,5699,2952,10187,9422,1771,62,21442,1228,6257,1242,8727,508,135,643
2020-02-17,11,3615,5663,2870,9807,9228,1656,58,20749,1259,6551,1390,9200,605,84,689
2020-02-17,12,3592,5600,2764,9523,9206,1589,55,20372,1228,6510,1436,9174,651,121,772
2020-02-17,13,3563,5580,2668,9320,9260,1567,54,20201,1222,6494,1453,9169,649,133,782
2020-02-17,14,3555,5554,2571,9332,9480,1594,53,20459,1205,6463,1422,9090,648,116,764
2020-02-17,15,3555,5552,2501,9490,9766,1724,50,21030,1137,6155,1330,8622,606,97,703
2020-02-17,16,3607,5593,2488,9931,10142,1891,50,22016,978,4962,1078,7018,528,82,610
2020-02-17,17,3685,5691,2550,10667,10550,2115,53,23385,571,2551,577,3699,435,78,513
2020-02-17,18,3934,5934,2708,11804,11279,2411,60,25554,128,488,125,741,341,122,463
2020-02-17,19,4108,5919,2871,12814,11888,2611,64,27377,0,6,0,6,279,240,519
2020-02-17,20,4067,5831,2847,12692,11760,2558,62,27072,0,4,0,4,252,284,536
2020-02-17,21,4000,5645,2780,12320,11441,2468,59,26289,0,0,0,0,240,227,467
2020-02-17,22,3856,5351,2637,11720,11005,2322,56,25103,0,0,0,0,242,190,432
2020-02-17,23,3719,5093,2447,10856,10347,2121,53,23378,0,0,0,0,246,151,397
2020-02-17,24,3551,4939,2303,10170,9654,1954,53,21831,0,0,0,0,246,116,362
2020-02-18,1,3362,4884,2250,9500,9114,1892,52,20557,0,0,0,0,368,55,423
2020-02-18,2,3302,4873,2235,9215,8796,1834,53,19899,0,0,0,0,282,58,340
2020-02-18,3,3277,4897,2247,9047,8544,1788,56,19435,0,0,0,0,226,60,286
2020-02-18,4,3300,5001,2293,8996,8454,1771,59,19281,0,0,0,0,192,57,249
2020-02-18,5,3384,5237,2424,9253,8642,1820,65,19780,0,0,0,0,173,63,236
2020-02-18,6,3579,5638,2716,9966,9293,1978,74,21312,0,0,0,0,161,70,231
2020-02-18,7,3783,5922,3134,11141,10172,2231,83,23627,0,207,1,208,149,85,234
2020-02-18,8,3775,5937,3293,11687,10448,2271,82,24488,300,1820,240,2360,140,100,240
2020-02-18,9,3726,5864,3191,11254,10597,2174,73,24098,916,4145,758,5819,121,100,221
2020-02-18,10,3676,5780,3040,10566,10458,2038,65,23126,1243,5505,1146,7894,121,103,224
2020-02-18,11,3634,5691,2901,9970,10300,1882,60,22211,1278,5954,1298,8530,115,105,220
2020-02-18,12,3586,5604,2766,9544,10297,1817,56,21713,1258,6046,1358,8662,71,88,159
2020-02-18,13,3553,5571,2674,9348,10297,1794,53,21492,1255,6036,1382,8673,39,63,102
2020-02-18,14,3531,5523,2602,9404,10444,1847,52,21747,1235,5864,1347,8446,21,47,68
2020-02-18,15,3521,5510,2536,9561,10606,1930,51,22148,1172,5531,1283,7986,13,47,60
2020-02-18,16,3544,5542,2510,10022,10717,2063,52,22853,1021,4440,1058,6519,11,72,83
2020-02-18,17,3642,5648,2570,10751,10985,2222,54,24012,608,2274,564,3446,10,112,122
2020-02-18,18,3884,5891,2728,11813,11547,2488,60,25908,141,454,125,720,15,165,180
2020-02-18,19,4082,5906,2888,12653,12198,2659,63,27572,0,5,0,5,34,246,280
2020-02-18,20,4065,5827,2879,12565,12016,2602,62,27245,0,5,0,5,54,345,399
2020-02-18,21,3985,5634,2819,12212,11646,2499,60,26417,0,0,0,0,67,397,464
2020-02-18,22,3833,5342,2666,11636,11078,2353,58,25125,0,0,0,0,84,441,525
2020-02-18,23,3648,5094,2479,10811,10351,2143,55,23360,0,0,0,0,101,527,628
2020-02-18,24,3489,4947,2338,10149,9653,1972,54,21827,0,0,0,0,119,615,734
2020-02-19,1,3416,4964,2304,9645,9490,1894,59,21087,0,0,0,0,128,749,877
2020-02-19,2,3367,4955,2286,9325,9164,1835,60,20384,0,0,0,0,128,830,958
2020-02-19,3,3352,4978,2295,9168,8928,1794,63,19953,0,0,0,0,123,913,1036
2020-02-19,4,3379,5078,2342,9172,8887,1779,66,19904,0,0,0,0,111,980,1091
2020-02-19,5,3476,5313,2474,9470,9173,1831,72,20546,0,0,0,0,95,1017,1112
2020-02-19,6,3661,5703,2766,10236,9931,1991,80,22238,0,0,0,0,86,938,1024
2020-02-19,7,3854,5977,3179,11516,10891,2242,90,24740,0,218,1,219,81,816,897
2020-02-19,8,3828,5983,3331,12012,11082,2325,87,25506,351,2189,346,2886,77,725,802
2020-02-19,9,3753,5911,3221,11352,10426,2159,78,24015,1041,5058,1032,7131,66,528,594
2020-02-19,10,3679,5813,3064,10511,10131,1935,70,22647,1357,6523,1436,9316,57,318,375
2020-02-19,11,3615,5713,2920,9945,10017,1795,63,21820,1360,6884,1535,9779,51,184,235
2020-02-19,12,3559,5615,2786,9523,10039,1725,59,21346,1322,6935,1561,9818,38,132,170
2020-02-19,13,3524,5577,2694,9380,10060,1698,57,21194,1309,6934,1573,9816,24,179,203
2020-02-19,14,3506,5534,2621,9431,10226,1734,55,21447,1313,6864,1543,9720,15,286,301
2020-02-19,15,3495,5524,2563,9664,10350,1830,54,21898,1331,6610,1485,9426,9,425,434
2020-02-19,16,3526,5553,2532,10184,10522,2000,54,22760,1224,5456,1259,7939,8,538,546
2020-02-19,17,3625,5671,2601,10931,10815,2198,56,23999,752,2896,724,4372,10,615,625
2020-02-19,18,3886,5912,2735,11961,11470,2484,62,25977,169,608,173,950,13,700,713
2020-02-19,19,4094,5937,2897,12818,12077,2675,65,27635,0,9,0,9,20,665,685
2020-02-19,20,4084,5867,2884,12681,11904,2617,64,27266,0,5,0,5,27,470,497
2020-02-19,21,4008,5682,2830,12353,11535,2515,63,26466,0,0,0,0,33,263,296
2020-02-19,22,3855,5395,2683,11807,11086,2377,61,25330,0,0,0,0,41,143,184
2020-02-19,23,3667,5143,2498,10931,10373,2169,58,23531,0,0,0,0,48,118,166
2020-02-19,24,3511,5003,2348,10225,9688,1994,57,21964,0,0,0,0,53,117,170
2020-02-20,1,3452,5012,2297,9823,9422,1890,59,21193,0,0,0,0,29,109,138
2020-02-20,2,3397,5005,2273,9504,9103,1835,61,20503,0,0,0,0,28,119,147
2020-02-20,3,3374,5032,2275,9403,8884,1791,63,20141,0,0,0,0,21,142,163
2020-02-20,4,3395,5129,2317,9371,8879,1774,66,20088,0,0,0,0,15,188,203
2020-02-20,5,3484,5351,2441,9653,9047,1826,72,20598,0,0,0,0,14,235,249
2020-02-20,6,3678,5736,2722,10408,9779,1984,81,22252,0,0,0,0,18,256,274
2020-02-20,7,3860,5999,3118,11608,10813,2232,92,24744,0,265,2,267,29,276,305
2020-02-20,8,3849,6016,3275,12183,11101,2222,88,25594,343,2377,342,3062,43,298,341
2020-02-20,9,3791,5949,3169,11721,10669,2045,79,24513,970,5326,994,7290,45,330,375
2020-02-20,10,3727,5854,3037,11022,10334,1867,70,23292,1282,6755,1391,9428,35,405,440
2020-02-20,11,3673,5742,2909,10440,10104,1751,63,22358,1311,7025,1495,9831,30,490,520
2020-02-20,12,3612,5632,2786,10146,10011,1691,59,21907,1282,6990,1530,9802,25,528,553
2020-02-20,13,3571,5586,2701,10013,10079,1684,56,21832,1272,6948,1553,9773,19,498,517
2020-02-20,14,3552,5543,2633,10166,10227,1755,55,22202,1275,6831,1531,9637,14,441,455
2020-02-20,15,3538,5523,2567,10408,10413,1840,54,22714,1289,6537,1470,9296,13,403,416
2020-02-20,16,3564,5552,2539,10841,10598,2010,54,23503,1188,5392,1238,7818,15,368,383
2020-02-20,17,3660,5649,2580,11408,11029,2204,56,24696,729,2879,706,4314,18,329,347
2020-02-20,18,3905,5886,2719,12123,11563,2472,62,26219,176,603,169,948,27,294,321
2020-02-20,19,4108,5920,2879,12834,12200,2647,65,27745,0,7,0,7,45,262,307
2020-02-20,20,4092,5857,2875,12724,11986,2587,64,27361,0,4,0,4,62,241,303
2020-02-20,21,4018,5673,2816,12337,11634,2487,63,26520,0,0,0,0,74,222,296
2020-02-20,22,3869,5399,2676,11730,11081,2352,61,25223,0,0,0,0,87,198,285
2020-02-20,23,3691,5155,2496,10907,10396,2149,59,23511,0,0,0,0,102,182,284
2020-02-20,24,3531,5015,2348,10191,9728,1985,58,21961,0,0,0,0,112,172,284
2020-02-21,1,3428,5005,2199,9736,9307,1898,56,20999,0,0,0,0,114,147,261
2020-02-21,2,3372,4989,2168,9400,8953,1833,58,20246,0,0,0,0,102,141,243
2020-02-21,3,3347,5013,2169,9232,8716,1783,60,19792,0,0,0,0,86,132,218
2020-02-21,4,3367,5106,2207,9134,8601,1761,63,19562,0,0,0,0,84,131,215
2020-02-21,5,3449,5316,2324,9397,8835,1802,69,20104,0,0,0,0,105,142,247
2020-02-21,6,3616,5673,2588,10039,9382,1947,78,21447,0,0,0,0,107,156,263
2020-02-21,7,3798,5927,2971,11121,10176,2176,86,23560,1,233,3,237,114,188,302
2020-02-21,8,3777,5947,3138,11662,10446,2202,82,24396,243,1950,231,2424,133,225,358
2020-02-21,9,3735,5884,3034,11459,10756,2111,73,24398,696,4368,692,5756,128,274,402
2020-02-21,10,3685,5775,2897,10996,10603,2021,65,23687,911,5670,1016,7597,96,359,455
2020-02-21,11,3640,5652,2762,10513,10396,1923,58,22891,911,6022,1132,8065,117,432,549
2020-02-21,12,3589,5533,2629,10219,10346,1856,55,22476,894,6035,1172,8101,140,460,600
2020-02-21,13,3549,5474,2525,10142,10383,1874,52,22452,900,5997,1189,8086,142,450,592
2020-02-21,14,3536,5429,2444,10298,10546,1923,51,22818,879,5714,1168,7761,147,397,544
2020-02-21,15,3539,5404,2372,10635,10583,2005,50,23274,823,5140,1103,7066,153,347,500
2020-02-21,16,3572,5414,2347,10878,10792,2104,50,23826,688,3909,881,5478,141,326,467
2020-02-21,17,3650,5504,2379,11300,10859,2216,52,24428,391,1893,473,2757,122,296,418
2020-02-21,18,3884,5727,2482,11978,11435,2412,57,25882,91,352,111,554,104,244,348
2020-02-21,19,4043,5734,2635,12599,12104,2547,60,27311,0,3,0,3,89,225,314
2020-02-21,20,4006,5645,2622,12379,11890,2471,59,26801,0,4,0,4,76,294,370
2020-02-21,21,3930,5496,2567,11932,11516,2375,58,25882,0,0,0,0,61,390,451
2020-02-21,22,3803,5292,2457,11405,11069,2273,56,24805,0,0,0,0,73,459,532
2020-02-21,23,3671,5094,2319,10723,10407,2117,54,23302,0,0,0,0,128,500,628
2020-02-21,24,3528,4946,2197,10081,9715,1967,52,21816,0,0,0,0,177,525,702
2020-02-22,1,3460,4891,2090,9676,9288,1894,55,20914,0,0,0,0,75,797,872
2020-02-22,2,3385,4853,2051,9302,8905,1826,55,20090,0,0,0,0,79,819,898
2020-02-22,3,3342,4851,2046,9082,8641,1766,59,19550,0,0,0,0,101,776,877
2020-02-22,4,3333,4903,2069,8974,8522,1734,62,19292,0,0,0,0,141,817,958
2020-02-22,5,3360,5000,2131,9043,8597,1739,67,19447,0,0,0,0,171,916,1087
2020-02-22,6,3427,5160,2262,9321,8857,1789,73,20041,0,0,0,0,211,976,1187
2020-02-22,7,3480,5267,2449,9803,9266,1881,77,21029,4,171,6,181,278,976,1254
2020-02-22,8,3444,5380,2605,10041,9390,1970,76,21478,148,1494,176,1818,314,941,1255
2020-02-22,9,3503,5434,2660,9862,9290,2023,72,21248,441,3505,525,4471,276,910,1186
2020-02-22,10,3529,5401,2605,9528,9310,2061,67,20968,642,4737,789,6168,233,930,1163
2020-02-22,11,3521,5330,2502,9191,9361,2052,62,20667,710,5157,888,6755,239,1003,1242
2020-02-22,12,3494,5249,2386,8923,9225,2016,59,20225,746,5261,916,6923,287,1163,1450
2020-02-22,13,3474,5179,2271,8740,9161,1999,58,19958,758,5236,886,6880,350,1511,1861
2020-02-22,14,3462,5131,2179,8690,9136,1935,57,19819,744,5077,815,6636,397,1907,2304
2020-02-22,15,3466,5122,2131,8778,9123,1947,57,19904,734,4706,739,6179,424,2202,2626
2020-02-22,16,3525,5156,2136,9267,9352,1995,59,20673,674,3682,578,4934,460,2389,2849
2020-02-22,17,3627,5270,2174,9894,9719,2076,62,21751,439,1878,307,2624,528,2420,2948
2020-02-22,18,3833,5525,2291,10809,10136,2250,66,23261,121,382,71,574,600,2386,2986
2020-02-22,19,3987,5589,2440,11733,10807,2449,69,25058,0,2,0,2,622,2385,3007
2020-02-22,20,3939,5527,2426,11592,10760,2408,68,24828,0,0,0,0,613,2388,3001
2020-02-22,21,3873,5414,2371,11271,10565,2329,67,24234,0,0,0,0,617,2431,3048
2020-02-22,22,3768,5223,2282,10857,10215,2246,66,23384,0,0,0,0,614,2445,3059
2020-02-22,23,3661,5024,2164,10320,9740,2112,63,22236,0,0,0,0,592,2383,2975
2020-02-22,24,3524,4862,2060,9743,9233,1974,60,21011,0,0,0,0,560,2377,2937
2020-02-23,1,3419,4773,2019,9209,8749,1868,52,19881,0,0,0,0,516,2153,2669
2020-02-23,2,3353,4737,1984,8860,8425,1801,52,19139,0,0,0,0,450,2126,2576
2020-02-23,3,3315,4739,1974,8635,8201,1742,54,18633,0,0,0,0,387,2199,2586
2020-02-23,4,3307,4774,1991,8532,8037,1711,56,18338,0,0,0,0,375,2334,2709
2020-02-23,5,3336,4844,2049,8607,8081,1715,60,18465,0,0,0,0,365,2409,2774
2020-02-23,6,3401,4966,2152,8863,8363,1765,67,19060,0,0,0,0,324,2393,2717
2020-02-23,7,3430,5070,2309,9263,8555,1846,72,19737,3,300,6,309,276,2295,2571
2020-02-23,8,3388,5168,2445,9392,8472,1873,71,19809,325,2267,308,2900,242,2164,2406
2020-02-23,9,3398,5171,2520,9186,8377,1886,65,19514,919,4976,892,6787,225,2021,2246
2020-02-23,10,3394,5136,2512,8789,8201,1874,59,18924,1238,6385,1303,8926,195,1873,2068
2020-02-23,11,3370,5079,2450,8376,8152,1754,54,18336,1277,6731,1461,9469,148,1763,1911
2020-02-23,12,3322,5061,2380,8053,8092,1663,51,17858,1255,6745,1513,9513,111,1726,1837
2020-02-23,13,3294,5019,2324,7888,8082,1598,49,17618,1254,6741,1528,9523,94,1820,1914
2020-02-23,14,3300,5013,2272,7867,8115,1570,48,17600,1281,6687,1503,9471,83,2024,2107
2020-02-23,15,3325,5037,2243,8045,8311,1601,47,18004,1316,6460,1455,9231,79,2210,2289
2020-02-23,16,3374,5112,2252,8582,8593,1709,47,18932,1227,5436,1248,7911,82,2308,2390
2020-02-23,17,3468,5245,2327,9435,9058,1888,49,20430,776,3011,735,4522,90,2309,2399
2020-02-23,18,3716,5475,2466,10554,9943,2189,54,22740,199,674,186,1059,124,2257,2381
2020-02-23,19,3874,5533,2610,11658,10852,2441,58,25009,0,8,0,8,166,2243,2409
2020-02-23,20,3860,5485,2600,11671,10771,2406,57,24906,0,4,0,4,197,2288,2485
2020-02-23,21,3828,5340,2532,11362,10488,2320,55,24227,0,0,0,0,224,2308,2532
2020-02-23,22,3711,5105,2400,10838,10054,2206,53,23152,0,0,0,0,223,2264,2487
2020-02-23,23,3589,4888,2235,10087,9530,2038,50,21706,0,0,0,0,204,2212,2416
2020-02-23,24,3442,4757,2106,9410,8972,1895,49,20327,0,0,0,0,189,2136,2325
2020-02-24,1,3360,4677,2031,9038,8729,1828,51,19647,0,0,0,0,137,2237,2374
2020-02-24,2,3304,4683,2010,8794,8488,1784,52,19118,0,0,0,0,106,2179,2285
2020-02-24,3,3281,4718,2019,8682,8366,1747,55,18851,0,0,0,0,93,2071,2164
2020-02-24,4,3303,4827,2070,8721,8347,1735,58,18863,0,0,0,0,106,1932,2038
2020-02-24,5,3387,5068,2201,9035,8699,1784,64,19583,0,0,0,0,136,1749,1885
2020-02-24,6,3566,5464,2481,9805,9539,1950,71,21366,0,0,0,0,183,1511,1694
2020-02-24,7,3745,5745,2875,11034,10496,2193,82,23806,7,390,11,408,217,1279,1496
2020-02-24,8,3741,5791,3090,11712,10791,2199,78,24782,407,2637,362,3406,197,1012,1209
2020-02-24,9,3715,5761,2997,11265,10662,2026,70,24026,1061,5549,947,7557,149,695,844
2020-02-24,10,3688,5716,2887,10512,10343,1855,63,22775,1359,6958,1320,9637,124,373,497
2020-02-24,11,3663,5668,2786,9923,10207,1727,59,21918,1383,7230,1455,10068,138,146,284
2020-02-24,12,3622,5619,2682,9489,10150,1664,56,21359,1353,7192,1504,10049,161,59,220
2020-02-24,13,3583,5605,2612,9354,10121,1650,54,21181,1348,7160,1530,10038,171,46,217
2020-02-24,14,3567,5573,2547,9340,10219,1694,53,21308,1365,7079,1524,9968,170,57,227
2020-02-24,15,3567,5560,2479,9537,10356,1793,53,21739,1387,6838,1474,9699,156,105,261
2020-02-24,16,3611,5576,2460,10082,10559,1959,53,22654,1294,5749,1263,8306,143,242,385
2020-02-24,17,3682,5673,2511,10769,10989,2164,55,23978,829,3198,752,4779,156,497,653
2020-02-24,18,3906,5891,2655,11790,11649,2463,60,25963,215,713,193,1121,200,917,1117
2020-02-24,19,4108,5911,2843,12731,12402,2663,64,27861,0,11,0,11,238,1251,1489
2020-02-24,20,4098,5820,2838,12602,12313,2605,62,27582,0,4,0,4,241,1318,1559
2020-02-24,21,4002,5621,2762,12162,11936,2489,60,26647,0,0,0,0,224,1203,1427
2020-02-24,22,3837,5318,2610,11521,11317,2344,56,25239,0,0,0,0,217,867,1084
2020-02-24,23,3664,5057,2422,10658,10531,2128,53,23370,0,0,0,0,245,552,797
2020-02-24,24,3492,4911,2275,9955,9817,1961,51,21785,0,0,0,0,300,340,640
2020-02-25,1,3390,4871,2131,9488,9249,1879,52,20668,0,0,0,0,353,255,608
2020-02-25,2,3329,4860,2105,9174,8856,1822,53,19906,0,0,0,0,446,153,599
2020-02-25,3,3301,4885,2113,9049,8659,1778,56,19553,0,0,0,0,529,113,642
2020-02-25,4,3315,4985,2159,8996,8554,1759,58,19372,0,0,0,0,563,124,687
2020-02-25,5,3393,5220,2284,9293,8825,1806,64,19990,0,0,0,0,522,156,678
2020-02-25,6,3571,5612,2569,10029,9552,1964,72,21620,0,0,0,0,399,191,590
2020-02-25,7,3757,5882,2982,11244,10480,2196,82,24004,12,455,14,481,279,215,494
2020-02-25,8,3750,5889,3137,11712,10751,2179,79,24722,445,2860,416,3721,231,184,415
2020-02-25,9,3724,5826,3016,11082,10703,1968,70,23825,1141,5835,1100,8076,188,233,421
2020-02-25,10,3688,5752,2870,10350,10481,1815,64,22711,1418,7233,1479,10130,163,315,478
2020-02-25,11,3665,5677,2734,9909,10446,1740,59,22156,1418,7511,1586,10515,189,408,597
2020-02-25,12,3617,5603,2608,9659,10441,1709,56,21867,1382,7454,1606,10442,202,490,692
2020-02-25,13,3591,5577,2521,9583,10517,1703,54,21859,1365,7396,1605,10366,187,553,740
2020-02-25,14,3587,5541,2444,9727,10691,1763,53,22235,1370,7269,1578,10217,166,582,748
2020-02-25,15,3599,5533,2382,9976,10927,1903,53,22859,1386,6959,1518,9863,142,564,706
2020-02-25,16,3649,5568,2355,10454,11220,2103,53,23832,1292,5889,1302,8483,100,530,630
2020-02-25,17,3737,5668,2389,11157,11535,2318,55,25067,830,3328,780,4938,49,496,545
2020-02-25,18,3924,5891,2526,12110,12097,2562,60,26831,216,742,201,1159,33,577,610
2020-02-25,19,4129,5929,2725,12895,12807,2695,64,28463,0,8,0,8,51,538,589
2020-02-25,20,4108,5860,2732,12742,12503,2613,63,27926,0,2,0,2,60,504,564
2020-02-25,21,4021,5663,2672,12283,12087,2500,62,26933,0,0,0,0,52,477,529
2020-02-25,22,3860,5370,2530,11595,11432,2346,59,25433,0,0,0,0,38,459,497
2020-02-25,23,3682,5114,2350,10660,10642,2128,57,23487,0,0,0,0,30,450,480
2020-02-25,24,3510,4966,2200,9943,9886,1955,56,21840,0,0,0,0,28,441,469
2020-02-26,1,3415,4900,2109,9693,9210,1891,59,20856,0,0,0,0,32,430,462
2020-02-26,2,3367,4887,2077,9381,8867,1831,61,20142,0,0,0,0,29,419,448
2020-02-26,3,3354,4910,2078,9217,8715,1785,64,19783,0,0,0,0,25,408,433
2020-02-26,4,3380,5011,2117,9211,8681,1765,67,19726,0,0,0,0,25,395,420
2020-02-26,5,3478,5245,2236,9475,8878,1814,74,20242,0,0,0,0,24,386,410
2020-02-26,6,3659,5640,2503,10131,9535,1968,83,21718,0,0,0,0,21,377,398
2020-02-26,7,3835,5886,2897,11328,10456,2200,93,24078,20,500,20,540,16,366,382
2020-02-26,8,3808,5880,3042,11923,10708,2180,89,24902,455,2953,435,3843,14,233,247
2020-02-26,9,3746,5809,2926,11425,10585,1967,78,24057,1126,5891,1109,8126,11,231,242
2020-02-26,10,3680,5711,2789,10706,10450,1804,70,23031,1389,7236,1474,10099,7,240,247
2020-02-26,11,3618,5611,2669,10092,10304,1703,63,22164,1390,7490,1572,10452,8,240,248
2020-02-26,12,3541,5515,2560,9727,10225,1657,58,21669,1358,7418,1586,10362,9,222,231
2020-02-26,13,3503,5474,2484,9592,10264,1641,56,21555,1344,7340,1583,10267,11,197,208
2020-02-26,14,3496,5435,2430,9704,10425,1695,55,21881,1350,7190,1551,10091,14,171,185
2020-02-26,15,3498,5425,2395,9958,10574,1831,54,22419,1361,6828,1478,9667,17,163,180
2020-02-26,16,3554,5456,2378,10328,10757,2004,55,23146,1272,5763,1265,8300,19,173,192
2020-02-26,17,3645,5546,2406,11071,11035,2208,57,24373,828,3282,762,4872,24,159,183
2020-02-26,18,3859,5780,2516,12096,11540,2453,63,26154,218,735,196,1149,37,197,234
2020-02-26,19,4080,5832,2693,12855,12292,2616,66,27830,0,7,0,7,52,199,251
2020-02-26,20,4068,5780,2703,12702,12097,2564,65,27430,0,0,0,0,71,207,278
2020-02-26,21,3992,5598,2645,12252,11689,2446,65,26457,0,0,0,0,81,193,274
2020-02-26,22,3838,5309,2514,11632,11077,2306,64,25082,0,0,0,0,79,180,259
2020-02-26,23,3668,5056,2331,10809,10269,2108,61,23248,0,0,0,0,79,178,257
2020-02-26,24,3508,4899,2187,10143,9604,1942,59,21748,0,0,0,0,87,171,258
2020-02-27,1,3373,4813,2081,9655,9241,1881,57,20837,0,0,0,0,53,188,241
2020-02-27,2,3319,4791,2051,9295,8879,1817,59,20052,0,0,0,0,47,175,222
2020-02-27,3,3297,4809,2054,9092,8657,1771,62,19584,0,0,0,0,40,165,205
2020-02-27,4,3323,4903,2092,9018,8624,1751,65,19462,0,0,0,0,40,164,204
2020-02-27,5,3417,5123,2211,9272,8894,1799,71,20038,0,0,0,0,55,171,226
2020-02-27,6,3594,5510,2489,10055,9620,1958,81,21716,0,0,0,0,74,178,252
2020-02-27,7,3759,5757,2888,11244,10624,2202,88,24160,22,524,31,577,79,176,255
2020-02-27,8,3731,5777,3045,11594,10805,2222,84,24708,443,2859,414,3716,65,166,231
2020-02-27,9,3675,5714,2917,11064,10563,2034,75,23740,1082,5456,1000,7538,43,165,208
2020-02-27,10,3620,5636,2774,10475,10360,1867,66,22772,1350,6687,1326,9363,29,179,208
2020-02-27,11,3567,5550,2646,10055,10343,1798,60,22259,1363,7039,1444,9846,31,207,238
2020-02-27,12,3514,5463,2525,9784,10509,1789,55,22142,1330,7043,1488,9861,37,230,267
2020-02-27,13,3486,5434,2445,9639,10644,1795,53,22136,1315,6972,1492,9779,37,231,268
2020-02-27,14,3493,5402,2393,9744,10988,1880,52,22668,1300,6762,1442,9504,28,221,249
2020-02-27,15,3509,5389,2348,10075,11267,2033,51,23431,1261,6275,1350,8886,16,200,216
2020-02-27,16,3559,5405,2327,10493,11473,2201,52,24225,1148,5114,1132,7394,10,164,174
2020-02-27,17,3637,5483,2352,11198,11686,2387,53,25327,739,2778,652,4169,8,131,139
2020-02-27,18,3862,5695,2455,12052,12131,2761,58,27004,192,589,155,936,8,113,121
2020-02-27,19,4049,5746,2597,12708,12740,2720,62,28231,0,3,0,3,9,106,115
2020-02-27,20,4013,5702,2610,12519,12418,2614,60,27613,0,0,0,0,11,108,119
2020-02-27,21,3928,5523,2568,12049,12029,2485,59,26623,0,0,0,0,14,114,128
2020-02-27,22,3771,5246,2445,11406,11331,2337,56,25131,0,0,0,0,15,121,136
2020-02-27,23,3612,5000,2274,10689,10531,2137,53,23411,0,0,0,0,14,136,150
2020-02-27,24,3448,4844,2141,10045,9807,1962,51,21868,0,0,0,0,11,146,157
2020-02-28,1,3322,4737,2045,9702,9117,1884,52,20756,0,0,0,0,15,115,130
2020-02-28,2,3259,4718,2012,9351,8802,1824,54,20032,0,0,0,0,14,114,128
2020-02-28,3,3233,4736,2009,9157,8612,1774,56,19602,0,0,0,0,14,119,133
2020-02-28,4,3251,4829,2042,9141,8567,1753,60,19522,0,0,0,0,15,126,141
2020-02-28,5,3328,5044,2147,9393,8802,1787,65,20049,0,0,0,0,17,130,147
2020-02-28,6,3505,5404,2396,10000,9473,1918,75,21468,0,0,0,0,17,123,140
2020-02-28,7,3642,5644,2764,11096,10285,2123,79,23584,14,256,20,290,18,107,125
2020-02-28,8,3619,5658,2916,11604,10473,2137,76,24292,261,1519,241,2021,19,95,114
2020-02-28,9,3596,5603,2809,11227,10352,2067,68,23716,687,3157,629,4473,17,80,97
2020-02-28,10,3571,5517,2687,10815,10277,1998,61,23154,966,4608,923,6497,16,70,86
2020-02-28,11,3542,5419,2571,10501,10318,1951,56,22828,1066,5516,1074,7656,22,68,90
2020-02-28,12,3494,5315,2459,10326,10418,1988,53,22787,1074,5587,1134,7795,37,59,96
2020-02-28,13,3477,5270,2388,10315,10530,2007,51,22905,1060,5579,1141,7780,53,42,95
2020-02-28,14,3500,5228,2338,10473,10799,2040,50,23365,1006,5349,1101,7456,65,31,96
2020-02-28,15,3531,5196,2291,10717,11045,2163,50,23977,894,4812,994,6700,73,31,104
2020-02-28,16,3592,5183,2269,11120,11069,2271,50,24512,727,3787,784,5298,85,38,123
2020-02-28,17,3632,5249,2292,11380,11178,2335,51,24947,419,2000,435,2854,117,57,174
2020-02-28,18,3815,5443,2379,11877,11515,2482,56,25932,100,415,103,618,196,82,278
2020-02-28,19,3988,5475,2514,12410,12028,2583,59,27082,0,3,0,3,304,145,449
2020-02-28,20,3935,5412,2501,12152,11743,2505,58,26461,0,0,0,0,381,225,606
2020-02-28,21,3836,5272,2436,11764,11332,2389,56,25544,0,0,0,0,443,296,739
2020-02-28,22,3707,5066,2330,11215,10864,2267,54,24411,0,0,0,0,525,373,898
2020-02-28,23,3586,4858,2193,10504,10161,2104,51,22825,0,0,0,0,594,465,1059
2020-02-28,24,3438,4698,2082,9917,9495,1951,50,21416,0,0,0,0,661,580,1241
2020-02-29,1,3353,4594,2065,9753,9293,1887,49,20985,0,0,0,0,619,1082,1701
2020-02-29,2,3278,4556,2029,9353,8972,1818,51,20195,0,0,0,0,670,1220,1890
2020-02-29,3,3236,4561,2014,9108,8675,1759,54,19598,0,0,0,0,762,1396,2158
2020-02-29,4,3233,4600,2030,9014,8540,1724,56,19337,0,0,0,0,831,1504,2335
2020-02-29,5,3266,4694,2088,9076,8617,1732,61,19489,0,0,0,0,814,1496,2310
2020-02-29,6,3330,4851,2203,9384,8910,1789,66,20149,0,0,0,0,809,1195,2004
2020-02-29,7,3347,4950,2386,9856,9223,1875,71,21027,21,507,33,561,827,1398,2225
2020-02-29,8,3335,5051,2526,10097,9301,1836,69,21305,315,2628,339,3282,798,1397,2195
2020-02-29,9,3396,5095,2600,9955,9329,1746,63,21096,802,5026,838,6666,758,1287,2045
2020-02-29,10,3435,5068,2581,9607,9317,1655,58,20639,1113,6197,1185,8495,719,1195,1914
2020-02-29,11,3439,5010,2526,9263,9213,1535,52,20065,1223,6493,1354,9070,675,1273,1948
2020-02-29,12,3403,4936,2452,9010,9081,1456,50,19599,1243,6472,1431,9146,667,1462,2129
2020-02-29,13,3392,4873,2379,8880,9131,1451,48,19513,1264,6369,1474,9107,700,1712,2412
2020-02-29,14,3421,4831,2316,8897,9203,1474,48,19623,1307,6206,1482,8995,756,1954,2710
2020-02-29,15,3459,4818,2270,9047,9387,1559,47,20041,1348,5943,1436,8727,810,2162,2972
2020-02-29,16,3544,4840,2284,9518,9607,1725,48,20899,1285,5032,1251,7568,877,2245,3122
2020-02-29,17,3627,4968,2332,10113,9860,1916,50,21941,850,2855,774,4479,932,2160,3092
2020-02-29,18,3847,5208,2431,10861,10503,2185,55,23605,229,672,207,1108,950,1974,2924
2020-02-29,19,4007,5282,2571,11817,11133,2395,59,25405,0,16,0,16,956,1790,2746
2020-02-29,20,3947,5253,2549,11718,11024,2351,58,25151,0,6,0,6,909,1742,2651
2020-02-29,21,3833,5136,2484,11421,10781,2276,56,24535,0,0,0,0,818,1800,2618
2020-02-29,22,3701,4945,2393,11001,10418,2185,54,23660,0,0,0,0,753,1917,2670
2020-02-29,23,3569,4743,2259,10447,9957,2051,51,22507,0,0,0,0,682,2063,2745
2020-02-29,24,3438,4598,2156,9884,9387,1915,49,21237,0,0,0,0,584,2183,2767
2020-03-01,1,3373,4592,2100,9429,8918,1865,52,20279,0,0,0,0,591,2238,2829
2020-03-01,2,3300,4561,2080,9028,8587,1784,52,19465,0,0,0,0,528,2327,2855
2020-03-01,3,3258,4561,2088,8808,8332,1715,53,18922,0,0,0,0,457,2354,2811
2020-03-01,4,3244,4598,2123,8664,8217,1689,54,18640,0,0,0,0,405,2273,2678
2020-03-01,5,3247,4672,2200,8731,8120,1690,59,18615,0,0,0,0,341,2230,2571
2020-03-01,6,3286,4784,2335,8978,8268,1736,63,19059,0,0,0,0,281,2212,2493
2020-03-01,7,3279,4865,2531,9353,8392,1781,66,19620,31,436,28,495,237,2170,2407
2020-03-01,8,3276,4961,2667,9466,8360,1815,66,19731,328,2354,318,3000,214,2121,2335
2020-03-01,9,3331,4989,2730,9443,8411,1854,65,19774,756,4694,801,6251,224,2001,2225
2020-03-01,10,3391,5006,2683,9087,8467,1872,63,19491,942,6002,1069,8013,330,1879,2209
2020-03-01,11,3433,5007,2570,8823,8538,1849,60,19272,938,6343,1094,8375,494,1865,2359
2020-03-01,12,3466,5027,2455,8560,8539,1845,58,19002,898,6275,1082,8255,627,1899,2526
2020-03-01,13,3492,5037,2358,8450,8520,1847,57,18876,838,6062,984,7884,753,1917,2670
2020-03-01,14,3491,5049,2277,8472,8424,1881,57,18836,735,5630,795,7160,862,1914,2776
2020-03-01,15,3515,5066,2228,8621,8429,1931,56,19040,637,5156,663,6456,921,1852,2773
2020-03-01,16,3578,5136,2210,9110,8681,2003,57,19853,535,4228,497,5260,955,1799,2754
2020-03-01,17,3677,5224,2282,9821,9120,2128,60,21137,348,2291,264,2903,1006,1783,2789
2020-03-01,18,3879,5422,2421,10821,9888,2291,64,23078,103,499,67,669,1065,1764,2829
2020-03-01,19,4101,5522,2613,11837,10801,2498,71,25222,0,2,0,2,1103,1716,2819
2020-03-01,20,4094,5459,2636,11904,10795,2472,73,25259,0,0,0,0,1127,1597,2724
2020-03-01,21,4018,5300,2586,11590,10545,2384,71,24605,0,0,0,0,1150,1392,2542
2020-03-01,22,3872,5073,2459,11048,10168,2270,67,23567,0,0,0,0,1172,1106,2278
2020-03-01,23,3707,4876,2294,10343,9636,2095,64,22153,0,0,0,0,1189,901,2090
2020-03-01,24,3545,4766,2157,9645,9064,1943,62,20728,0,0,0,0,1196,796,1992
2020-03-02,1,3329,4763,2045,8861,8658,1845,57,19452,0,0,0,0,1147,595,1742
2020-03-02,2,3266,4771,2032,8549,8370,1790,58,18798,0,0,0,0,1124,569,1693
2020-03-02,3,3244,4814,2058,8442,8232,1741,60,18507,0,0,0,0,1110,461,1571
2020-03-02,4,3270,4935,2121,8493,8249,1737,64,18581,0,0,0,0,1116,350,1466
2020-03-02,5,3349,5185,2266,8832,8566,1796,69,19325,0,0,0,0,1119,298,1417
2020-03-02,6,3542,5576,2567,9627,9395,1971,77,21141,0,0,0,0,1112,323,1435
2020-03-02,7,3685,5841,2969,10842,10461,2197,84,23654,65,370,49,484,1108,421,1529
2020-03-02,8,3714,5861,3137,11230,10703,2233,82,24305,588,2009,481,3078,1091,442,1533
2020-03-02,9,3699,5807,3007,10719,10458,2121,75,23404,1254,4147,1114,6515,1077,394,1471
2020-03-02,10,3658,5728,2858,10005,10167,1977,69,22249,1477,5410,1454,8341,1087,438,1525
2020-03-02,11,3629,5637,2728,9543,9904,1848,64,21389,1481,5808,1560,8849,1090,629,1719
2020-03-02,12,3590,5555,2601,9219,9663,1782,59,20753,1458,5901,1598,8957,1086,807,1893
2020-03-02,13,3568,5527,2509,9063,9536,1758,57,20442,1445,5880,1608,8933,1086,887,1973
2020-03-02,14,3544,5484,2434,9124,9664,1810,56,20681,1445,5768,1586,8799,1089,914,2003
2020-03-02,15,3543,5460,2370,9297,9742,1897,54,21021,1450,5488,1529,8467,1088,912,2000
2020-03-02,16,3562,5482,2351,9843,9943,2029,55,21901,1372,4639,1335,7346,1081,937,2018
2020-03-02,17,3645,5572,2392,10676,10321,2209,58,23294,928,2683,835,4446,1066,976,2042
2020-03-02,18,3856,5786,2499,11598,11026,2417,62,25133,260,622,225,1107,1049,1179,2228
2020-03-02,19,4106,5892,2697,12434,11903,2639,66,27072,0,5,0,5,1030,1441,2471
2020-03-02,20,4104,5820,2708,12370,11803,2602,66,26871,0,3,0,3,1011,1468,2479
2020-03-02,21,4013,5620,2643,11967,11448,2498,65,26012,0,0,0,0,983,1358,2341
2020-03-02,22,3854,5327,2495,11271,10857,2362,64,24590,0,0,0,0,932,1141,2073
2020-03-02,23,3661,5077,2315,10409,10178,2156,61,22838,0,0,0,0,856,788,1644
2020-03-02,24,3495,4924,2157,9697,9592,1981,59,21363,0,0,0,0,756,502,1258
2020-03-03,1,3459,4790,2027,9515,9126,1883,54,20667,0,0,0,0,537,349,886
2020-03-03,2,3398,4777,1993,9201,8779,1821,56,19945,0,0,0,0,423,361,784
2020-03-03,3,3372,4798,1998,9058,8533,1775,59,19514,0,0,0,0,323,390,713
2020-03-03,4,3384,4898,2039,9063,8494,1768,62,19476,0,0,0,0,255,371,626
2020-03-03,5,3459,5130,2159,9361,8822,1826,70,20168,0,0,0,0,219,316,535
2020-03-03,6,3622,5517,2441,10137,9558,2000,78,21862,0,0,0,0,196,253,449
2020-03-03,7,3752,5742,2817,11218,10408,2206,85,24005,72,704,68,844,183,204,387
2020-03-03,8,3774,5748,2989,11665,10715,2169,80,24695,593,3338,543,4474,170,161,331
2020-03-03,9,3734,5684,2852,10984,10558,1953,71,23643,1244,6092,1192,8528,149,144,293
2020-03-03,10,3686,5601,2718,10309,10402,1773,64,22650,1458,7324,1507,10289,146,148,294
2020-03-03,11,3646,5511,2602,9901,10355,1664,59,22081,1458,7609,1592,10659,145,145,290
2020-03-03,12,3619,5429,2496,9693,10334,1618,55,21794,1435,7561,1617,10613,126,134,260
2020-03-03,13,3592,5409,2427,9606,10364,1598,53,21713,1422,7502,1618,10542,108,111,219
2020-03-03,14,3582,5371,2379,9788,10539,1667,52,22139,1424,7397,1588,10409,93,80,173
2020-03-03,15,3592,5357,2342,10024,10631,1767,50,22564,1436,7104,1526,10066,76,56,132
2020-03-03,16,3638,5379,2326,10581,10813,1932,50,23468,1362,6109,1333,8804,55,58,113
2020-03-03,17,3706,5448,2361,11278,10978,2162,52,24560,925,3614,838,5377,34,85,119
2020-03-03,18,3926,5651,2450,12058,11519,2426,56,26149,261,867,227,1355,32,120,152
2020-03-03,19,4148,5756,2605,12791,12268,2622,60,27832,0,13,0,13,52,158,210
2020-03-03,20,4123,5699,2623,12689,12091,2572,59,27502,0,0,0,0,79,195,274
2020-03-03,21,4026,5503,2557,12251,11702,2473,58,26574,0,0,0,0,105,205,310
2020-03-03,22,3867,5214,2419,11591,11181,2327,55,25242,0,0,0,0,116,188,304
2020-03-03,23,3682,4963,2245,10700,10380,2124,52,23346,0,0,0,0,101,174,275
2020-03-03,24,3511,4812,2094,9995,9640,1957,50,21731,0,0,0,0,77,158,235
2020-03-04,1,3390,4702,1980,9836,9248,1896,48,21114,0,0,0,0,82,184,266
2020-03-04,2,3324,4678,1946,9488,8914,1828,49,20366,0,0,0,0,67,146,213
2020-03-04,3,3292,4696,1946,9293,8713,1775,52,19921,0,0,0,0,58,117,175
2020-03-04,4,3303,4795,1984,9335,8657,1760,55,19895,0,0,0,0,45,92,137
2020-03-04,5,3373,5042,2097,9665,8834,1811,61,20458,0,0,0,0,35,66,101
2020-03-04,6,3545,5401,2371,10398,9481,1969,71,22006,0,0,0,0,31,39,70
2020-03-04,7,3679,5634,2758,11433,10289,2166,77,24053,68,716,72,856,28,24,52
2020-03-04,8,3689,5640,2921,11829,10612,2132,73,24735,521,3289,499,4309,23,28,51
2020-03-04,9,3657,5584,2796,11199,10525,1924,65,23801,1088,5944,1062,8094,16,32,48
2020-03-04,10,3622,5510,2665,10441,10462,1763,59,22814,1316,7141,1359,9816,11,36,47
2020-03-04,11,3598,5423,2554,10031,10345,1673,54,22192,1347,7416,1458,10221,9,42,51
2020-03-04,12,3569,5338,2454,9837,10303,1620,52,21901,1331,7370,1485,10186,7,46,53
2020-03-04,13,3546,5317,2380,9778,10320,1611,51,21849,1325,7294,1492,10111,6,47,53
2020-03-04,14,3547,5287,2333,9917,10475,1671,50,22202,1322,7121,1461,9904,6,49,55
2020-03-04,15,3569,5273,2304,10208,10578,1771,48,22694,1298,6662,1385,9345,7,56,63
2020-03-04,16,3637,5281,2291,10807,10771,1938,49,23653,1221,5613,1205,8039,8,71,79
2020-03-04,17,3692,5357,2323,11471,10962,2160,49,24730,840,3304,750,4894,12,95,107
2020-03-04,18,3887,5540,2406,12247,11479,2416,53,26282,240,790,200,1230,19,126,145
2020-03-04,19,4108,5643,2570,12854,12224,2610,57,27832,0,11,0,11,31,177,208
2020-03-04,20,4080,5594,2581,12701,12105,2571,56,27521,0,0,0,0,48,230,278
2020-03-04,21,3953,5415,2526,12180,11709,2468,54,26499,0,0,0,0,73,214,287
2020-03-04,22,3792,5131,2390,11503,11124,2330,51,25097,0,0,0,0,110,138,248
2020-03-04,23,3622,4882,2214,10631,10385,2125,48,23278,0,0,0,0,153,76,229
2020-03-04,24,3452,4730,2072,9884,9671,1951,46,21640,0,0,0,0,203,45,248
2020-03-05,1,3317,4596,1991,9725,9397,1886,47,21144,0,0,0,0,430,36,466
2020-03-05,2,3250,4570,1965,9466,9042,1821,48,20467,0,0,0,0,443,33,476
2020-03-05,3,3214,4587,1966,9292,8822,1758,51,20010,0,0,0,0,419,40,459
2020-03-05,4,3226,4685,2008,9288,8763,1739,53,19932,0,0,0,0,359,60,419
2020-03-05,5,3302,4909,2126,9406,8951,1781,59,20286,0,0,0,0,295,85,380
2020-03-05,6,3468,5285,2414,10070,9659,1943,68,21829,0,0,0,0,242,111,353
2020-03-05,7,3600,5521,2799,11189,10478,2141,74,23970,63,675,65,803,199,126,325
2020-03-05,8,3612,5532,2949,11629,10575,2125,70,24487,465,2846,452,3763,164,128,292
2020-03-05,9,3594,5479,2807,11167,10435,1961,64,23716,968,5037,966,6971,124,137,261
2020-03-05,10,3571,5428,2669,10675,10338,1822,58,22982,1184,6291,1260,8735,99,155,254
2020-03-05,11,3556,5359,2545,10187,10410,1762,54,22502,1216,6767,1360,9343,96,175,271
2020-03-05,12,3542,5281,2430,9954,10528,1737,52,22360,1196,6798,1381,9375,98,193,291
2020-03-05,13,3537,5262,2370,9849,10709,1747,52,22447,1190,6691,1388,9269,125,194,319
2020-03-05,14,3575,5235,2321,10022,10975,1810,51,22948,1165,6436,1349,8950,178,172,350
2020-03-05,15,3616,5220,2290,10311,11205,1913,51,23568,1080,5899,1249,8228,233,144,377
2020-03-05,16,3676,5231,2277,10776,11401,2087,52,24403,961,4723,1048,6732,286,122,408
2020-03-05,17,3726,5272,2303,11559,11509,2268,52,25475,646,2624,635,3905,356,104,460
2020-03-05,18,3902,5431,2370,12188,11804,2477,54,26612,184,603,166,953,439,95,534
2020-03-05,19,4104,5536,2502,12839,12455,2630,58,28071,0,5,0,5,503,90,593
2020-03-05,20,4066,5490,2519,12769,12221,2582,57,27717,0,0,0,0,580,75,655
2020-03-05,21,3940,5313,2471,12295,11831,2464,55,26733,0,0,0,0,649,64,713
2020-03-05,22,3732,5041,2344,11651,11244,2314,51,25349,0,0,0,0,666,58,724
2020-03-05,23,3567,4793,2179,10786,10469,2105,48,23496,0,0,0,0,624,55,679
2020-03-05,24,3400,4640,2039,10133,9800,1934,46,22002,0,0,0,0,543,57,600
2020-03-06,1,3273,4529,1947,9703,9348,1860,47,21048,0,0,0,0,604,36,640
2020-03-06,2,3208,4499,1907,9318,9042,1791,48,20288,0,0,0,0,486,35,521
2020-03-06,3,3172,4518,1904,9087,8850,1733,51,19813,0,0,0,0,386,36,422
2020-03-06,4,3178,4602,1935,9100,8741,1715,53,19702,0,0,0,0,323,39,362
2020-03-06,5,3255,4814,2038,9317,8917,1757,59,20145,0,0,0,0,285,39,324
2020-03-06,6,3402,5157,2287,10053,9569,1904,65,21687,0,0,0,0,253,37,290
2020-03-06,7,3525,5374,2647,11117,10211,2099,71,23592,53,601,69,723,215,38,253
2020-03-06,8,3561,5412,2791,11699,10589,2099,67,24521,383,2641,423,3447,177,42,219
2020-03-06,9,3556,5370,2690,11206,10516,1977,61,23828,816,4736,905,6457,170,42,212
2020-03-06,10,3534,5319,2584,10742,10258,1826,56,22951,1051,5921,1214,8186,170,42,212
2020-03-06,11,3524,5243,2482,10401,10159,1726,51,22406,1148,6350,1341,8839,160,50,210
2020-03-06,12,3511,5154,2389,10104,10060,1666,49,21946,1171,6386,1380,8937,171,73,244
2020-03-06,13,3546,5129,2312,9933,10251,1658,48,21958,1177,6334,1396,8907,207,134,341
2020-03-06,14,3575,5108,2261,10034,10476,1691,48,22316,1169,6126,1366,8661,267,267,534
2020-03-06,15,3624,5086,2220,10210,10612,1773,47,22710,1124,5666,1306,8096,363,521,884
2020-03-06,16,3696,5076,2202,10564,10782,1922,49,23384,1052,4759,1160,6971,468,784,1252
2020-03-06,17,3745,5102,2228,11101,10899,2124,49,24240,713,2850,735,4298,525,954,1479
2020-03-06,18,3877,5234,2295,11811,11219,2345,51,25494,192,694,198,1084,530,1028,1558
2020-03-06,19,4065,5294,2466,12495,11874,2518,55,27010,0,17,0,17,535,1032,1567
2020-03-06,20,4015,5231,2450,12356,11741,2457,53,26676,0,8,0,8,577,1040,1617
2020-03-06,21,3891,5100,2375,11969,11436,2357,52,25899,0,0,0,0,649,1111,1760
2020-03-06,22,3731,4892,2259,11485,10974,2254,49,24850,0,0,0,0,707,1203,1910
2020-03-06,23,3564,4683,2126,10726,10314,2097,46,23272,0,0,0,0,661,1246,1907
2020-03-06,24,3406,4521,2008,10111,9689,1940,45,21874,0,0,0,0,553,1218,1771
2020-03-07,1,3319,4419,1992,9672,9166,1869,45,20846,0,0,0,0,382,1218,1600
2020-03-07,2,3225,4383,1957,9284,8862,1790,46,20074,0,0,0,0,337,1182,1519
2020-03-07,3,3173,4384,1948,9054,8599,1722,47,19526,0,0,0,0,279,1174,1453
2020-03-07,4,3158,4421,1968,8939,8460,1692,49,19237,0,0,0,0,232,1184,1416
2020-03-07,5,3185,4518,2028,9012,8522,1705,53,19390,0,0,0,0,205,1177,1382
2020-03-07,6,3252,4666,2158,9317,8809,1763,58,20056,0,0,0,0,193,1173,1366
2020-03-07,7,3247,4754,2334,9787,8932,1831,62,20714,19,557,32,608,176,1168,1344
2020-03-07,8,3250,4860,2467,10109,9021,1891,62,21177,154,2442,209,2805,169,1122,1291
2020-03-07,9,3309,4905,2527,10372,9146,1969,57,21640,390,4436,479,5305,193,1093,1286
2020-03-07,10,3352,4910,2507,10540,9249,2060,52,21998,571,5592,670,6833,213,1148,1361
2020-03-07,11,3379,4872,2445,10476,9224,2053,49,21894,686,5998,784,7468,213,1257,1470
2020-03-07,12,3400,4818,2369,10348,9099,2006,46,21591,770,5988,867,7625,204,1415,1619
2020-03-07,13,3422,4800,2282,10261,9019,1957,44,21373,779,5800,872,7451,184,1538,1722
2020-03-07,14,3432,4783,2213,10201,8960,1940,43,21236,740,5411,837,6988,177,1579,1756
2020-03-07,15,3476,4789,2173,10197,8938,1941,42,21209,691,4882,781,6354,181,1630,1811
2020-03-07,16,3522,4830,2174,10431,9121,1978,44,21669,588,3919,634,5141,190,1696,1886
2020-03-07,17,3594,4922,2222,10930,9429,2071,46,22571,371,2163,384,2918,201,1717,1918
2020-03-07,18,3770,5096,2303,11484,10083,2162,49,23872,102,482,108,692,195,1677,1872
2020-03-07,19,3955,5195,2452,12205,10938,2384,53,25675,0,3,0,3,172,1588,1760
2020-03-07,20,3909,5137,2456,12183,10919,2347,52,25593,0,0,0,0,151,1495,1646
2020-03-07,21,3793,5013,2401,11841,10628,2272,51,24887,0,0,0,0,141,1472,1613
2020-03-07,22,3655,4811,2312,11403,10313,2186,49,24046,0,0,0,0,128,1483,1611
2020-03-07,23,3523,4608,2197,10741,9803,2046,46,22728,0,0,0,0,108,1482,1590
2020-03-07,24,3400,4450,2096,10109,9275,1914,45,21436,0,0,0,0,90,1472,1562
2020-03-08,1,3307,4341,2002,9656,8966,1863,47,20646,0,0,0,0,77,1334,1411
2020-03-08,2,3225,4293,1967,9281,8607,1786,47,19834,0,0,0,0,63,1301,1364
2020-03-08,3,3225,4293,1967,9281,8607,1786,47,19834,0,0,0,0,63,1301,1364
2020-03-08,4,3161,4302,1995,8943,8165,1688,50,18959,0,0,0,0,51,1282,1333
2020-03-08,5,3162,4364,2052,8953,8063,1686,52,18867,0,0,0,0,39,1279,1318
2020-03-08,6,3199,4463,2159,9134,8195,1723,56,19213,0,0,0,0,29,1269,1298
2020-03-08,7,3302,4644,2333,9581,8540,1828,62,20141,0,0,0,0,23,1241,1264
2020-03-08,8,3270,4747,2522,10144,8633,1886,67,20825,81,793,74,948,16,1194,1210
2020-03-08,9,3290,4788,2616,10114,8475,1871,63,20619,521,3357,502,4380,12,1078,1090
2020-03-08,10,3340,4809,2648,9866,8265,1829,60,20117,1053,5905,1082,8040,11,895,906
2020-03-08,11,3351,4797,2584,9499,7984,1753,56,19388,1253,7096,1386,9735,12,772,784
2020-03-08,12,3304,4811,2437,9115,7831,1597,53,18688,1222,7350,1431,10003,20,790,810
2020-03-08,13,3294,4805,2336,8942,7733,1471,52,18290,1156,7265,1418,9839,35,885,920
2020-03-08,14,3278,4807,2243,8919,7764,1419,51,18247,1111,7166,1388,9665,46,1011,1057
2020-03-08,15,3292,4809,2174,8988,7820,1428,50,18379,1031,6972,1300,9303,40,1171,1211
2020-03-08,16,3335,4843,2134,9283,8103,1526,51,19054,912,6549,1186,8647,33,1289,1322
2020-03-08,17,3385,4853,2155,9774,8452,1720,51,20091,758,5556,1005,7319,38,1332,1370
2020-03-08,18,3455,4845,2205,10377,9118,1989,54,21631,470,3241,620,4331,79,1346,1425
2020-03-08,19,3607,5036,2285,10981,9786,2209,55,23134,126,795,163,1084,127,1310,1437
2020-03-08,20,3818,5213,2489,11907,10538,2349,58,24951,0,9,0,9,129,1226,1355
2020-03-08,21,3809,5112,2506,11923,10630,2339,57,25056,0,1,0,1,94,1137,1231
2020-03-08,22,3705,4890,2401,11434,10416,2255,54,24276,0,0,0,0,68,1042,1110
2020-03-08,23,3616,4653,2234,10655,9908,2093,51,22811,0,0,0,0,65,945,1010
2020-03-08,24,3450,4488,2093,9896,9295,1921,49,21272,0,0,0,0,56,845,901
2020-03-09,1,3292,4378,1982,9355,8706,1823,51,20029,0,0,0,0,48,803,851
2020-03-09,2,3212,4367,1955,8996,8462,1759,51,19368,0,0,0,0,44,690,734
2020-03-09,3,3179,4379,1967,8765,8302,1714,53,18945,0,0,0,0,44,558,602
2020-03-09,4,3191,4493,2022,8833,8262,1697,56,18943,0,0,0,0,39,474,513
2020-03-09,5,3256,4694,2148,9103,8537,1743,60,19538,0,0,0,0,30,412,442
2020-03-09,6,3436,5070,2415,9759,9218,1895,68,21036,0,0,0,0,23,354,377
2020-03-09,7,3695,5426,2811,10793,10245,2159,77,23369,0,0,0,0,19,279,298
2020-03-09,8,3704,5480,3035,11635,10699,2268,79,24776,27,595,39,661,21,180,201
2020-03-09,9,3672,5473,2980,11389,10637,2144,74,24370,206,2470,256,2932,27,111,138
2020-03-09,10,3635,5436,2882,11066,10378,1970,68,23582,483,4422,569,5474,31,87,118
2020-03-09,11,3607,5374,2767,10885,10084,1815,63,22943,688,5608,815,7111,39,100,139
2020-03-09,12,3581,5304,2654,10594,9915,1757,60,22422,810,6008,1008,7826,44,125,169
2020-03-09,13,3547,5281,2574,10340,9906,1747,58,22147,869,6002,1117,7988,37,141,178
2020-03-09,14,3518,5236,2494,10272,9984,1804,57,22212,884,5802,1112,7798,33,155,188
2020-03-09,15,3514,5197,2428,10284,10035,1926,56,22397,879,5248,1066,7193,31,156,187
2020-03-09,16,3538,5164,2383,10456,10170,2080,56,22857,837,4515,986,6338,27,141,168
2020-03-09,17,3586,5145,2363,10788,10384,2224,57,23546,716,3486,794,4996,28,116,144
2020-03-09,18,3650,5133,2394,11273,10724,2357,59,24507,447,1816,454,2717,29,107,136
2020-03-09,19,3805,5294,2459,11775,11084,2440,61,25454,120,392,117,629,36,120,156
2020-03-09,20,4032,5451,2646,12553,11741,2563,63,27014,0,1,0,1,47,129,176
2020-03-09,21,3980,5313,2657,12480,11709,2513,62,26857,0,1,0,1,57,138,195
2020-03-09,22,3801,5034,2537,11835,11266,2384,59,25638,0,0,0,0,70,139,209
2020-03-09,23,3666,4760,2358,10909,10493,2169,55,23720,0,0,0,0,87,164,251
2020-03-09,24,3487,4574,2200,10093,9726,1979,51,21945,0,0,0,0,117,192,309
2020-03-10,1,3346,4463,2068,9701,9247,1849,50,20940,0,0,0,0,184,215,399
2020-03-10,2,3258,4431,2033,9351,8932,1786,49,20212,0,0,0,0,214,169,383
2020-03-10,3,3219,4432,2031,9131,8724,1736,49,19736,0,0,0,0,299,149,448
2020-03-10,4,3219,4516,2076,9095,8653,1721,52,19615,0,0,0,0,377,159,536
2020-03-10,5,3274,4728,2196,9319,8869,1753,54,20090,0,0,0,0,398,206,604
2020-03-10,6,3432,5099,2464,9939,9501,1889,60,21485,0,0,0,0,352,296,648
2020-03-10,7,3669,5441,2859,11121,10540,2138,67,23961,0,0,0,0,301,423,724
2020-03-10,8,3676,5477,3086,11930,11001,2261,71,25358,35,204,46,285,306,577,883
2020-03-10,9,3644,5434,3006,11718,11072,2259,71,25213,238,1074,288,1600,279,761,1040
2020-03-10,10,3624,5390,2879,11294,11108,2254,67,24814,546,2170,660,3376,227,936,1163
2020-03-10,11,3614,5342,2737,10840,11120,2238,63,24352,772,2819,901,4492,197,1098,1295
2020-03-10,12,3592,5279,2606,10513,11080,2243,61,23987,895,3140,980,5015,168,1224,1392
2020-03-10,13,3563,5259,2508,10267,11084,2228,59,23727,940,3398,1012,5350,107,1317,1424
2020-03-10,14,3554,5217,2415,10293,11140,2237,57,23816,929,3402,950,5281,60,1369,1429
2020-03-10,15,3566,5177,2350,10364,11110,2217,55,23836,879,3147,814,4840,50,1329,1379
2020-03-10,16,3618,5153,2309,10587,11057,2220,54,24009,790,2791,699,4280,33,1224,1257
2020-03-10,17,3651,5122,2306,11019,10995,2246,55,24407,627,2082,543,3252,21,1067,1088
2020-03-10,18,3633,5098,2329,11569,11101,2320,56,25137,355,1016,306,1677,22,855,877
2020-03-10,19,3784,5266,2383,11981,11251,2404,59,25786,89,216,84,389,30,662,692
2020-03-10,20,4016,5430,2528,12638,11811,2508,63,27111,0,0,0,0,58,502,560
2020-03-10,21,3978,5297,2560,12543,11751,2462,62,26912,0,0,0,0,91,377,468
2020-03-10,22,3837,5026,2449,11933,11347,2330,59,25764,0,0,0,0,103,281,384
2020-03-10,23,3699,4756,2270,11019,10586,2123,56,23878,0,0,0,0,102,192,294
2020-03-10,24,3508,4573,2118,10219,9821,1940,52,22125,0,0,0,0,103,177,280
2020-03-11,1,3302,4461,2018,9761,9420,1869,47,21191,0,0,0,0,258,150,408
2020-03-11,2,3219,4433,1972,9320,9052,1796,46,20308,0,0,0,0,242,155,397
2020-03-11,3,3190,4436,1961,9110,8906,1739,47,19896,0,0,0,0,188,152,340
2020-03-11,4,3196,4519,1995,9093,8824,1710,48,19773,0,0,0,0,107,141,248
2020-03-11,5,3263,4733,2096,9296,8997,1742,52,20183,0,0,0,0,59,123,182
2020-03-11,6,3415,5112,2346,9902,9516,1877,59,21453,0,0,0,0,42,113,155
2020-03-11,7,3668,5433,2711,11039,10534,2128,66,23868,0,0,0,0,31,112,143
2020-03-11,8,3651,5455,2919,11849,11163,2250,68,25422,79,255,63,397,26,104,130
2020-03-11,9,3597,5407,2865,11709,10932,2225,66,25015,434,1286,358,2078,26,92,118
2020-03-11,10,3561,5347,2766,11318,10768,2183,63,24405,865,2575,756,4196,26,89,115
2020-03-11,11,3526,5271,2655,10817,10557,2078,60,23587,1087,3953,1005,6045,33,94,127
2020-03-11,12,3490,5182,2553,10399,10337,1920,58,22810,1156,4366,1103,6625,36,106,142
2020-03-11,13,3451,5155,2480,10170,10193,1821,56,22338,1170,4537,1148,6855,31,108,139
2020-03-11,14,3441,5110,2419,10091,10171,1815,55,22227,1175,4563,1146,6884,27,97,124
2020-03-11,15,3450,5077,2373,10101,10162,1842,53,22252,1182,4472,1090,6744,28,102,130
2020-03-11,16,3495,5057,2336,10292,10177,1940,53,22555,1174,4284,1029,6487,34,118,152
2020-03-11,17,3538,5041,2323,10702,10389,2095,53,23330,1097,3683,890,5670,53,137,190
2020-03-11,18,3578,5031,2338,11328,10714,2249,54,24438,749,2183,558,3490,86,150,236
2020-03-11,19,3710,5188,2382,11853,11197,2385,56,25583,217,554,161,932,142,157,299
2020-03-11,20,3924,5342,2527,12499,11889,2536,60,27075,0,3,0,3,219,157,376
2020-03-11,21,3896,5223,2555,12436,11808,2483,59,26878,0,2,0,2,272,134,406
2020-03-11,22,3756,4958,2446,11826,11347,2359,56,25680,0,0,0,0,284,100,384
2020-03-11,23,3627,4689,2271,11017,10641,2144,53,23948,0,0,0,0,284,85,369
2020-03-11,24,3443,4505,2115,10228,9845,1957,49,22172,0,0,0,0,285,84,369
2020-03-12,1,3283,4397,2037,9802,9485,1873,47,21304,0,0,0,0,304,53,357
2020-03-12,2,3195,4365,2001,9432,9103,1800,46,20478,0,0,0,0,253,59,312
2020-03-12,3,3153,4375,1995,9207,8860,1742,47,19950,0,0,0,0,200,70,270
2020-03-12,4,3153,4454,2032,9147,8737,1708,50,19735,0,0,0,0,164,84,248
2020-03-12,5,3211,4666,2145,9326,8945,1738,54,20157,0,0,0,0,137,107,244
2020-03-12,6,3360,5034,2412,9966,9570,1868,60,21559,0,0,0,0,113,142,255
2020-03-12,7,3615,5367,2797,11131,10723,2118,69,24135,0,0,0,0,99,183,282
2020-03-12,8,3599,5399,3018,12052,11114,2234,70,25565,143,477,110,730,95,218,313
2020-03-12,9,3573,5365,2964,11562,10936,2228,67,24890,709,2037,583,3329,80,237,317
2020-03-12,10,3554,5325,2844,10981,10760,2160,64,24061,1276,3715,1149,6140,54,290,344
2020-03-12,11,3530,5279,2716,10331,10579,2118,60,23182,1453,4496,1433,7382,44,402,446
2020-03-12,12,3518,5204,2596,9851,10384,2124,57,22509,1466,4554,1520,7540,47,501,548
2020-03-12,13,3501,5187,2506,9615,10362,2155,55,22280,1450,4435,1554,7439,49,585,634
2020-03-12,14,3511,5143,2419,9631,10489,2178,53,22445,1438,4092,1530,7060,52,708,760
2020-03-12,15,3536,5104,2340,9791,10672,2190,51,22795,1440,3502,1432,6374,61,781,842
2020-03-12,16,3579,5069,2294,10037,10713,2211,51,23103,1438,2903,1305,5646,86,730,816
2020-03-12,17,3634,5021,2282,10718,10716,2253,51,23830,1351,2078,1071,4500,137,693,830
2020-03-12,18,3644,5009,2298,11262,10776,2296,52,24479,938,979,623,2540,221,719,940
2020-03-12,19,3746,5169,2348,11773,11046,2365,54,25332,279,200,166,645,339,841,1180
2020-03-12,20,3939,5342,2517,12402,11874,2518,59,26946,0,0,0,0,419,1097,1516
2020-03-12,21,3888,5218,2554,12335,11824,2466,58,26777,0,0,0,0,425,1322,1747
2020-03-12,22,3746,4964,2452,11818,11435,2349,55,25751,0,0,0,0,419,1348,1767
2020-03-12,23,3626,4705,2281,10979,10690,2141,52,23956,0,0,0,0,419,1249,1668
2020-03-12,24,3435,4539,2128,10177,10014,1958,48,22292,0,0,0,0,390,1174,1564
2020-03-13,1,3271,4499,2046,9686,9349,1874,47,21049,0,0,0,0,426,977,1403
2020-03-13,2,3193,4482,2011,9287,8905,1799,47,20131,0,0,0,0,346,955,1301
2020-03-13,3,3156,4494,2006,9058,8611,1736,48,19544,0,0,0,0,299,944,1243
2020-03-13,4,3151,4580,2041,9029,8522,1708,50,19403,0,0,0,0,260,958,1218
2020-03-13,5,3207,4779,2146,9217,8742,1737,54,19844,0,0,0,0,208,978,1186
2020-03-13,6,3364,5123,2393,9808,9378,1861,59,21203,0,0,0,0,172,1018,1190
2020-03-13,7,3604,5443,2747,10906,10410,2102,65,23580,0,0,0,0,182,1031,1213
2020-03-13,8,3599,5482,2959,11666,10920,2234,66,24980,154,447,69,670,198,995,1193
2020-03-13,9,3584,5428,2917,11442,11031,2278,64,24910,743,1845,444,3032,176,913,1089
2020-03-13,10,3573,5362,2814,10847,11117,2263,61,24384,1316,3259,966,5541,153,858,1011
2020-03-13,11,3569,5286,2684,10251,11101,2229,57,23733,1495,4110,1326,6931,161,906,1067
2020-03-13,12,3538,5185,2568,9757,11043,2209,54,23154,1503,4524,1507,7534,175,1064,1239
2020-03-13,13,3513,5137,2475,9480,10990,2190,52,22804,1472,4669,1571,7712,209,1260,1469
2020-03-13,14,3509,5070,2388,9390,10949,2210,50,22691,1452,4585,1577,7614,292,1432,1724
2020-03-13,15,3526,5008,2305,9385,10890,2234,49,22650,1452,4321,1569,7342,472,1574,2046
2020-03-13,16,3578,4953,2253,9569,10806,2226,49,22741,1449,3982,1499,6930,727,1658,2385
2020-03-13,17,3589,4908,2251,10083,10829,2238,50,23289,1362,3330,1300,5992,923,1683,2606
2020-03-13,18,3556,4875,2278,10743,10809,2224,51,23917,941,1915,829,3685,1013,1629,2642
2020-03-13,19,3665,5028,2313,11287,10981,2284,52,24696,277,457,230,964,1039,1543,2582
2020-03-13,20,3887,5181,2446,11917,11767,2449,56,26283,0,1,0,1,1054,1469,2523
2020-03-13,21,3866,5101,2455,11921,11668,2415,56,26153,0,0,0,0,1064,1405,2469
2020-03-13,22,3776,4909,2356,11480,11374,2334,54,25334,0,0,0,0,1069,1394,2463
2020-03-13,23,3690,4683,2217,10763,10769,2172,52,23849,0,0,0,0,1077,1413,2490
2020-03-13,24,3517,4500,2092,10063,10038,2001,50,22244,0,0,0,0,1080,1420,2500
2020-03-14,1,3365,4422,2152,9683,9560,1875,49,21262,0,0,0,0,1038,1286,2324
2020-03-14,2,3273,4388,2116,9275,9060,1793,49,20272,0,0,0,0,839,1268,2107
2020-03-14,3,3219,4364,2099,9001,8780,1719,50,19644,0,0,0,0,585,1240,1825
2020-03-14,4,3203,4394,2113,8884,8634,1679,52,19344,0,0,0,0,417,1167,1584
2020-03-14,5,3231,4466,2169,8901,8733,1681,54,19464,0,0,0,0,327,1063,1390
2020-03-14,6,3287,4596,2277,9129,8977,1721,58,19978,0,0,0,0,286,986,1272
2020-03-14,7,3392,4762,2448,9620,9474,1828,66,21081,0,0,0,0,279,944,1223
2020-03-14,8,3356,4880,2638,10132,9561,1909,67,21762,97,716,51,864,255,924,1179
2020-03-14,9,3391,4937,2779,10372,9659,1979,65,22166,467,2792,296,3555,194,905,1099
2020-03-14,10,3411,4902,2801,10461,9775,1991,61,22378,849,4769,628,6246,189,913,1102
2020-03-14,11,3403,4835,2747,10416,9697,1923,56,22185,975,5720,848,7543,248,952,1200
2020-03-14,12,3375,4762,2666,10206,9625,1830,53,21804,969,5944,967,7880,306,991,1297
2020-03-14,13,3358,4708,2580,10034,9228,1742,51,21149,946,5893,1025,7864,353,1050,1403
2020-03-14,14,3348,4671,2501,9880,9115,1661,51,20801,936,5703,1042,7681,361,1105,1466
2020-03-14,15,3369,4646,2444,9783,9165,1614,49,20711,927,5368,1061,7356,369,1127,1496
2020-03-14,16,3431,4651,2413,9848,9197,1671,49,20865,870,4958,1028,6856,404,1128,1532
2020-03-14,17,3508,4684,2436,10151,9513,1780,52,21602,763,4162,877,5802,400,1088,1488
2020-03-14,18,3541,4707,2446,10532,9841,1919,52,22445,529,2398,547,3474,366,1034,1400
2020-03-14,19,3626,4874,2473,10849,10240,2086,54,23327,165,568,151,884,328,991,1319
2020-03-14,20,3826,5035,2590,11499,11161,2296,57,25109,0,0,0,0,272,975,1247
2020-03-14,21,3804,4962,2602,11599,11194,2268,57,25216,0,0,0,0,206,968,1174
2020-03-14,22,3716,4794,2521,11231,10910,2203,55,24500,0,0,0,0,158,971,1129
2020-03-14,23,3639,4580,2389,10664,10404,2063,52,23279,0,0,0,0,144,998,1142
2020-03-14,24,3494,4390,2272,10016,9764,1916,49,21849,0,0,0,0,143,1044,1187
2020-03-15,1,3345,4329,2277,9566,9045,1829,50,20585,0,0,0,0,173,1142,1315
2020-03-15,2,3260,4275,2245,9138,8686,1747,50,19716,0,0,0,0,159,1133,1292
2020-03-15,3,3215,4255,2242,8954,8390,1681,52,19171,0,0,0,0,156,1112,1268
2020-03-15,4,3198,4273,2270,8889,8226,1642,54,18906,0,0,0,0,173,1076,1249
2020-03-15,5,3207,4324,2337,8894,8215,1640,56,18900,0,0,0,0,183,1056,1239
2020-03-15,6,3256,4419,2449,9016,8310,1669,61,19151,0,0,0,0,212,1011,1223
2020-03-15,7,3329,4575,2625,9312,8621,1755,69,19853,0,0,0,0,259,924,1183
2020-03-15,8,3293,4691,2817,9712,8510,1802,69,20190,52,814,78,944,294,832,1126
2020-03-15,9,3307,4722,2964,10083,8822,1804,67,20871,258,3117,378,3753,308,747,1055
2020-03-15,10,3338,4724,2959,10126,8697,1749,62,20730,517,5213,727,6457,317,754,1071
2020-03-15,11,3329,4689,2859,10013,8520,1676,58,20363,688,6293,885,7866,348,843,1191
2020-03-15,12,3327,4700,2757,9895,8490,1614,54,20149,764,6646,897,8307,370,953,1323
2020-03-15,13,3322,4685,2665,9880,8397,1564,53,19989,801,6585,909,8295,363,1075,1438
2020-03-15,14,3314,4707,2583,9871,8342,1520,52,19881,812,6429,908,8149,336,1178,1514
2020-03-15,15,3333,4735,2529,9814,8396,1514,51,19872,829,6207,893,7929,300,1246,1546
2020-03-15,16,3395,4788,2508,9823,8591,1612,51,20170,813,5869,854,7536,269,1268,1537
2020-03-15,17,3456,4813,2545,10091,8827,1756,51,20816,710,5069,710,6489,259,1254,1513
2020-03-15,18,3548,4823,2586,10622,9370,1920,54,22060,466,3026,431,3923,250,1228,1478
2020-03-15,19,3645,4979,2669,11080,9922,2096,56,23249,134,731,118,983,223,1209,1432
2020-03-15,20,3849,5139,2809,11856,10838,2317,60,25166,0,5,0,5,161,1166,1327
2020-03-15,21,3837,5033,2823,11994,10835,2289,60,25273,0,2,0,2,103,1079,1182
2020-03-15,22,3724,4817,2706,11535,10552,2193,57,24433,0,0,0,0,67,1020,1087
2020-03-15,23,3630,4580,2527,10740,9988,2032,54,22910,0,0,0,0,41,982,1023
2020-03-15,24,3459,4405,2383,10016,9362,1882,53,21407,0,0,0,0,24,951,975
2020-03-16,1,3332,4298,2263,9785,8978,1811,52,20722,0,0,0,0,24,983,1007
2020-03-16,2,3251,4272,2244,9457,8702,1750,52,20056,0,0,0,0,28,956,984
2020-03-16,3,3215,4283,2265,9289,8530,1697,54,19665,0,0,0,0,33,953,986
2020-03-16,4,3220,4377,2325,9284,8526,1675,57,19637,0,0,0,0,31,937,968
2020-03-16,5,3279,4590,2473,9626,8759,1719,61,20260,0,0,0,0,32,885,917
2020-03-16,6,3454,4965,2756,10323,9532,1865,69,21885,0,0,0,0,48,814,862
2020-03-16,7,3695,5314,3154,11537,10639,2121,78,24471,0,0,0,0,54,740,794
2020-03-16,8,3716,5397,3378,12450,11069,2240,81,25937,27,756,41,824,56,660,716
2020-03-16,9,3701,5396,3325,12358,10803,2262,76,25602,140,2718,222,3080,65,526,591
2020-03-16,10,3668,5395,3207,12137,10564,2173,69,25044,330,4353,460,5143,53,429,482
2020-03-16,11,3655,5366,3069,11899,10458,2075,65,24592,490,5097,585,6172,37,440,477
2020-03-16,12,3629,5312,2929,11671,10369,1979,61,24174,566,5337,649,6552,26,519,545
2020-03-16,13,3608,5296,2833,11506,10387,1951,59,23996,614,5354,715,6683,15,650,665
2020-03-16,14,3578,5269,2746,11377,10394,1988,58,23910,624,5168,689,6481,13,834,847
2020-03-16,15,3572,5248,2673,11334,10475,2022,57,23982,606,4788,606,6000,16,1049,1065
2020-03-16,16,3586,5229,2640,11392,10612,2049,57,24203,572,4280,533,5385,19,1236,1255
2020-03-16,17,3622,5216,2651,11661,10764,2125,58,24701,473,3388,405,4266,22,1356,1378
2020-03-16,18,3699,5208,2683,12138,11042,2201,60,25535,287,1790,222,2299,27,1374,1401
2020-03-16,19,3812,5317,2769,12633,11405,2354,62,26550,80,373,62,515,34,1385,1419
2020-03-16,20,4054,5433,2897,13295,12265,2547,66,28269,0,0,0,0,44,1397,1441
2020-03-16,21,4017,5295,2912,13318,12095,2493,65,28066,0,0,0,0,52,1313,1365
2020-03-16,22,3863,5013,2780,12679,11585,2359,62,26780,0,0,0,0,53,1238,1291
2020-03-16,23,3710,4738,2586,11723,10784,2148,58,24808,0,0,0,0,54,1197,1251
2020-03-16,24,3523,4539,2421,10865,10067,1970,56,23052,0,0,0,0,53,1177,1230
2020-03-17,1,3382,4390,2266,9983,9339,1893,58,21368,0,0,0,0,74,1189,1263
2020-03-17,2,3297,4353,2230,9633,8967,1817,58,20569,0,0,0,0,96,1160,1256
2020-03-17,3,3260,4355,2233,9424,8689,1758,60,20025,0,0,0,0,100,1031,1131
2020-03-17,4,3258,4437,2276,9416,8627,1728,63,19929,0,0,0,0,94,910,1004
2020-03-17,5,3319,4647,2395,9668,8855,1769,67,20454,0,0,0,0,89,881,970
2020-03-17,6,3486,5020,2671,10336,9627,1907,74,22042,0,0,0,0,81,878,959
2020-03-17,7,3719,5346,3055,11443,10723,2172,83,24517,0,0,0,0,75,828,903
2020-03-17,8,3733,5393,3254,12327,11090,2283,86,25883,120,950,139,1209,75,758,833
2020-03-17,9,3702,5360,3205,12083,10984,2197,82,25445,577,3526,652,4755,70,666,736
2020-03-17,10,3672,5330,3080,11508,10710,2053,76,24443,1067,5667,1199,7933,61,603,664
2020-03-17,11,3653,5286,2947,10917,10443,1902,73,23427,1293,6489,1444,9226,55,606,661
2020-03-17,12,3628,5234,2825,10399,10248,1756,69,22564,1327,6570,1486,9383,53,651,704
2020-03-17,13,3599,5221,2740,10038,10199,1644,65,22040,1290,6327,1461,9078,49,730,779
2020-03-17,14,3580,5196,2660,9907,10131,1601,62,21795,1258,6015,1413,8686,45,804,849
2020-03-17,15,3576,5180,2589,9850,10048,1611,60,21662,1236,5644,1327,8207,47,854,901
2020-03-17,16,3600,5169,2539,10010,10109,1697,59,21969,1175,5125,1223,7523,58,873,931
2020-03-17,17,3664,5148,2549,10426,10430,1898,61,22908,1047,4299,1029,6375,68,861,929
2020-03-17,18,3702,5144,2602,11154,10762,2133,64,24205,666,2568,629,3863,73,866,939
2020-03-17,19,3827,5258,2651,11833,11170,2341,66,25506,207,618,176,1001,76,899,975
2020-03-17,20,4065,5388,2786,12531,12127,2566,72,27390,0,0,0,0,72,951,1023
2020-03-17,21,4045,5252,2798,12658,12115,2521,73,27462,0,1,0,1,66,1056,1122
2020-03-17,22,3902,4979,2667,12101,11699,2395,70,26362,0,0,0,0,69,1170,1239
2020-03-17,23,3739,4704,2477,11223,10951,2189,67,24527,0,0,0,0,77,1223,1300
2020-03-17,24,3551,4514,2304,10411,10211,2017,64,22802,0,0,0,0,84,1241,1325
2020-03-18,1,3377,4364,2168,9851,9624,1877,62,21508,0,0,0,0,114,1193,1307
2020-03-18,2,3304,4329,2134,9524,9259,1804,62,20745,0,0,0,0,99,1165,1264
2020-03-18,3,3271,4333,2132,9351,8986,1767,63,20262,0,0,0,0,89,1058,1147
2020-03-18,4,3276,4413,2172,9293,8941,1751,66,20146,0,0,0,0,79,920,999
2020-03-18,5,3349,4615,2297,9531,9239,1820,70,20757,0,0,0,0,70,840,910
2020-03-18,6,3521,4982,2563,10266,9921,1980,78,22341,0,0,0,0,61,774,835
2020-03-18,7,3758,5307,2928,11420,10986,2250,86,24837,0,1,0,1,52,721,773
2020-03-18,8,3760,5349,3117,12199,11389,2378,88,26151,176,681,140,997,41,711,752
2020-03-18,9,3708,5323,3067,11897,11433,2375,84,25889,757,2520,639,3916,32,647,679
2020-03-18,10,3653,5295,2953,11590,11107,2332,78,25205,1266,4010,1159,6435,30,540,570
2020-03-18,11,3613,5269,2828,11129,10870,2220,75,24390,1405,4576,1385,7366,30,481,511
2020-03-18,12,3570,5219,2714,10743,10632,2143,71,23685,1366,4765,1424,7555,29,491,520
2020-03-18,13,3538,5214,2631,10309,10509,2108,67,23088,1307,4774,1417,7498,26,576,602
2020-03-18,14,3517,5176,2556,10178,10502,2054,64,22892,1258,4624,1383,7265,24,789,813
2020-03-18,15,3509,5152,2497,10145,10418,2021,61,22740,1194,4440,1301,6935,24,1134,1158
2020-03-18,16,3540,5132,2450,10298,10537,2054,60,23045,1104,4205,1197,6506,25,1640,1665
2020-03-18,17,3603,5106,2430,10682,10751,2094,61,23687,951,3701,1026,5678,30,2080,2110
2020-03-18,18,3654,5094,2469,11123,10969,2221,64,24478,573,2350,653,3576,37,2310,2347
2020-03-18,19,3777,5211,2520,11717,11287,2392,66,25556,167,626,188,981,43,2494,2537
2020-03-18,20,4020,5360,2644,12486,12126,2513,72,27291,0,1,0,1,48,2680,2728
2020-03-18,21,4014,5233,2670,12459,12103,2490,73,27219,0,0,0,0,59,2716,2775
2020-03-18,22,3877,4962,2556,11974,11702,2373,71,26217,0,0,0,0,69,2703,2772
2020-03-18,23,3721,4693,2378,11102,10937,2173,68,24378,0,0,0,0,73,2655,2728
2020-03-18,24,3544,4518,2221,10383,10190,1995,65,22728,0,0,0,0,79,2520,2599
2020-03-19,1,3408,4459,2079,9312,9754,1937,63,21160,0,0,0,0,36,2267,2303
2020-03-19,2,3340,4433,2048,8972,9340,1858,63,20327,0,0,0,0,38,2131,2169
2020-03-19,3,3313,4449,2049,8757,9039,1804,64,19758,0,0,0,0,36,2018,2054
2020-03-19,4,3331,4541,2090,8717,8951,1775,66,19603,0,0,0,0,31,1886,1917
2020-03-19,5,3407,4755,2216,8958,9218,1823,69,20161,0,0,0,0,27,1687,1714
2020-03-19,6,3581,5127,2491,9527,9868,1964,76,21528,0,0,0,0,27,1468,1495
2020-03-19,7,3812,5431,2879,10514,10891,2189,85,23774,0,3,0,3,26,1279,1305
2020-03-19,8,3822,5446,3094,11194,11290,2310,85,24977,98,995,85,1178,22,1112,1134
2020-03-19,9,3761,5405,3025,11129,11327,2291,83,24929,461,3359,398,4218,15,954,969
2020-03-19,10,3697,5349,2891,10687,11158,2216,79,24235,854,5203,774,6831,8,880,888
2020-03-19,11,3643,5283,2744,10107,11066,2160,75,23504,1045,5868,976,7889,4,933,937
2020-03-19,12,3589,5215,2605,9498,10857,2127,72,22648,1095,5787,1018,7900,5,1012,1017
2020-03-19,13,3544,5200,2503,9187,10745,2068,68,22163,1093,5549,1030,7672,5,1081,1086
2020-03-19,14,3509,5161,2415,9044,10715,2017,66,21936,1090,5275,1018,7383,6,1138,1144
2020-03-19,15,3482,5125,2338,8981,10651,2006,63,21796,1098,4882,989,6969,7,1175,1182
2020-03-19,16,3506,5102,2283,9134,10623,2068,62,21983,1062,4451,940,6453,10,1211,1221
2020-03-19,17,3583,5083,2276,9545,10785,2158,63,22645,969,3745,790,5504,12,1208,1220
2020-03-19,18,3634,5071,2304,10124,11073,2258,64,23614,632,2241,495,3368,15,1158,1173
2020-03-19,19,3750,5188,2351,10738,11399,2384,67,24683,196,558,149,903,21,1041,1062
2020-03-19,20,3991,5358,2476,11513,12314,2548,74,26544,1,0,0,1,29,922,951
2020-03-19,21,3996,5230,2533,11546,12275,2497,75,26486,0,0,0,0,39,842,881
2020-03-19,22,3867,4970,2428,11106,11857,2400,73,25530,0,0,0,0,55,784,839
2020-03-19,23,3716,4714,2266,10406,11096,2209,70,23876,0,0,0,0,68,741,809
2020-03-19,24,3544,4548,2123,9713,10300,2027,66,22200,0,0,0,0,65,711,776
2020-03-20,1,3439,4487,2034,9425,9618,1933,62,21132,0,0,0,0,59,664,723
2020-03-20,2,3372,4461,1998,9130,9238,1852,62,20376,0,0,0,0,47,587,634
2020-03-20,3,3343,4476,1996,8937,9071,1798,63,19963,0,0,0,0,36,517,553
2020-03-20,4,3358,4565,2032,8906,9008,1767,66,19840,0,0,0,0,22,419,441
2020-03-20,5,3429,4748,2143,9155,9223,1806,70,20349,0,0,0,0,11,315,326
2020-03-20,6,3605,5085,2389,9762,9798,1940,76,21670,0,0,0,0,10,227,237
2020-03-20,7,3811,5377,2743,10865,10774,2189,85,24007,0,3,0,3,11,156,167
2020-03-20,8,3828,5419,2954,11437,11043,2306,87,24969,198,990,141,1329,9,97,106
2020-03-20,9,3776,5383,2910,11202,11025,2257,81,24661,825,3378,620,4823,6,57,63
2020-03-20,10,3717,5305,2788,10583,10744,2153,73,23645,1346,5206,1109,7661,6,58,64
2020-03-20,11,3671,5217,2655,9910,10590,2034,68,22697,1488,5769,1298,8555,8,86,94
2020-03-20,12,3615,5120,2529,9357,10369,1938,64,21823,1446,5690,1257,8393,10,106,116
2020-03-20,13,3565,5081,2424,9040,10213,1880,60,21288,1353,5472,1184,8009,15,102,117
2020-03-20,14,3521,5029,2336,8890,10177,1897,57,21115,1277,5034,1103,7414,19,87,106
2020-03-20,15,3495,4984,2271,8869,10027,1949,56,20995,1194,4318,975,6487,17,77,94
2020-03-20,16,3505,4946,2226,9076,10008,2009,55,21240,1099,3582,847,5528,16,72,88
2020-03-20,17,3578,4909,2215,9479,10150,2083,57,21863,949,2663,654,4266,14,73,87
2020-03-20,18,3607,4879,2226,10063,10439,2137,59,22795,581,1359,361,2301,15,70,85
2020-03-20,19,3700,4998,2242,10630,10880,2234,61,23900,181,286,93,560,20,64,84
2020-03-20,20,3937,5151,2313,11352,11764,2437,65,25710,1,0,0,1,26,56,82
2020-03-20,21,3945,5072,2362,11475,11654,2410,66,25698,0,0,0,0,32,50,82
2020-03-20,22,3859,4883,2285,11090,11280,2326,65,24856,0,0,0,0,38,48,86
2020-03-20,23,3751,4666,2165,10413,10702,2176,62,23447,0,0,0,0,52,56,108
2020-03-20,24,3596,4494,2035,9765,9971,2008,60,21897,0,0,0,0,59,74,133
2020-03-21,1,3406,4401,1921,9238,9366,1891,51,20640,0,0,0,0,34,152,186
2020-03-21,2,3332,4365,1879,8718,9030,1805,51,19697,0,0,0,0,35,230,265
2020-03-21,3,3287,4364,1870,8510,8758,1737,52,19151,0,0,0,0,36,276,312
2020-03-21,4,3278,4405,1891,8403,8636,1699,54,18886,0,0,0,0,35,307,342
2020-03-21,5,3306,4494,1953,8456,8694,1711,56,19010,0,0,0,0,32,340,372
2020-03-21,6,3377,4633,2070,8664,8962,1754,60,19533,0,0,0,0,30,361,391
2020-03-21,7,3478,4779,2244,9243,9302,1862,66,20567,0,4,0,4,34,366,400
2020-03-21,8,3431,4895,2413,9681,9331,1906,70,21084,76,809,76,961,35,341,376
2020-03-21,9,3446,4919,2530,9557,9351,1852,67,20924,447,3219,443,4109,25,269,294
2020-03-21,10,3446,4877,2497,9214,9128,1714,63,20214,759,5166,871,6796,14,194,208
2020-03-21,11,3416,4796,2385,8681,8928,1549,58,19308,922,6077,1087,8086,10,164,174
2020-03-21,12,3364,4696,2263,8197,8667,1431,55,18444,1010,6379,1162,8551,9,147,156
2020-03-21,13,3311,4626,2156,7875,8480,1341,53,17842,1045,6307,1225,8577,10,122,132
2020-03-21,14,3268,4577,2078,7707,8367,1289,52,17509,1046,6154,1207,8407,15,135,150
2020-03-21,15,3261,4548,2027,7690,8361,1303,52,17486,1044,5978,1181,8203,25,197,222
2020-03-21,16,3293,4560,2009,7831,8468,1415,53,17855,1026,5673,1097,7796,39,256,295
2020-03-21,17,3367,4583,2014,8154,8777,1594,54,18674,984,4974,925,6883,50,297,347
2020-03-21,18,3423,4606,2037,8860,9216,1834,55,20059,765,3176,579,4520,53,331,384
2020-03-21,19,3525,4762,2068,9608,9750,2054,56,21565,198,656,147,1001,61,364,425
2020-03-21,20,3748,4955,2144,10393,10688,2284,60,23518,1,6,2,9,71,424,495
2020-03-21,21,3762,4903,2175,10571,10665,2268,59,23658,0,0,0,0,72,480,552
2020-03-21,22,3683,4742,2117,10245,10403,2200,57,23000,0,0,0,0,70,446,516
2020-03-21,23,3612,4549,2021,9779,9967,2072,54,21966,0,0,0,0,68,381,449
2020-03-21,24,3468,4384,1918,9208,9446,1927,51,20726,0,0,0,0,65,359,424
2020-03-22,1,3266,4332,1809,8967,8849,1844,48,19802,0,0,0,0,30,503,533
2020-03-22,2,3188,4291,1778,8634,8494,1765,48,19035,0,0,0,0,21,429,450
2020-03-22,3,3153,4287,1779,8421,8241,1705,49,18510,0,0,0,0,16,378,394
2020-03-22,4,3149,4318,1809,8303,8070,1669,51,18186,0,0,0,0,13,349,362
2020-03-22,5,3163,4375,1874,8326,8056,1674,53,18203,0,0,0,0,11,309,320
2020-03-22,6,3213,4476,1978,8499,8169,1718,58,18537,0,0,0,0,11,252,263
2020-03-22,7,3273,4584,2123,8865,8499,1789,65,19312,0,7,0,7,11,186,197
2020-03-22,8,3243,4673,2304,9180,8569,1824,66,19735,90,788,80,958,14,144,158
2020-03-22,9,3250,4680,2415,9163,8550,1784,64,19658,538,2903,458,3899,22,127,149
2020-03-22,10,3274,4644,2384,8803,8386,1680,59,19021,866,4466,787,6119,25,107,132
2020-03-22,11,3267,4576,2266,8337,8245,1528,54,18260,996,4933,893,6822,20,95,115
2020-03-22,12,3246,4555,2140,7942,8255,1436,51,17780,960,5186,902,7048,15,102,117
2020-03-22,13,3233,4512,2050,7699,8203,1371,50,17419,860,5108,866,6834,12,129,141
2020-03-22,14,3223,4506,1982,7670,8177,1353,49,17342,836,5065,817,6718,12,195,207
2020-03-22,15,3243,4513,1935,7744,8169,1434,48,17488,809,4806,739,6354,15,343,358
2020-03-22,16,3298,4567,1919,8014,8264,1622,48,18042,672,4071,593,5336,24,587,611
2020-03-22,17,3348,4608,1949,8506,8479,1794,49,18919,571,3263,459,4293,43,820,863
2020-03-22,18,3420,4633,2009,9154,8906,1951,52,20156,381,1849,268,2498,81,943,1024
2020-03-22,19,3513,4783,2061,9897,9455,2093,53,21591,84,381,66,531,112,999,1111
2020-03-22,20,3709,4970,2151,10729,10245,2306,57,23430,0,4,1,5,117,1021,1138
2020-03-22,21,3702,4894,2179,10916,10298,2280,57,23645,0,0,0,0,141,1008,1149
2020-03-22,22,3592,4683,2084,10477,10055,2182,54,22862,0,0,0,0,189,978,1167
2020-03-22,23,3504,4464,1943,9755,9645,2014,51,21558,0,0,0,0,216,931,1147
2020-03-22,24,3342,4321,1816,9105,9091,1870,48,20208,0,0,0,0,218,854,1072
2020-03-23,1,3172,4279,1792,9175,8815,1815,45,19936,0,0,0,0,319,889,1208
2020-03-23,2,3100,4269,1773,8865,8523,1754,44,19271,0,0,0,0,318,890,1208
2020-03-23,3,3074,4293,1778,8761,8284,1704,45,18877,0,0,0,0,350,888,1238
2020-03-23,4,3090,4394,1818,8771,8270,1681,47,18854,0,0,0,0,405,909,1314
2020-03-23,5,3157,4622,1936,8972,8549,1716,51,19372,0,0,0,0,445,976,1421
2020-03-23,6,3323,4981,2191,9482,9264,1853,57,20740,0,0,0,0,469,1085,1554
2020-03-23,7,3551,5286,2550,10433,10271,2085,65,22942,0,10,0,10,479,1225,1704
2020-03-23,8,3559,5339,2751,11120,10717,2211,68,24211,75,1007,89,1171,450,1345,1795
2020-03-23,9,3549,5327,2749,11063,10769,2217,64,24206,458,3729,509,4696,408,1519,1927
2020-03-23,10,3525,5291,2661,10633,10619,2142,60,23549,789,5436,996,7221,389,1797,2186
2020-03-23,11,3523,5238,2580,10197,10473,2036,57,22853,909,6082,1151,8142,381,2020,2401
2020-03-23,12,3496,5178,2495,9862,10381,1911,55,22295,944,6518,1158,8620,427,2067,2494
2020-03-23,13,3480,5168,2437,9647,10259,1784,53,21831,988,6730,1115,8833,516,2142,2658
2020-03-23,14,3480,5137,2374,9509,10209,1700,52,21558,1001,6732,1095,8828,603,2356,2959
2020-03-23,15,3496,5106,2317,9464,10094,1677,51,21374,983,6667,1057,8707,728,2479,3207
2020-03-23,16,3537,5083,2286,9540,10150,1757,51,21586,980,6397,927,8304,853,2513,3366
2020-03-23,17,3566,5076,2299,9887,10385,1924,52,22337,897,5561,815,7273,940,2483,3423
2020-03-23,18,3590,5097,2344,10592,10677,2137,54,23549,646,3562,508,4716,968,2356,3324
2020-03-23,19,3665,5186,2390,11170,11103,2313,56,24730,175,752,128,1055,932,2165,3097
2020-03-23,20,3893,5319,2485,11858,11978,2510,59,26493,1,9,2,12,824,1978,2802
2020-03-23,21,3868,5186,2504,11902,11921,2467,58,26436,0,0,0,0,667,1867,2534
2020-03-23,22,3721,4901,2372,11363,11471,2336,55,25311,0,0,0,0,516,1810,2326
2020-03-23,23,3583,4626,2193,10578,10722,2136,51,23571,0,0,0,0,402,1793,2195
2020-03-23,24,3396,4440,2044,9854,9951,1957,49,21895,0,0,0,0,334,1786,2120
2020-03-24,1,3202,4334,1993,9376,9169,1859,48,20545,0,0,0,0,303,1750,2053
2020-03-24,2,3122,4303,1963,8966,8857,1786,49,19750,0,0,0,0,265,1789,2054
2020-03-24,3,3089,4310,1959,8804,8629,1733,50,19311,0,0,0,0,218,1832,2050
2020-03-24,4,3099,4393,1996,8826,8566,1710,53,19253,0,0,0,0,184,1816,2000
2020-03-24,5,3171,4616,2110,9045,8736,1748,57,19685,0,0,0,0,165,1714,1879
2020-03-24,6,3338,4962,2383,9729,9389,1886,65,21166,0,0,0,0,145,1602,1747
2020-03-24,7,3560,5252,2752,10876,10281,2135,71,23463,0,17,0,17,130,1505,1635
2020-03-24,8,3572,5291,2950,11581,10634,2225,72,24613,66,1222,77,1365,128,1435,1563
2020-03-24,9,3548,5270,2912,11502,10591,2137,68,24387,391,4269,394,5054,127,1392,1519
2020-03-24,10,3517,5232,2814,11369,10458,1996,63,23975,674,6287,786,7747,123,1361,1484
2020-03-24,11,3489,5186,2714,11155,10303,1835,59,23441,808,6891,982,8681,137,1328,1465
2020-03-24,12,3468,5136,2615,10899,10267,1726,56,23037,876,6996,1083,8955,180,1321,1501
2020-03-24,13,3457,5132,2541,10651,10191,1654,55,22640,873,6981,1114,8968,225,1375,1600
2020-03-24,14,3463,5104,2473,10522,10192,1633,54,22489,877,6943,1132,8952,287,1464,1751
2020-03-24,15,3486,5085,2401,10380,10094,1655,53,22272,867,6776,1146,8789,342,1560,1902
2020-03-24,16,3535,5076,2376,10391,10049,1751,53,22336,827,6286,1065,8178,378,1618,1996
2020-03-24,17,3561,5055,2387,10587,10185,1930,53,22848,744,5435,890,7069,436,1649,2085
2020-03-24,18,3631,5071,2430,11000,10383,2116,55,23649,543,3203,550,4296,447,1662,2109
2020-03-24,19,3699,5162,2471,11353,10939,2286,57,24732,145,653,146,944,399,1649,2048
2020-03-24,20,3898,5307,2565,12060,11881,2488,60,26587,1,5,1,7,350,1617,1967
2020-03-24,21,3865,5172,2594,12095,11799,2453,59,26503,0,0,0,0,330,1614,1944
2020-03-24,22,3716,4902,2465,11597,11355,2326,56,25429,0,0,0,0,329,1659,1988
2020-03-24,23,3574,4632,2290,10771,10743,2126,52,23786,0,0,0,0,302,1719,2021
2020-03-24,24,3389,4457,2141,10035,9968,1956,50,22103,0,0,0,0,254,1783,2037
2020-03-25,1,3174,4362,2093,9482,9020,1814,49,20458,0,0,0,0,246,2054,2300
2020-03-25,2,3099,4331,2064,9155,8648,1740,50,19686,0,0,0,0,239,2089,2328
2020-03-25,3,3065,4340,2062,8985,8393,1699,51,19224,0,0,0,0,248,2110,2358
2020-03-25,4,3072,4429,2102,8963,8415,1676,53,19203,0,0,0,0,267,2085,2352
2020-03-25,5,3142,4638,2217,9173,8642,1712,58,19679,0,0,0,0,282,2041,2323
2020-03-25,6,3309,5004,2485,9748,9129,1819,65,20855,0,0,0,0,277,1973,2250
2020-03-25,7,3517,5294,2850,10616,9970,2007,74,22761,0,15,0,15,271,1863,2134
2020-03-25,8,3543,5338,3054,11075,10174,2121,74,23541,106,966,100,1172,282,1786,2068
2020-03-25,9,3516,5302,3002,10876,10152,2094,71,23294,547,3331,521,4399,267,1830,2097
2020-03-25,10,3490,5270,2882,10366,9918,1987,66,22430,854,5062,962,6878,226,1972,2198
2020-03-25,11,3472,5242,2765,9903,9785,1877,63,21719,963,5635,1156,7754,194,2085,2279
2020-03-25,12,3456,5195,2653,9657,9697,1796,60,21300,969,5805,1186,7960,171,2127,2298
2020-03-25,13,3448,5183,2568,9403,9626,1739,58,20916,940,5613,1169,7722,166,2121,2287
2020-03-25,14,3447,5146,2497,9185,9497,1702,56,20531,921,5417,1135,7473,191,2073,2264
2020-03-25,15,3461,5126,2443,9149,9561,1742,55,20598,881,5216,1115,7212,232,2036,2268
2020-03-25,16,3491,5111,2401,9268,9596,1850,55,20859,874,4512,1039,6425,304,2024,2328
2020-03-25,17,3530,5087,2410,9634,9807,1953,56,21540,781,3745,913,5439,391,1959,2350
2020-03-25,18,3571,5109,2448,10376,10196,2092,58,22811,554,2188,604,3346,414,1859,2273
2020-03-25,19,3645,5204,2500,11096,10684,2240,60,24167,163,476,166,805,400,1786,2186
2020-03-25,20,3883,5349,2592,11797,11255,2433,64,25636,2,4,3,9,406,1760,2166
2020-03-25,21,3875,5216,2630,11944,11240,2416,63,25754,0,0,0,0,403,1854,2257
2020-03-25,22,3730,4943,2505,11457,10778,2300,61,24688,0,0,0,0,369,2131,2500
2020-03-25,23,3575,4679,2332,10707,10253,2129,58,23239,0,0,0,0,323,2399,2722
2020-03-25,24,3394,4508,2184,9987,9551,1968,55,21655,0,0,0,0,285,2482,2767
2020-03-26,1,3191,4480,2115,9445,9056,1790,57,20438,0,0,0,0,307,2446,2753
2020-03-26,2,3123,4458,2088,9123,8672,1711,57,19654,0,0,0,0,265,2459,2724
2020-03-26,3,3092,4476,2091,8926,8480,1670,58,19224,0,0,0,0,231,2485,2716
2020-03-26,4,3108,4566,2133,8888,8383,1640,60,19062,0,0,0,0,207,2521,2728
2020-03-26,5,3184,4773,2262,9154,8564,1679,65,19553,0,0,0,0,180,2541,2721
2020-03-26,6,3366,5144,2537,9749,9187,1795,72,20894,0,0,0,0,138,2531,2669
2020-03-26,7,3576,5426,2916,10474,9862,1945,80,22452,0,35,0,35,94,2474,2568
2020-03-26,8,3602,5448,3106,10964,10108,2015,83,23258,283,1542,208,2033,63,2368,2431
2020-03-26,9,3582,5404,3040,10828,10201,1986,78,23188,963,4624,795,6382,42,2277,2319
2020-03-26,10,3549,5343,2906,10257,9950,1890,73,22260,1410,6737,1310,9457,30,2257,2287
2020-03-26,11,3526,5285,2766,9552,9627,1767,70,21105,1515,7511,1547,10573,27,2294,2321
2020-03-26,12,3489,5214,2639,9034,9481,1643,66,20313,1493,7740,1599,10832,30,2356,2386
2020-03-26,13,3462,5194,2541,8704,9383,1583,63,19822,1445,7680,1576,10701,32,2438,2470
2020-03-26,14,3443,5152,2455,8525,9267,1531,61,19473,1424,7536,1530,10490,32,2508,2540
2020-03-26,15,3434,5124,2382,8477,9207,1513,60,19348,1413,7222,1431,10066,37,2568,2605
2020-03-26,16,3448,5110,2319,8568,9146,1584,59,19448,1373,6619,1306,9298,51,2609,2660
2020-03-26,17,3501,5089,2333,9034,9355,1750,60,20290,1257,5681,1088,8026,78,2604,2682
2020-03-26,18,3541,5097,2365,9954,9779,2008,62,21893,897,3664,670,5231,127,2575,2702
2020-03-26,19,3613,5203,2421,10737,10385,2226,64,23504,320,1022,200,1542,184,2562,2746
2020-03-26,20,3840,5364,2526,11485,11138,2396,71,25179,9,14,2,25,261,2566,2827
2020-03-26,21,3849,5239,2581,11621,11251,2416,71,25449,0,1,0,1,352,2608,2960
2020-03-26,22,3722,4984,2473,11091,10929,2307,69,24486,0,0,0,0,416,2716,3132
2020-03-26,23,3574,4732,2301,10496,10339,2123,66,23114,0,0,0,0,447,2863,3310
2020-03-26,24,3404,4570,2160,9806,9697,1952,63,21609,0,0,0,0,460,2995,3455
2020-03-27,1,3232,4543,2102,9439,8990,1847,61,20426,0,0,0,0,512,2989,3501
2020-03-27,2,3181,4527,2066,9126,8592,1763,61,19631,0,0,0,0,529,3033,3562
2020-03-27,3,3165,4551,2065,8946,8398,1714,63,19210,0,0,0,0,530,3016,3546
2020-03-27,4,3191,4640,2100,8864,8369,1692,65,19081,0,0,0,0,520,2970,3490
2020-03-27,5,3270,4837,2210,9154,8542,1732,69,19587,0,0,0,0,520,2928,3448
2020-03-27,6,3446,5177,2452,9713,8981,1845,75,20704,0,0,0,0,525,2890,3415
2020-03-27,7,3649,5452,2802,10601,9779,2013,85,22568,0,52,0,52,519,2860,3379
2020-03-27,8,3658,5473,2962,11151,9987,2052,84,23364,309,1559,216,2084,483,2840,3323
2020-03-27,9,3611,5417,2931,10723,9795,1972,79,22656,1034,4531,813,6378,433,2816,3249
2020-03-27,10,3548,5330,2820,10037,9506,1797,72,21501,1473,6753,1335,9561,403,2777,3180
2020-03-27,11,3488,5235,2704,9370,9298,1649,67,20474,1562,7521,1571,10654,400,2730,3130
2020-03-27,12,3425,5132,2590,8605,9094,1508,62,19359,1553,7729,1634,10916,405,2702,3107
2020-03-27,13,3388,5085,2498,8321,8941,1402,60,18813,1523,7711,1625,10859,409,2717,3126
2020-03-27,14,3360,5033,2419,8128,8834,1374,58,18483,1480,7635,1580,10695,417,2757,3174
2020-03-27,15,3344,4988,2349,8080,8798,1375,56,18399,1411,7478,1493,10382,425,2802,3227
2020-03-27,16,3349,4957,2292,8095,8849,1438,56,18527,1323,7125,1385,9833,459,2821,3280
2020-03-27,17,3398,4931,2269,8584,9034,1622,58,19385,1205,6330,1224,8759,526,2814,3340
2020-03-27,18,3422,4924,2307,9464,9552,1903,60,21065,885,4209,846,5940,569,2777,3346
2020-03-27,19,3479,5021,2327,10454,10128,2145,61,22876,331,1257,284,1872,564,2695,3259
2020-03-27,20,3710,5173,2394,11311,10824,2319,65,24607,13,17,4,34,549,2570,3119
2020-03-27,21,3738,5093,2432,11314,10820,2338,66,24624,0,0,0,0,535,2461,2996
2020-03-27,22,3662,4906,2345,10905,10620,2269,65,23946,0,0,0,0,503,2342,2845
2020-03-27,23,3571,4695,2211,10318,10117,2129,63,22715,0,0,0,0,462,2187,2649
2020-03-27,24,3425,4524,2075,9707,9472,1965,61,21293,0,0,0,0,418,2048,2466
2020-03-28,1,3295,4467,1923,9257,8940,1843,58,20186,0,0,0,0,372,2012,2384
2020-03-28,2,3233,4431,1876,8908,8559,1757,58,19370,0,0,0,0,283,1850,2133
2020-03-28,3,3197,4435,1861,8674,8233,1705,60,18760,0,0,0,0,211,1705,1916
2020-03-28,4,3200,4480,1881,8532,8132,1667,62,18481,0,0,0,0,171,1543,1714
2020-03-28,5,3238,4568,1933,8609,8193,1684,65,18640,0,0,0,0,145,1395,1540
2020-03-28,6,3319,4687,2040,8850,8500,1719,70,19228,0,0,0,0,115,1302,1417
2020-03-28,7,3394,4801,2190,9279,8772,1766,77,19983,0,72,0,72,84,1214,1298
2020-03-28,8,3360,4912,2334,9572,8778,1759,79,20275,133,1664,162,1959,57,1053,1110
2020-03-28,9,3361,4960,2461,9533,8649,1703,74,20050,498,4408,586,5492,41,789,830
2020-03-28,10,3351,4919,2446,9295,8412,1567,68,19435,822,6252,971,8045,35,477,512
2020-03-28,11,3314,4852,2373,9034,8090,1383,63,18662,955,6807,1170,8932,34,248,282
2020-03-28,12,3260,4768,2281,8750,7848,1265,58,18012,969,6867,1220,9056,34,145,179
2020-03-28,13,3210,4701,2193,8476,7656,1216,57,17493,926,6703,1194,8823,34,129,163
2020-03-28,14,3168,4653,2107,8347,7609,1167,56,17267,840,6396,1093,8329,35,183,218
2020-03-28,15,3158,4631,2050,8378,7605,1186,56,17314,729,5964,927,7620,40,328,368
2020-03-28,16,3192,4645,2031,8420,7745,1298,58,17610,609,5373,778,6760,47,598,645
2020-03-28,17,3252,4670,2036,8690,8129,1479,59,18448,455,4339,587,5381,57,930,987
2020-03-28,18,3336,4711,2067,9241,8776,1734,60,19901,253,2494,313,3060,68,1198,1266
2020-03-28,19,3386,4822,2092,9795,9359,1988,63,21292,72,640,83,795,74,1362,1436
2020-03-28,20,3610,5004,2155,10514,10174,2212,66,23053,1,5,1,7,77,1476,1553
2020-03-28,21,3647,4954,2191,10789,10270,2225,65,23437,0,0,0,0,76,1575,1651
2020-03-28,22,3571,4795,2122,10491,10103,2165,63,22909,0,0,0,0,73,1656,1729
2020-03-28,23,3498,4596,2011,9935,9632,2061,59,21775,0,0,0,0,67,1732,1799
2020-03-28,24,3366,4426,1896,9357,9057,1917,55,20475,0,0,0,0,66,1822,1888
2020-03-29,1,3198,4342,1796,8783,8324,1796,51,19042,0,0,0,0,74,1890,1964
2020-03-29,2,3123,4307,1750,8427,7999,1705,50,18269,0,0,0,0,66,1995,2061
2020-03-29,3,3091,4305,1738,8203,7754,1658,51,17753,0,0,0,0,58,2068,2126
2020-03-29,4,3087,4337,1759,8114,7625,1617,51,17495,0,0,0,0,52,2106,2158
2020-03-29,5,3107,4397,1807,8136,7626,1625,54,17529,0,0,0,0,49,2121,2170
2020-03-29,6,3153,4475,1898,8294,7688,1648,59,17776,0,0,0,0,51,2120,2171
2020-03-29,7,3203,4567,2012,8635,7833,1717,65,18338,0,77,0,77,67,2085,2152
2020-03-29,8,3173,4665,2147,8840,7800,1712,66,18506,122,1501,122,1745,90,2038,2128
2020-03-29,9,3186,4670,2283,8962,7648,1650,65,18414,444,4214,491,5149,111,2067,2178
2020-03-29,10,3208,4625,2305,8968,7324,1533,63,17977,734,6089,883,7706,121,2201,2322
2020-03-29,11,3207,4554,2255,8860,7138,1432,59,17578,856,6837,1053,8746,117,2371,2488
2020-03-29,12,3196,4533,2190,8700,6956,1329,57,17131,876,7057,1043,8976,106,2516,2622
2020-03-29,13,3194,4479,2129,8507,6813,1250,56,16716,869,7001,1027,8897,95,2629,2724
2020-03-29,14,3187,4473,2065,8218,6728,1211,55,16302,870,6891,1005,8766,91,2731,2822
2020-03-29,15,3209,4488,2016,7967,6741,1232,54,16083,885,6607,952,8444,94,2825,2919
2020-03-29,16,3264,4552,2000,8030,6950,1321,54,16445,851,6105,892,7848,111,2874,2985
2020-03-29,17,3304,4596,2018,8402,7375,1517,55,17437,815,5338,785,6938,146,2880,3026
2020-03-29,18,3352,4634,2080,9057,7980,1776,57,18958,659,3505,546,4710,187,2857,3044
2020-03-29,19,3400,4764,2127,9741,8653,2000,59,20541,264,1029,190,1483,226,2802,3028
2020-03-29,20,3640,4951,2212,10568,9603,2235,63,22557,14,15,4,33,265,2779,3044
2020-03-29,21,3673,4875,2264,10827,9692,2219,63,22888,0,2,0,2,302,2810,3112
2020-03-29,22,3559,4669,2158,10427,9473,2133,60,22180,0,0,0,0,339,2802,3141
2020-03-29,23,3464,4449,2003,9713,9080,1981,56,20918,0,0,0,0,376,2749,3125
2020-03-29,24,3304,4301,1864,9080,8551,1834,53,19605,0,0,0,0,410,2718,3128
2020-03-30,1,3155,4267,1769,8848,8452,1763,48,19204,0,0,0,0,458,2450,2908
2020-03-30,2,3083,4253,1735,8563,8159,1695,48,18556,0,0,0,0,455,2378,2833
2020-03-30,3,3055,4278,1733,8390,7938,1657,49,18126,0,0,0,0,463,2242,2705
2020-03-30,4,3069,4379,1765,8415,7948,1643,52,18150,0,0,0,0,470,2093,2563
2020-03-30,5,3141,4595,1870,8701,8213,1680,56,18742,0,0,0,0,440,1930,2370
2020-03-30,6,3319,4966,2111,9354,8732,1811,63,20053,0,0,0,0,363,1768,2131
2020-03-30,7,3516,5249,2437,10226,9493,1990,71,21873,0,103,0,103,274,1581,1855
2020-03-30,8,3535,5297,2631,10883,9788,2032,74,22868,294,1878,229,2401,203,1305,1508
2020-03-30,9,3530,5282,2628,10850,9632,1931,68,22568,948,5053,800,6801,160,946,1106
2020-03-30,10,3504,5240,2585,10287,9336,1739,62,21513,1370,6962,1293,9625,139,601,740
2020-03-30,11,3479,5187,2539,9744,9150,1572,59,20613,1468,7599,1546,10613,134,391,525
2020-03-30,12,3452,5123,2483,9358,8889,1475,56,19866,1456,7822,1638,10916,136,326,462
2020-03-30,13,3438,5106,2445,9019,8694,1413,55,19270,1421,7846,1653,10920,141,360,501
2020-03-30,14,3440,5072,2400,8895,8534,1390,55,18962,1414,7817,1663,10894,147,487,634
2020-03-30,15,3461,5037,2354,8970,8605,1419,54,19137,1437,7690,1658,10785,154,716,870
2020-03-30,16,3504,5020,2321,9182,8761,1528,54,19613,1430,7301,1579,10310,179,1042,1221
2020-03-30,17,3555,5010,2333,9413,9033,1683,55,20272,1356,6457,1397,9210,231,1411,1642
2020-03-30,18,3639,5039,2382,10005,9423,1948,57,21520,1033,4345,978,6356,286,1714,2000
2020-03-30,19,3683,5101,2420,10776,10101,2185,59,23207,399,1357,347,2103,323,1901,2224
2020-03-30,20,3879,5238,2470,11542,10817,2386,62,24893,21,32,7,60,343,1998,2341
2020-03-30,21,3846,5113,2492,11597,10828,2351,60,24923,0,0,0,0,362,2043,2405
2020-03-30,22,3675,4837,2362,11096,10499,2227,57,23967,0,0,0,0,379,2053,2432
2020-03-30,23,3499,4568,2183,10426,9981,2041,53,22589,0,0,0,0,374,2049,2423
2020-03-30,24,3321,4387,2034,9845,9403,1880,49,21269,0,0,0,0,346,2043,2389
2020-03-31,1,3187,4258,1934,9147,8618,1775,48,19686,0,0,0,0,274,1734,2008
2020-03-31,2,3113,4220,1892,8836,8297,1712,48,18991,0,0,0,0,250,1728,1978
2020-03-31,3,3078,4227,1878,8655,8110,1665,49,18577,0,0,0,0,244,1755,1999
2020-03-31,4,3077,4310,1903,8647,8089,1650,52,18536,0,0,0,0,254,1786,2040
2020-03-31,5,3134,4526,2004,8909,8304,1686,56,19061,0,0,0,0,277,1791,2068
2020-03-31,6,3285,4872,2247,9462,8795,1813,62,20241,0,0,0,0,307,1742,2049
2020-03-31,7,3476,5129,2590,10445,9583,2002,70,22210,0,97,0,97,328,1626,1954
2020-03-31,8,3508,5174,2782,10881,9909,2044,70,22996,346,1570,260,2176,344,1423,1767
2020-03-31,9,3505,5161,2770,10724,9823,1933,66,22646,1057,4086,857,6000,378,1155,1533
2020-03-31,10,3488,5119,2703,10335,9588,1745,62,21833,1472,5764,1330,8566,403,911,1314
2020-03-31,11,3476,5074,2633,9887,9444,1605,59,21096,1565,6502,1551,9618,397,755,1152
2020-03-31,12,3482,5031,2563,9499,9282,1541,57,20476,1567,6761,1640,9968,381,716,1097
2020-03-31,13,3491,5042,2513,9262,9204,1512,56,20131,1545,6720,1658,9923,375,809,1184
2020-03-31,14,3541,5025,2459,9179,9139,1513,56,19983,1511,6545,1649,9705,387,1006,1393
2020-03-31,15,3587,5016,2406,9174,9191,1551,54,20068,1487,6186,1632,9305,420,1275,1695
2020-03-31,16,3651,5014,2365,9321,9340,1646,54,20459,1461,5557,1551,8569,461,1592,2053
2020-03-31,17,3711,4993,2382,9594,9554,1788,55,21087,1380,4618,1363,7361,513,1914,2427
2020-03-31,18,3772,5010,2431,10239,9928,2011,57,22331,1046,2988,949,4983,576,2158,2734
2020-03-31,19,3810,5067,2468,11024,10446,2211,59,23834,407,939,338,1684,647,2301,2948
2020-03-31,20,3992,5201,2527,11743,11109,2382,62,25389,27,14,8,49,719,2396,3115
2020-03-31,21,3971,5058,2552,11842,11097,2357,61,25456,0,0,0,0,768,2464,3232
2020-03-31,22,3782,4790,2430,11303,10699,2237,57,24394,0,0,0,0,766,2496,3262
2020-03-31,23,3507,4529,2252,10550,10126,2054,52,22880,0,0,0,0,752,2509,3261
2020-03-31,24,3314,4351,2104,9880,9466,1889,48,21381,0,0,0,0,767,2527,3294
2020-04-01,1,3156,4235,2027,9074,8668,1796,44,19692,0,0,0,0,842,2594,3436
2020-04-01,2,3075,4198,1990,8774,8348,1702,43,18978,0,0,0,0,809,2610,3419
2020-04-01,3,3027,4200,1986,8572,8166,1645,43,18539,0,0,0,0,743,2639,3382
2020-04-01,4,3024,4276,2022,8490,8047,1632,44,18323,0,0,0,0,669,2645,3314
2020-04-01,5,3075,4484,2133,8623,8173,1674,47,18625,0,0,0,0,604,2605,3209
2020-04-01,6,3211,4837,2399,9038,8587,1772,52,19561,0,0,0,0,552,2527,3079
2020-04-01,7,3391,5067,2786,9931,9415,1916,58,21435,1,96,1,98,504,2447,2951
2020-04-01,8,3411,5129,2949,10437,9640,1960,59,22213,377,1564,234,2175,451,2381,2832
2020-04-01,9,3413,5141,2921,10509,9528,1904,59,22119,1099,4279,785,6163,387,2354,2741
2020-04-01,10,3423,5133,2818,10050,9252,1733,57,21211,1501,6172,1256,8929,325,2388,2713
2020-04-01,11,3454,5120,2708,9510,8947,1555,55,20185,1588,6989,1500,10077,266,2495,2761
2020-04-01,12,3496,5084,2615,9085,8833,1444,54,19534,1601,7373,1604,10578,205,2636,2841
2020-04-01,13,3548,5074,2549,8793,8709,1398,55,19072,1598,7474,1636,10708,164,2763,2927
2020-04-01,14,3619,5025,2489,8654,8834,1395,56,19056,1597,7472,1643,10712,153,2864,3017
2020-04-01,15,3683,4986,2435,8569,8867,1451,56,19059,1599,7348,1633,10580,165,2938,3103
2020-04-01,16,3772,4976,2388,8624,8871,1568,57,19236,1573,6998,1570,10141,196,2979,3175
2020-04-01,17,3900,4969,2433,8996,9089,1759,59,20016,1498,6242,1407,9147,244,2974,3218
2020-04-01,18,3909,4938,2470,9878,9504,1953,57,21509,1158,4231,997,6386,297,2919,3216
2020-04-01,19,3895,5011,2508,10706,10054,2144,56,23076,470,1349,362,2181,348,2823,3171
2020-04-01,20,4067,5218,2584,11387,10761,2333,58,24656,33,34,11,78,405,2728,3133
2020-04-01,21,4040,5128,2639,11531,10824,2366,58,24896,0,0,0,0,436,2629,3065
2020-04-01,22,3863,4856,2515,11067,10470,2257,54,23965,0,0,0,0,411,2555,2966
2020-04-01,23,3548,4591,2327,10384,9860,2086,49,22495,0,0,0,0,366,2518,2884
2020-04-01,24,3341,4427,2163,9668,9281,1916,45,21026,0,0,0,0,318,2524,2842
2020-04-02,1,3069,4356,2083,8907,8564,1759,44,19387,0,0,0,0,175,2381,2556
2020-04-02,2,2989,4333,2054,8629,8267,1681,43,18730,0,0,0,0,179,2449,2628
2020-04-02,3,2944,4348,2056,8439,8030,1639,43,18263,0,0,0,0,190,2519,2709
2020-04-02,4,2948,4436,2098,8404,7994,1632,44,18181,0,0,0,0,205,2569,2774
2020-04-02,5,3005,4644,2216,8583,8183,1652,47,18571,0,0,0,0,228,2583,2811
2020-04-02,6,3153,4997,2488,9155,8642,1728,51,19683,0,0,0,0,260,2576,2836
2020-04-02,7,3333,5228,2873,10123,9270,1892,57,21454,3,157,3,163,293,2564,2857
2020-04-02,8,3362,5261,3028,10590,9496,1979,59,22236,421,2038,316,2775,302,2563,2865
2020-04-02,9,3370,5236,2977,10459,9441,1948,59,22023,1170,5154,969,7293,296,2548,2844
2020-04-02,10,3360,5182,2855,9750,9271,1771,58,20965,1541,6972,1436,9949,306,2510,2816
2020-04-02,11,3361,5125,2720,9028,9051,1666,56,19918,1606,7565,1637,10808,309,2463,2772
2020-04-02,12,3345,5058,2602,8505,8836,1502,54,19014,1619,7778,1718,11115,266,2392,2658
2020-04-02,13,3342,5035,2520,8210,8717,1470,54,18566,1623,7803,1724,11150,179,2324,2503
2020-04-02,14,3361,4971,2447,8116,8819,1418,54,18522,1627,7773,1720,11120,110,2307,2417
2020-04-02,15,3387,4915,2380,8090,8813,1423,54,18491,1624,7654,1711,10989,91,2384,2475
2020-04-02,16,3430,4904,2331,8336,8857,1502,54,18864,1594,7271,1634,10499,118,2533,2651
2020-04-02,17,3523,4902,2341,8811,9041,1582,55,19605,1524,6449,1464,9437,191,2671,2862
2020-04-02,18,3529,4872,2375,9679,9361,1847,56,21059,1201,4418,1055,6674,299,2747,3046
2020-04-02,19,3544,4970,2434,10451,9811,2107,56,22543,504,1444,395,2343,423,2805,3228
2020-04-02,20,3732,5188,2528,11150,10533,2335,59,24193,35,44,14,93,536,2863,3399
2020-04-02,21,3732,5099,2599,11391,10609,2315,58,24488,0,0,0,0,605,2890,3495
2020-04-02,22,3587,4836,2492,10960,10215,2198,54,23539,0,0,0,0,619,2898,3517
2020-04-02,23,3459,4589,2318,10205,9672,2040,50,22083,0,0,0,0,614,2882,3496
2020-04-02,24,3280,4436,2163,9494,9101,1873,46,20630,0,0,0,0,619,2843,3462
2020-04-03,1,3089,4422,2082,8787,8643,1782,45,19373,0,0,0,0,595,2713,3308
2020-04-03,2,3021,4411,2050,8470,8266,1694,45,18592,0,0,0,0,597,2602,3199
2020-04-03,3,2989,4431,2051,8273,8106,1640,46,18183,0,0,0,0,552,2470,3022
2020-04-03,4,3004,4520,2091,8253,8006,1629,48,18053,0,0,0,0,466,2313,2779
2020-04-03,5,3069,4727,2201,8606,8055,1661,52,18491,0,0,0,0,391,2176,2567
2020-04-03,6,3230,5041,2454,9225,8449,1750,58,19600,0,0,0,0,342,2080,2422
2020-04-03,7,3407,5236,2797,10113,9020,1867,65,21183,6,188,5,199,293,1996,2289
2020-04-03,8,3433,5273,2956,10510,9300,1902,65,21889,392,2175,338,2905,230,1862,2092
2020-04-03,9,3427,5223,2920,10139,9174,1865,61,21349,1069,5266,1002,7337,158,1668,1826
2020-04-03,10,3409,5111,2811,9427,8987,1695,57,20278,1433,6999,1468,9900,97,1515,1612
2020-04-03,11,3384,4986,2689,8720,8715,1521,53,19120,1530,7596,1675,10801,62,1488,1550
2020-04-03,12,3335,4870,2576,8232,8676,1410,51,18477,1564,7822,1754,11140,47,1594,1641
2020-04-03,13,3309,4802,2491,7700,8557,1341,50,17758,1573,7851,1759,11183,43,1851,1894
2020-04-03,14,3311,4722,2416,7420,8403,1306,50,17293,1579,7813,1750,11142,55,2190,2245
2020-04-03,15,3331,4651,2335,7390,8399,1328,50,17284,1589,7666,1732,10987,80,2492,2572
2020-04-03,16,3373,4620,2299,7569,8394,1418,50,17548,1568,7265,1659,10492,120,2709,2829
2020-04-03,17,3446,4602,2292,8083,8698,1592,51,18541,1491,6439,1481,9411,184,2838,3022
2020-04-03,18,3505,4602,2311,8931,9155,1860,53,20116,1160,4400,1056,6616,284,2894,3178
2020-04-03,19,3503,4676,2341,9943,9757,2067,53,21936,484,1441,390,2315,408,2909,3317
2020-04-03,20,3675,4888,2420,10781,10466,2226,55,23644,40,47,17,104,537,2897,3434
2020-04-03,21,3684,4865,2491,11050,10638,2244,54,24103,0,0,0,0,636,2884,3520
2020-04-03,22,3562,4680,2407,10662,10356,2179,51,23364,0,0,0,0,682,2846,3528
2020-04-03,23,3459,4472,2264,10016,9799,2034,47,22013,0,0,0,0,701,2767,3468
2020-04-03,24,3312,4319,2121,9345,9258,1887,44,20653,0,0,0,0,715,2685,3400
2020-04-04,1,3151,4319,1989,8901,8662,1858,44,19583,0,0,0,0,833,2647,3480
2020-04-04,2,3071,4282,1948,8495,8238,1773,43,18668,0,0,0,0,867,2601,3468
2020-04-04,3,3022,4284,1939,8270,7993,1711,44,18136,0,0,0,0,873,2554,3427
2020-04-04,4,3018,4317,1957,8150,7906,1673,46,17893,0,0,0,0,851,2532,3383
2020-04-04,5,3037,4400,2013,8197,7936,1683,48,17982,0,0,0,0,819,2524,3343
2020-04-04,6,3107,4532,2129,8443,8281,1733,52,18628,0,0,0,0,782,2488,3270
2020-04-04,7,3146,4563,2292,8794,8468,1798,58,19236,11,205,7,223,713,2390,3103
2020-04-04,8,3135,4685,2444,9046,8388,1801,58,19412,387,2193,330,2910,566,2228,2794
2020-04-04,9,3173,4740,2559,9286,8247,1739,57,19446,1033,5336,982,7351,394,2050,2444
2020-04-04,10,3200,4691,2543,9207,8048,1610,55,19038,1365,7125,1453,9943,288,1909,2197
2020-04-04,11,3207,4610,2457,9072,7787,1425,52,18454,1399,7717,1655,10771,257,1841,2098
2020-04-04,12,3207,4517,2363,8888,7646,1299,50,18001,1338,7957,1726,11021,270,1895,2165
2020-04-04,13,3222,4431,2272,8678,7450,1213,49,17508,1264,7984,1727,10975,318,2081,2399
2020-04-04,14,3267,4352,2182,8440,7314,1154,49,17075,1167,7921,1687,10775,385,2316,2701
2020-04-04,15,3341,4310,2119,8343,7388,1175,49,17073,1025,7725,1592,10342,432,2499,2931
2020-04-04,16,3423,4340,2093,8428,7572,1295,49,17463,885,7245,1454,9584,445,2597,3042
2020-04-04,17,3539,4400,2122,8717,7829,1496,51,18212,729,6346,1244,8319,430,2614,3044
2020-04-04,18,3589,4421,2150,9156,8305,1752,52,19383,473,4282,836,5591,383,2549,2932
2020-04-04,19,3602,4513,2187,9742,9060,1967,52,20939,170,1386,292,1848,315,2436,2751
2020-04-04,20,3755,4734,2247,10378,9883,2197,54,22629,11,44,13,68,259,2175,2434
2020-04-04,21,3771,4707,2305,10677,9971,2225,54,23045,0,0,0,0,230,1930,2160
2020-04-04,22,3643,4545,2229,10363,9654,2161,50,22346,0,0,0,0,220,1807,2027
2020-04-04,23,3452,4350,2105,9821,9250,2028,47,21263,0,0,0,0,223,1755,1978
2020-04-04,24,3295,4182,1979,9233,8701,1886,44,19981,0,0,0,0,228,1683,1911
2020-04-05,1,3084,4137,1857,9125,8201,1806,43,19292,0,0,0,0,171,1492,1663
2020-04-05,2,2989,4089,1815,8784,7849,1717,43,18510,0,0,0,0,187,1428,1615
2020-04-05,3,2937,4077,1807,8512,7571,1659,43,17902,0,0,0,0,207,1383,1590
2020-04-05,4,2922,4092,1830,8399,7434,1622,43,17617,0,0,0,0,218,1358,1576
2020-04-05,5,2940,4143,1881,8404,7407,1624,45,17597,0,0,0,0,231,1335,1566
2020-04-05,6,2984,4200,1980,8547,7537,1648,47,17898,0,0,0,0,266,1292,1558
2020-04-05,7,2993,4232,2099,8821,7710,1687,53,18391,5,187,6,198,316,1238,1554
2020-04-05,8,2987,4360,2239,9007,7650,1715,53,18544,102,1728,165,1995,362,1188,1550
2020-04-05,9,3029,4407,2351,9181,7699,1732,54,18784,306,4227,476,5009,383,1167,1550
2020-04-05,10,3057,4402,2351,9300,7740,1712,53,18924,499,5837,735,7071,399,1186,1585
2020-04-05,11,3085,4366,2266,9367,7677,1610,51,18825,598,6449,842,7889,439,1247,1686
2020-04-05,12,3115,4385,2183,9305,7646,1521,50,18641,638,6697,865,8200,472,1334,1806
2020-04-05,13,3156,4345,2118,9196,7577,1449,49,18389,671,6744,886,8301,465,1421,1886
2020-04-05,14,3205,4344,2048,9095,7555,1379,49,18195,648,6576,844,8068,428,1509,1937
2020-04-05,15,3261,4357,1992,8991,7482,1361,48,18001,574,6202,725,7501,401,1607,2008
2020-04-05,16,3349,4426,1970,8948,7676,1436,50,18228,493,5679,606,6778,396,1697,2093
2020-04-05,17,3478,4479,2002,9180,8015,1583,53,18950,388,4800,449,5637,388,1749,2137
2020-04-05,18,3533,4483,2076,9733,8442,1787,55,20135,234,3027,247,3508,353,1748,2101
2020-04-05,19,3559,4568,2142,10342,8962,1976,56,21453,73,898,76,1047,278,1704,1982
2020-04-05,20,3700,4780,2233,10859,9806,2203,57,23042,2,28,2,32,188,1645,1833
2020-04-05,21,3701,4719,2307,11028,9933,2227,56,23362,0,0,0,0,124,1600,1724
2020-04-05,22,3559,4503,2212,10631,9620,2137,53,22558,0,0,0,0,85,1590,1675
2020-04-05,23,3433,4274,2049,9989,9110,1983,49,21247,0,0,0,0,60,1617,1677
2020-04-05,24,3254,4121,1897,9380,8616,1844,46,20002,0,0,0,0,43,1665,1708
2020-04-06,1,3073,4076,1765,8818,8267,1779,43,19025,0,0,0,0,37,1672,1709
2020-04-06,2,2997,4053,1735,8471,7900,1709,43,18243,0,0,0,0,50,1706,1756
2020-04-06,3,2964,4067,1741,8322,7725,1664,44,17874,0,0,0,0,68,1675,1743
2020-04-06,4,2972,4155,1785,8317,7698,1650,47,17830,0,0,0,0,73,1588,1661
2020-04-06,5,3043,4358,1899,8611,7901,1682,51,18363,0,0,0,0,60,1455,1515
2020-04-06,6,3208,4704,2161,9254,8459,1811,58,19699,0,0,0,0,41,1291,1332
2020-04-06,7,3371,4946,2507,10152,9163,1984,64,21481,12,158,3,173,25,1112,1137
2020-04-06,8,3410,5024,2708,10795,9563,2100,65,22642,247,1200,145,1592,16,978,994
2020-04-06,9,3412,5068,2674,10715,9748,2163,62,22807,693,2891,514,4098,11,937,948
2020-04-06,10,3388,5063,2595,10397,9929,2187,59,22692,1012,4069,889,5970,12,965,977
2020-04-06,11,3368,5035,2507,9933,9928,2194,56,22230,1111,4651,1102,6864,16,996,1012
2020-04-06,12,3356,5016,2426,9496,9793,2172,53,21634,1116,5007,1183,7306,20,1008,1028
2020-04-06,13,3342,5022,2373,9212,9650,2171,51,21203,1116,5106,1202,7424,24,1046,1070
2020-04-06,14,3355,4990,2319,9158,9634,2151,50,21112,1114,5004,1207,7325,25,1120,1145
2020-04-06,15,3376,4958,2268,9064,9690,2117,50,21039,1102,4809,1188,7099,25,1189,1214
2020-04-06,16,3405,4954,2234,9116,9685,2141,50,21110,1061,4470,1154,6685,26,1222,1248
2020-04-06,17,3475,4956,2235,9414,9697,2173,52,21454,1036,3981,1076,6093,31,1216,1247
2020-04-06,18,3475,4933,2272,10145,9881,2233,54,22430,844,2762,794,4400,37,1187,1224
2020-04-06,19,3509,4961,2306,10793,10071,2313,54,23348,367,894,304,1565,37,1137,1174
2020-04-06,20,3722,5125,2353,11561,10805,2457,56,24996,33,18,16,67,37,1072,1109
2020-04-06,21,3774,5006,2417,11820,10932,2430,57,25357,0,0,0,0,39,1018,1057
2020-04-06,22,3643,4724,2313,11311,10495,2302,56,24282,0,0,0,0,40,975,1015
2020-04-06,23,3533,4457,2136,10468,9853,2107,52,22597,0,0,0,0,44,934,978
2020-04-06,24,3346,4274,1976,9765,9261,1930,50,21124,0,0,0,0,47,888,935
2020-04-07,1,3153,4169,1865,9227,8750,1883,50,20031,0,0,0,0,65,759,824
2020-04-07,2,3078,4124,1824,8866,8412,1779,51,19228,0,0,0,0,58,655,713
2020-04-07,3,3044,4126,1816,8698,8282,1717,51,18868,0,0,0,0,48,563,611
2020-04-07,4,3052,4203,1843,8650,8243,1701,52,18766,0,0,0,0,38,474,512
2020-04-07,5,3123,4410,1944,8805,8376,1732,56,19090,0,0,0,0,29,393,422
2020-04-07,6,3291,4759,2196,9333,8960,1830,62,20306,0,0,0,0,23,324,347
2020-04-07,7,3440,4987,2541,10157,9694,1987,69,22026,20,194,13,227,20,249,269
2020-04-07,8,3462,5042,2695,10630,9977,2068,71,22868,377,1467,281,2125,18,182,200
2020-04-07,9,3453,5053,2658,10491,10115,2149,68,22941,1004,3389,815,5208,15,144,159
2020-04-07,10,3419,5037,2572,10065,10013,2193,64,22454,1392,4468,1242,7102,13,141,154
2020-04-07,11,3397,5003,2487,9575,9923,2166,61,21844,1492,4706,1385,7583,13,166,179
2020-04-07,12,3358,4981,2409,9118,9754,2079,58,21127,1488,4750,1346,7584,14,191,205
2020-04-07,13,3322,4988,2366,8826,9650,2066,55,20714,1439,4690,1303,7432,13,209,222
2020-04-07,14,3315,4957,2324,8672,9607,2001,53,20452,1393,4503,1240,7136,14,241,255
2020-04-07,15,3331,4936,2274,8617,9522,1945,53,20256,1352,4224,1137,6713,14,283,297
2020-04-07,16,3378,4943,2243,8696,9459,1986,53,20311,1292,3804,1022,6118,16,314,330
2020-04-07,17,3464,4939,2260,9012,9617,2075,55,20877,1171,3150,834,5155,26,329,355
2020-04-07,18,3473,4929,2288,9710,9836,2184,56,21903,840,2000,530,3370,57,320,377
2020-04-07,19,3510,4954,2301,10496,10267,2246,57,23184,333,611,183,1127,128,297,425
2020-04-07,20,3717,5127,2341,11267,11088,2421,60,24954,29,12,8,49,225,283,508
2020-04-07,21,3771,5013,2376,11544,11179,2430,61,25330,0,0,0,0,303,276,579
2020-04-07,22,3648,4734,2282,11093,10810,2311,59,24391,0,0,0,0,334,298,632
2020-04-07,23,3531,4470,2110,10300,10164,2113,55,22750,0,0,0,0,341,348,689
2020-04-07,24,3347,4286,1956,9598,9469,1945,53,21184,0,0,0,0,350,381,731
2020-04-08,1,3104,4162,1832,8859,8968,1848,53,19854,0,0,0,0,481,397,878
2020-04-08,2,3024,4120,1791,8559,8589,1761,53,19094,0,0,0,0,482,407,889
2020-04-08,3,2989,4127,1781,8371,8373,1708,53,18632,0,0,0,0,488,404,892
2020-04-08,4,2998,4202,1809,8303,8284,1680,55,18460,0,0,0,0,487,432,919
2020-04-08,5,3067,4409,1911,8499,8468,1713,58,18871,0,0,0,0,475,509,984
2020-04-08,6,3227,4756,2159,9024,9024,1829,63,20067,0,0,0,0,441,577,1018
2020-04-08,7,3364,4967,2503,9813,9495,2003,69,21517,9,100,5,114,374,583,957
2020-04-08,8,3385,5018,2652,10255,9859,2077,72,22384,159,854,100,1113,291,538,829
2020-04-08,9,3370,5025,2607,10372,10369,2073,70,23005,487,2189,337,3013,209,505,714
2020-04-08,10,3329,4999,2524,9975,10610,2014,66,22784,775,3203,591,4569,146,528,674
2020-04-08,11,3300,4961,2430,9512,10604,1911,64,22210,914,3749,714,5377,109,604,713
2020-04-08,12,3270,4930,2357,9241,10653,1814,62,21887,987,4112,767,5866,82,703,785
2020-04-08,13,3258,4932,2325,8893,10623,1737,59,21430,1007,4208,812,6027,72,804,876
2020-04-08,14,3288,4902,2286,8747,10562,1693,58,21179,969,4067,777,5813,81,918,999
2020-04-08,15,3339,4893,2256,8756,10408,1692,55,21030,896,3831,678,5405,100,1048,1148
2020-04-08,16,3420,4925,2243,8888,10283,1773,53,21118,775,3543,574,4892,123,1144,1267
2020-04-08,17,3492,4954,2256,9384,10255,1882,55,21697,629,3033,416,4078,158,1206,1364
2020-04-08,18,3467,4981,2277,9852,10381,2047,58,22459,430,1937,226,2593,219,1238,1457
2020-04-08,19,3494,4924,2283,10557,10774,2220,59,23730,165,569,72,806,302,1216,1518
2020-04-08,20,3695,5062,2287,11213,11272,2414,65,25083,12,6,3,21,395,1171,1566
2020-04-08,21,3750,4961,2320,11420,11284,2406,66,25296,0,0,0,0,456,1129,1585
2020-04-08,22,3628,4685,2208,11000,10909,2290,64,24385,0,0,0,0,454,1089,1543
2020-04-08,23,3522,4408,2049,10379,10325,2116,60,23004,0,0,0,0,419,1051,1470
2020-04-08,24,3330,4226,1898,9627,9590,1958,58,21358,0,0,0,0,377,1018,1395
2020-04-09,1,3127,4099,1782,8847,9230,1793,62,20053,0,0,0,0,349,958,1307
2020-04-09,2,3066,4064,1743,8511,8847,1707,63,19249,0,0,0,0,193,926,1119
2020-04-09,3,3042,4073,1733,8301,8596,1667,64,18749,0,0,0,0,106,871,977
2020-04-09,4,3069,4148,1758,8240,8404,1652,66,18484,0,0,0,0,75,775,850
2020-04-09,5,3151,4353,1856,8421,8581,1683,71,18876,0,0,0,0,66,657,723
2020-04-09,6,3306,4694,2105,8923,9069,1785,76,19972,0,0,0,0,68,529,597
2020-04-09,7,3451,4900,2437,9746,9706,1928,82,21582,3,195,2,200,70,387,457
2020-04-09,8,3465,4955,2594,10202,10049,2044,82,22497,46,1339,33,1418,59,269,328
2020-04-09,9,3439,4962,2544,10195,10200,2103,79,22697,200,3134,180,3514,46,208,254
2020-04-09,10,3408,4937,2459,10125,10055,2098,73,22469,391,4347,381,5119,41,184,225
2020-04-09,11,3373,4900,2368,9908,9985,2022,66,22097,526,4928,518,5972,45,177,222
2020-04-09,12,3312,4867,2309,9764,9892,1950,61,21782,650,5235,649,6534,59,184,243
2020-04-09,13,3260,4868,2276,9747,9755,1922,58,21600,738,5221,754,6713,74,206,280
2020-04-09,14,3257,4834,2246,9630,9664,1871,55,21338,784,4913,751,6448,76,228,304
2020-04-09,15,3276,4804,2225,9483,9656,1825,55,21137,823,4392,690,5905,72,252,324
2020-04-09,16,3325,4800,2216,9413,9555,1850,55,20986,801,3847,618,5266,76,279,355
2020-04-09,17,3399,4786,2233,9430,9741,1898,54,21241,759,3098,519,4376,87,304,391
2020-04-09,18,3413,4758,2242,9621,10128,2039,59,21964,642,1856,367,2865,100,318,418
2020-04-09,19,3435,4785,2249,10139,10737,2213,59,23267,301,529,148,978,121,326,447
2020-04-09,20,3633,4977,2249,10855,11344,2387,63,24769,32,8,10,50,142,342,484
2020-04-09,21,3705,4893,2243,11102,11288,2367,65,24941,0,0,0,0,136,357,493
2020-04-09,22,3608,4644,2133,10667,11012,2252,64,24113,0,0,0,0,112,375,487
2020-04-09,23,3522,4387,1955,9950,10388,2103,61,22622,0,0,0,0,97,380,477
2020-04-09,24,3356,4217,1806,9283,9708,1956,60,21126,0,0,0,0,91,362,453
2020-04-10,1,3186,4119,1713,8925,8879,1821,59,19805,0,0,0,0,75,393,468
2020-04-10,2,3119,4094,1672,8605,8491,1735,58,19009,0,0,0,0,71,371,442
2020-04-10,3,3088,4094,1651,8379,8283,1682,58,18522,0,0,0,0,69,359,428
2020-04-10,4,3096,4161,1667,8336,8200,1666,59,18381,0,0,0,0,67,344,411
2020-04-10,5,3162,4331,1753,8502,8337,1698,61,18718,0,0,0,0,60,322,382
2020-04-10,6,3266,4612,1975,9032,8853,1798,67,19870,0,0,0,0,47,293,340
2020-04-10,7,3362,4779,2274,9732,9441,1948,69,21312,44,108,15,167,36,252,288
2020-04-10,8,3366,4862,2417,10101,9771,2062,71,22124,466,828,284,1578,32,220,252
2020-04-10,9,3366,4871,2397,9948,9981,2117,69,22234,1095,2139,814,4048,30,221,251
2020-04-10,10,3350,4812,2312,9457,10053,2127,66,21822,1409,3192,1253,5854,27,254,281
2020-04-10,11,3303,4747,2272,9008,9972,2141,62,21302,1458,3747,1476,6681,26,320,346
2020-04-10,12,3260,4683,2237,8738,9793,2098,58,20805,1423,4121,1544,7088,23,422,445
2020-04-10,13,3215,4665,2180,8563,9618,2082,55,20437,1376,4233,1543,7152,26,520,546
2020-04-10,14,3205,4618,2147,8452,9526,2012,53,20162,1335,4082,1506,6923,37,544,581
2020-04-10,15,3208,4577,2115,8354,9491,1983,51,19998,1288,3819,1436,6543,62,478,540
2020-04-10,16,3266,4582,2103,8473,9409,1957,50,20010,1238,3435,1327,6000,126,363,489
2020-04-10,17,3334,4592,2111,8683,9474,1949,53,20278,1170,2869,1163,5202,246,259,505
2020-04-10,18,3316,4506,2116,9204,9746,2007,54,21131,912,1895,830,3637,394,201,595
2020-04-10,19,3323,4512,2095,9806,10020,2125,54,22124,400,628,334,1362,521,221,742
2020-04-10,20,3479,4712,2077,10362,10626,2281,57,23445,46,18,25,89,616,333,949
2020-04-10,21,3563,4680,2080,10718,10723,2279,60,23899,0,0,0,0,693,514,1207
2020-04-10,22,3507,4491,1995,10428,10511,2208,59,23324,0,0,0,0,748,684,1432
2020-04-10,23,3521,4274,1857,9869,10039,2077,56,22160,0,0,0,0,772,834,1606
2020-04-10,24,3388,4100,1735,9248,9379,1934,54,20736,0,0,0,0,776,1035,1811
2020-04-11,1,3236,4026,1698,8547,8691,1855,55,19267,0,0,0,0,876,673,1549
2020-04-11,2,3152,3987,1649,8171,8302,1768,53,18414,0,0,0,0,833,915,1748
2020-04-11,3,3103,3981,1620,7957,8050,1707,53,17887,0,0,0,0,760,1205,1965
2020-04-11,4,3094,4003,1620,7841,7931,1670,55,17617,0,0,0,0,668,1464,2132
2020-04-11,5,3121,4079,1655,7879,7974,1682,57,17712,0,0,0,0,571,1655,2226
2020-04-11,6,3174,4197,1748,8100,8223,1728,61,18232,0,0,0,0,478,1776,2254
2020-04-11,7,3171,4229,1869,8404,8398,1790,66,18777,47,267,25,339,402,1813,2215
2020-04-11,8,3165,4355,1998,8562,8350,1771,66,18869,446,1966,322,2734,340,1750,2090
2020-04-11,9,3202,4425,2105,8551,8331,1656,64,18723,1059,4531,877,6467,281,1619,1900
2020-04-11,10,3220,4414,2130,8282,8150,1527,60,18138,1405,6207,1311,8923,220,1475,1695
2020-04-11,11,3203,4378,2122,7850,7909,1411,55,17346,1497,6991,1521,10009,168,1357,1525
2020-04-11,12,3187,4342,2090,7422,7716,1336,51,16645,1507,7342,1595,10444,138,1308,1446
2020-04-11,13,3176,4298,2046,7134,7567,1254,49,16123,1476,7369,1594,10439,114,1346,1460
2020-04-11,14,3223,4257,1991,6971,7508,1189,49,15836,1444,7308,1576,10328,103,1513,1616
2020-04-11,15,3276,4241,1955,6995,7561,1191,49,15914,1406,7196,1516,10118,122,1820,1942
2020-04-11,16,3351,4281,1936,7187,7783,1297,49,16436,1360,6927,1401,9688,183,2155,2338
2020-04-11,17,3466,4341,1950,7572,8060,1483,51,17284,1303,6255,1234,8792,282,2396,2678
2020-04-11,18,3531,4356,1957,8314,8507,1722,53,18714,1039,4365,880,6284,398,2561,2959
2020-04-11,19,3539,4388,1965,9024,9024,1925,54,20145,469,1501,339,2309,501,2680,3181
2020-04-11,20,3642,4599,1987,9647,9785,2132,56,21738,57,54,25,136,577,2740,3317
2020-04-11,21,3705,4601,2045,10089,10041,2171,56,22475,0,0,0,0,623,2773,3396
2020-04-11,22,3590,4446,1999,9799,9788,2108,53,21867,0,0,0,0,617,2811,3428
2020-04-11,23,3444,4248,1891,9282,9313,1981,50,20745,0,0,0,0,562,2842,3404
2020-04-11,24,3291,4104,1775,8710,8744,1852,47,19473,0,0,0,0,491,2853,3344
2020-04-12,1,3098,4060,1647,8242,8342,1815,45,18562,0,0,0,0,396,2816,3212
2020-04-12,2,3005,4023,1603,7907,7990,1741,44,17801,0,0,0,0,332,2796,3128
2020-04-12,3,2949,4012,1592,7700,7764,1675,43,17301,0,0,0,0,286,2742,3028
2020-04-12,4,2937,4034,1615,7567,7645,1629,43,17002,0,0,0,0,251,2678,2929
2020-04-12,5,2954,4089,1673,7584,7694,1637,44,17081,0,0,0,0,216,2615,2831
2020-04-12,6,2965,4168,1779,7766,7823,1666,47,17427,0,0,0,0,181,2529,2710
2020-04-12,7,2951,4241,1913,7968,8003,1683,49,17838,53,369,24,446,153,2401,2554
2020-04-12,8,2955,4369,2076,7945,8052,1694,52,17872,463,2359,312,3134,121,2235,2356
2020-04-12,9,3015,4396,2196,7874,8048,1717,54,17813,1055,5086,844,6985,88,2069,2157
2020-04-12,10,3050,4368,2196,7544,8056,1733,54,17508,1361,6724,1270,9355,63,1935,1998
2020-04-12,11,3080,4325,2127,7104,7919,1708,52,16901,1431,7344,1492,10267,50,1852,1902
2020-04-12,12,3144,4318,2051,6696,7774,1661,51,16292,1432,7505,1561,10498,44,1866,1910
2020-04-12,13,3205,4283,1977,6491,7590,1544,51,15794,1393,7431,1570,10394,36,1987,2023
2020-04-12,14,3278,4263,1900,6308,7545,1453,51,15474,1336,7251,1539,10126,29,2153,2182
2020-04-12,15,3339,4257,1845,6316,7546,1447,51,15473,1271,6870,1440,9581,29,2315,2344
2020-04-12,16,3385,4269,1813,6596,7645,1510,51,15916,1209,6260,1328,8797,49,2436,2485
2020-04-12,17,3456,4277,1823,7144,7952,1618,51,16882,1128,5382,1173,7683,138,2483,2621
2020-04-12,18,3503,4274,1865,7972,8324,1731,52,18194,864,3644,821,5329,333,2445,2778
2020-04-12,19,3511,4365,1911,8702,8769,1865,53,19507,381,1249,319,1949,541,2323,2864
2020-04-12,20,3659,4632,1983,9384,9574,2077,55,21208,48,55,23,126,686,2196,2882
2020-04-12,21,3706,4646,2094,9864,9862,2137,55,22037,0,2,0,2,766,2122,2888
2020-04-12,22,3597,4450,2036,9616,9592,2062,52,21441,0,0,0,0,781,2083,2864
2020-04-12,23,3447,4253,1887,9036,9114,1926,49,20245,0,0,0,0,782,2087,2869
2020-04-12,24,3273,4168,1762,8495,8590,1797,46,19046,0,0,0,0,808,2128,2936
2020-04-13,1,3022,4261,1703,8420,8160,1760,43,18499,0,0,0,0,836,1782,2618
2020-04-13,2,2937,4257,1687,8150,7949,1699,42,17957,0,0,0,0,828,1841,2669
2020-04-13,3,2902,4290,1699,7999,7772,1658,42,17588,0,0,0,0,792,1935,2727
2020-04-13,4,2909,4397,1749,7996,7752,1638,43,17547,0,0,0,0,732,2013,2745
2020-04-13,5,2981,4621,1871,8231,8001,1677,45,18071,0,0,0,0,670,2056,2726
2020-04-13,6,3137,4968,2133,8825,8552,1806,50,19350,0,0,0,0,605,2054,2659
2020-04-13,7,3269,5193,2488,9683,9260,1996,55,21111,59,344,18,421,513,1998,2511
2020-04-13,8,3308,5244,2665,10164,9568,2095,57,22003,481,2189,260,2930,399,1944,2343
2020-04-13,9,3319,5221,2615,9987,9601,2089,57,21855,1085,4810,753,6648,294,1969,2263
2020-04-13,10,3310,5169,2525,9493,9516,2061,57,21248,1405,6467,1190,9062,207,2087,2294
2020-04-13,11,3301,5108,2433,8946,9394,1980,56,20496,1487,7165,1436,10088,162,2268,2430
2020-04-13,12,3302,5045,2351,8554,9290,1918,55,19936,1508,7435,1539,10482,155,2452,2607
2020-04-13,13,3300,5014,2297,8332,9182,1870,54,19556,1518,7414,1565,10497,149,2602,2751
2020-04-13,14,3349,4965,2244,8220,9063,1836,54,19292,1518,7254,1557,10329,135,2722,2857
2020-04-13,15,3389,4920,2190,8267,9029,1822,54,19290,1525,6996,1506,10027,127,2825,2952
2020-04-13,16,3449,4923,2155,8509,9140,1881,54,19702,1502,6575,1403,9480,145,2905,3050
2020-04-13,17,3523,4948,2154,8920,9371,1965,55,20430,1441,5821,1257,8519,181,2934,3115
2020-04-13,18,3580,4969,2198,9736,9674,2072,56,21656,1156,4053,914,6123,240,2890,3130
2020-04-13,19,3578,5003,2229,10582,10037,2180,57,22973,530,1424,364,2318,357,2758,3115
2020-04-13,20,3717,5180,2258,11075,10721,2351,59,24322,61,58,27,146,487,2541,3028
2020-04-13,21,3759,5102,2334,11348,10908,2362,59,24794,0,2,0,2,524,2314,2838
2020-04-13,22,3602,4825,2237,10857,10511,2241,55,23781,0,0,0,0,488,2141,2629
2020-04-13,23,3447,4572,2066,10082,9813,2051,50,22113,0,0,0,0,461,1998,2459
2020-04-13,24,3259,4425,1915,9362,9135,1887,47,20548,0,0,0,0,451,1804,2255
2020-04-14,1,3062,4354,1850,8875,8571,1808,45,19418,0,0,0,0,362,1736,2098
2020-04-14,2,2984,4342,1819,8576,8268,1725,44,18732,0,0,0,0,378,1245,1623
2020-04-14,3,2951,4360,1817,8428,8091,1672,44,18355,0,0,0,0,429,823,1252
2020-04-14,4,2956,4450,1848,8391,8016,1646,45,18217,0,0,0,0,500,444,944
2020-04-14,5,3024,4668,1946,8615,8248,1673,48,18704,0,0,0,0,562,239,801
2020-04-14,6,3179,5024,2196,9226,8829,1783,53,20011,0,0,0,0,553,253,806
2020-04-14,7,3307,5215,2532,10131,9533,1949,59,21791,16,229,10,255,473,347,820
2020-04-14,8,3333,5239,2689,10486,9772,1991,60,22427,577,2863,371,3811,358,427,785
2020-04-14,9,3332,5168,2620,10087,9652,1925,59,21840,1410,6076,1130,8616,255,531,786
2020-04-14,10,3308,5077,2524,9438,9432,1741,58,20788,1605,7422,1574,10601,211,675,886
2020-04-14,11,3280,4980,2432,8889,9274,1570,57,19908,1622,7916,1765,11303,218,786,1004
2020-04-14,12,3248,4901,2361,8401,9134,1466,55,19175,1663,8057,1789,11509,233,807,1040
2020-04-14,13,3223,4866,2327,8168,9151,1402,54,18894,1661,8060,1800,11521,210,740,950
2020-04-14,14,3238,4812,2284,8140,9158,1387,54,18858,1657,8073,1796,11526,155,610,765
2020-04-14,15,3275,4768,2247,8289,9231,1424,54,19117,1653,8049,1795,11497,99,463,562
2020-04-14,16,3335,4776,2228,8611,9385,1533,55,19702,1646,7824,1780,11250,60,333,393
2020-04-14,17,3386,4797,2249,9160,9532,1726,55,20592,1614,7189,1621,10424,45,240,285
2020-04-14,18,3452,4829,2267,9941,9863,1971,57,21950,1439,5436,1231,8106,68,176,244
2020-04-14,19,3466,4878,2285,10745,10300,2175,58,23395,584,1759,454,2797,149,129,278
2020-04-14,20,3626,5072,2279,11295,10945,2365,60,24781,23,63,17,103,264,105,369
2020-04-14,21,3675,5003,2322,11533,11177,2359,60,25246,0,0,0,0,331,110,441
2020-04-14,22,3535,4733,2206,11034,10724,2245,56,24176,0,0,0,0,331,132,463
2020-04-14,23,3428,4471,2031,10245,10037,2062,52,22514,0,0,0,0,312,152,464
2020-04-14,24,3246,4308,1881,9479,9300,1903,49,20849,0,0,0,0,296,168,464
2020-04-15,1,3047,4300,1768,8709,8568,1850,46,19288,0,0,0,0,373,332,705
2020-04-15,2,2973,4268,1724,8403,8307,1753,45,18623,0,0,0,0,345,340,685
2020-04-15,3,2943,4270,1708,8247,8098,1695,47,18203,0,0,0,0,298,346,644
2020-04-15,4,2959,4336,1723,8213,8129,1657,49,18168,0,0,0,0,231,337,568
2020-04-15,5,3029,4532,1807,8438,8339,1677,53,18627,0,0,0,0,160,317,477
2020-04-15,6,3186,4853,2040,9019,8901,1780,60,19877,0,0,0,0,108,309,417
2020-04-15,7,3294,5075,2345,9887,9485,1939,64,21504,21,306,15,342,78,305,383
2020-04-15,8,3324,5117,2496,10159,9717,1949,64,22016,619,3273,474,4366,60,259,319
2020-04-15,9,3313,5105,2459,9831,9556,1852,61,21423,1439,6522,1285,9246,46,180,226
2020-04-15,10,3279,5067,2403,9246,9359,1677,58,20459,1613,7674,1665,10952,35,113,148
2020-04-15,11,3253,5036,2353,8713,9233,1558,55,19679,1624,8135,1842,11601,27,80,107
2020-04-15,12,3235,5001,2317,8340,9132,1475,54,19119,1662,8224,1853,11739,18,87,105
2020-04-15,13,3251,4987,2298,8221,9190,1441,53,19023,1651,8227,1850,11728,11,159,170
2020-04-15,14,3324,4950,2267,8232,9227,1442,54,19073,1642,8226,1846,11714,9,389,398
2020-04-15,15,3402,4922,2233,8438,9358,1462,54,19431,1640,8198,1844,11682,14,833,847
2020-04-15,16,3493,4936,2203,8718,9530,1582,54,20003,1627,7963,1817,11407,31,1360,1391
2020-04-15,17,3598,4948,2209,9377,9659,1767,54,20976,1577,7285,1649,10511,78,1756,1834
2020-04-15,18,3664,4942,2227,10055,9923,2015,55,22165,1328,5520,1241,8089,163,1956,2119
2020-04-15,19,3666,4983,2245,10799,10321,2230,56,23523,512,1800,440,2752,272,2027,2299
2020-04-15,20,3775,5146,2256,11251,10885,2404,58,24716,21,64,14,99,369,2042,2411
2020-04-15,21,3805,5075,2300,11528,11064,2402,58,25175,0,0,0,0,430,2074,2504
2020-04-15,22,3657,4811,2207,10999,10618,2277,55,24072,0,0,0,0,455,2136,2591
2020-04-15,23,3425,4540,2032,10168,9944,2092,50,22372,0,0,0,0,469,2197,2666
2020-04-15,24,3234,4372,1881,9408,9214,1921,47,20708,0,0,0,0,488,2249,2737
2020-04-16,1,3051,4334,1787,8948,8555,1854,45,19525,0,0,0,0,538,2477,3015
2020-04-16,2,2974,4295,1745,8651,8249,1758,44,18827,0,0,0,0,579,2439,3018
2020-04-16,3,2929,4296,1731,8394,8056,1702,44,18321,0,0,0,0,581,2382,2963
2020-04-16,4,2930,4378,1752,8356,7964,1663,45,18151,0,0,0,0,560,2313,2873
2020-04-16,5,2987,4579,1849,8525,8066,1679,48,18437,0,0,0,0,549,2232,2781
2020-04-16,6,3120,4907,2090,8944,8560,1779,53,19463,0,0,0,0,526,2145,2671
2020-04-16,7,3236,5121,2424,9647,9218,1934,58,20978,18,311,12,341,446,2029,2475
2020-04-16,8,3287,5195,2593,10015,9424,1947,59,21563,530,3257,391,4178,336,1838,2174
2020-04-16,9,3305,5185,2548,9748,9390,1830,58,21147,1267,6369,1175,8811,247,1615,1862
2020-04-16,10,3321,5169,2475,9252,9267,1657,56,20347,1410,7435,1556,10401,182,1417,1599
2020-04-16,11,3369,5155,2404,8744,9050,1496,55,19459,1359,7907,1700,10966,140,1280,1420
2020-04-16,12,3394,5114,2342,8397,8978,1387,54,18932,1345,7897,1651,10893,117,1218,1335
2020-04-16,13,3416,5102,2315,8254,8970,1348,55,18744,1239,7804,1498,10541,101,1212,1313
2020-04-16,14,3466,5066,2279,8239,8891,1337,56,18641,1199,7757,1418,10374,92,1254,1346
2020-04-16,15,3505,5036,2234,8392,9003,1377,56,18945,1127,7651,1319,10097,101,1329,1430
2020-04-16,16,3558,5038,2200,8700,9156,1478,57,19509,1022,7196,1271,9489,159,1423,1582
2020-04-16,17,3625,5035,2205,9272,9324,1647,59,20421,872,6329,1087,8288,298,1494,1792
2020-04-16,18,3684,5021,2229,9926,9641,1886,59,21630,669,4563,776,6008,472,1513,1985
2020-04-16,19,3664,5061,2240,10663,10039,2117,58,22994,268,1451,255,1974,620,1493,2113
2020-04-16,20,3807,5222,2252,11189,10611,2332,58,24308,12,55,7,74,761,1459,2220
2020-04-16,21,3849,5152,2304,11454,10835,2336,59,24801,0,0,0,0,882,1417,2299
2020-04-16,22,3703,4905,2229,10926,10433,2213,55,23745,0,0,0,0,959,1368,2327
2020-04-16,23,3446,4654,2070,10089,9784,2052,50,22094,0,0,0,0,1000,1314,2314
2020-04-16,24,3247,4487,1923,9396,9077,1880,46,20520,0,0,0,0,1010,1254,2264
2020-04-17,1,3064,4352,1831,8958,8473,1803,46,19395,0,0,0,0,1031,1221,2252
2020-04-17,2,2974,4328,1791,8620,8113,1720,45,18614,0,0,0,0,1023,1165,2188
2020-04-17,3,2926,4345,1784,8427,7888,1669,44,18146,0,0,0,0,1013,1087,2100
2020-04-17,4,2920,4425,1809,8351,7811,1651,45,17974,0,0,0,0,987,1008,1995
2020-04-17,5,2966,4613,1905,8510,8058,1675,47,18406,0,0,0,0,926,952,1878
2020-04-17,6,3097,4921,2140,9028,8571,1777,51,19544,0,0,0,0,842,938,1780
2020-04-17,7,3212,5117,2444,9796,9212,1929,54,21109,33,330,14,377,724,947,1671
2020-04-17,8,3269,5162,2605,10090,9452,1984,56,21701,250,1842,177,2269,567,935,1502
2020-04-17,9,3306,5122,2555,9799,9359,1973,58,21307,609,3860,539,5008,426,895,1321
2020-04-17,10,3334,5044,2468,9382,9149,1862,57,20569,875,5197,903,6975,328,862,1190
2020-04-17,11,3357,4957,2378,8936,8967,1717,55,19793,1015,5961,1152,8128,257,876,1133
2020-04-17,12,3372,4864,2317,8622,8776,1614,54,19184,1111,6409,1301,8821,212,921,1133
2020-04-17,13,3397,4813,2272,8429,8627,1568,53,18793,1141,6551,1338,9030,203,969,1172
2020-04-17,14,3440,4750,2233,8303,8601,1512,52,18585,1120,6454,1294,8868,246,1007,1253
2020-04-17,15,3475,4692,2197,8157,8607,1512,51,18445,1076,6157,1212,8445,339,1044,1383
2020-04-17,16,3518,4665,2182,8225,8692,1596,51,18681,981,5713,1114,7808,464,1093,1557
2020-04-17,17,3589,4654,2197,8551,8836,1741,52,19299,815,5015,983,6813,577,1150,1727
2020-04-17,18,3575,4643,2205,9103,9090,1919,54,20284,540,3479,710,4729,636,1217,1853
2020-04-17,19,3581,4672,2188,9715,9395,2085,55,21369,213,1242,291,1746,632,1286,1918
2020-04-17,20,3681,4844,2163,10285,10026,2276,57,22763,25,73,28,126,588,1342,1930
2020-04-17,21,3735,4848,2172,10640,10252,2295,57,23362,0,2,0,2,536,1404,1940
2020-04-17,22,3611,4678,2091,10316,9999,2211,55,22697,0,0,0,0,524,1497,2021
2020-04-17,23,3437,4463,1949,9731,9478,2062,51,21439,0,0,0,0,566,1608,2174
2020-04-17,24,3263,4300,1820,9147,8843,1909,48,20063,0,0,0,0,602,1697,2299
2020-04-18,1,3077,4168,1736,8722,8607,1820,45,19318,0,0,0,0,758,1791,2549
2020-04-18,2,2982,4131,1688,8347,8198,1725,44,18439,0,0,0,0,680,1796,2476
2020-04-18,3,2922,4125,1665,8116,7878,1664,43,17826,0,0,0,0,584,1789,2373
2020-04-18,4,2902,4151,1669,7990,7756,1628,44,17542,0,0,0,0,475,1773,2248
2020-04-18,5,2919,4219,1706,8027,7755,1632,45,17584,0,0,0,0,367,1767,2134
2020-04-18,6,2974,4314,1799,8228,7930,1654,48,17984,0,0,0,0,281,1670,1951
2020-04-18,7,2952,4378,1911,8509,8050,1671,52,18406,28,450,23,501,222,1705,1927
2020-04-18,8,2991,4496,2023,8594,7945,1713,53,18427,207,2385,222,2814,187,1747,1934
2020-04-18,9,3048,4551,2119,8618,8023,1744,53,18558,540,4775,605,5920,190,1820,2010
2020-04-18,10,3095,4535,2127,8395,8005,1735,53,18306,810,6149,943,7902,213,1880,2093
2020-04-18,11,3115,4481,2107,7981,7952,1675,51,17778,929,6724,1141,8794,215,1896,2111
2020-04-18,12,3153,4410,2073,7639,7812,1620,50,17240,1015,6903,1241,9159,200,1927,2127
2020-04-18,13,3173,4336,2031,7363,7699,1564,49,16793,1060,6893,1268,9221,198,2014,2212
2020-04-18,14,3214,4283,1978,7178,7610,1483,49,16438,1075,6863,1263,9201,221,2164,2385
2020-04-18,15,3262,4259,1942,7094,7574,1452,50,16287,1104,6705,1256,9065,286,2351,2637
2020-04-18,16,3320,4299,1925,7224,7692,1499,50,16582,1066,6309,1190,8565,394,2494,2888
2020-04-18,17,3425,4363,1932,7707,7904,1593,52,17374,987,5661,1064,7712,505,2514,3019
2020-04-18,18,3472,4391,1957,8391,8277,1757,53,18597,817,4030,802,5649,609,2445,3054
2020-04-18,19,3491,4432,1968,9198,8792,1940,54,20102,405,1453,345,2203,695,2348,3043
2020-04-18,20,3600,4613,1971,9848,9551,2139,55,21714,61,84,39,184,753,2250,3003
2020-04-18,21,3672,4619,2029,10271,9843,2187,55,22478,0,4,0,4,784,2204,2988
2020-04-18,22,3561,4475,1985,9975,9554,2126,52,21830,0,0,0,0,791,2217,3008
2020-04-18,23,3393,4284,1868,9433,9116,2000,49,20720,0,0,0,0,778,2224,3002
2020-04-18,24,3233,4133,1751,8804,8591,1864,46,19429,0,0,0,0,750,2187,2937
2020-04-19,1,3029,4044,1654,8677,8424,1763,44,19025,0,0,0,0,717,2198,2915
2020-04-19,2,2937,3996,1617,8346,8075,1677,43,18258,0,0,0,0,651,2168,2819
2020-04-19,3,2880,3977,1610,8110,7801,1620,43,17692,0,0,0,0,543,2109,2652
2020-04-19,4,2865,3993,1627,7939,7613,1587,44,17300,0,0,0,0,443,2016,2459
2020-04-19,5,2883,4032,1671,7938,7591,1580,45,17270,0,0,0,0,372,1916,2288
2020-04-19,6,2919,4064,1759,8088,7704,1609,48,17565,0,0,0,0,310,1836,2146
2020-04-19,7,2869,4104,1849,8313,7720,1636,52,17839,89,594,48,731,248,1749,1997
2020-04-19,8,2893,4222,1976,8274,7621,1623,51,17688,552,3011,396,3959,206,1582,1788
2020-04-19,9,2949,4270,2061,8172,7489,1563,52,17394,1117,5757,937,7811,203,1357,1560
2020-04-19,10,3005,4268,2075,7849,7341,1494,52,16854,1368,7069,1307,9744,220,1151,1371
2020-04-19,11,3078,4237,2027,7495,7251,1371,50,16286,1425,7574,1496,10495,226,1057,1283
2020-04-19,12,3135,4257,1994,7132,7141,1268,50,15710,1433,7806,1583,10822,215,1204,1419
2020-04-19,13,3184,4223,1967,6880,7109,1196,50,15353,1410,7793,1593,10796,189,1609,1798
2020-04-19,14,3238,4229,1923,6726,7111,1161,50,15168,1379,7690,1572,10641,168,2045,2213
2020-04-19,15,3309,4245,1889,6779,7207,1189,50,15346,1342,7486,1505,10333,171,2340,2511
2020-04-19,16,3410,4321,1889,7030,7407,1335,51,15943,1291,7069,1408,9768,201,2548,2749
2020-04-19,17,3511,4382,1930,7608,7754,1546,53,17081,1233,6278,1271,8782,252,2688,2940
2020-04-19,18,3566,4399,2000,8518,8317,1800,55,18813,1001,4457,941,6399,332,2726,3058
2020-04-19,19,3592,4456,2032,9340,8824,1979,54,20315,482,1672,400,2554,440,2665,3105
2020-04-19,20,3686,4632,2036,9994,9550,2163,56,21881,75,112,41,228,571,2579,3150
2020-04-19,21,3761,4616,2080,10508,9882,2196,57,22765,0,0,0,0,659,2503,3162
2020-04-19,22,3615,4420,1982,10163,9607,2109,53,22049,0,0,0,0,661,2455,3116
2020-04-19,23,3395,4204,1823,9496,9097,1956,49,20716,0,0,0,0,658,2433,3091
2020-04-19,24,3187,4064,1694,8829,8554,1815,45,19359,0,0,0,0,685,2383,3068
2020-04-20,1,3031,4014,1642,8667,8357,1743,42,18928,0,0,0,0,526,2462,2988
2020-04-20,2,2948,3998,1616,8377,8085,1679,41,18301,0,0,0,0,581,2419,3000
2020-04-20,3,2903,4011,1618,8230,7893,1637,41,17920,0,0,0,0,696,2386,3082
2020-04-20,4,2901,4095,1655,8212,7870,1618,43,17861,0,0,0,0,791,2350,3141
2020-04-20,5,2960,4308,1760,8468,8090,1652,46,18374,0,0,0,0,806,2323,3129
2020-04-20,6,3095,4628,1996,9028,8646,1777,51,19621,0,0,0,0,779,2169,2948
2020-04-20,7,3193,4865,2326,9880,9296,1933,56,21283,56,574,36,666,726,2216,2942
2020-04-20,8,3267,4945,2477,10263,9565,2010,57,22014,345,2875,286,3506,670,1900,2570
2020-04-20,9,3313,4954,2433,10239,9594,1993,57,22003,755,5496,696,6947,637,1482,2119
2020-04-20,10,3347,4944,2371,9985,9445,1912,55,21518,1010,6853,1015,8878,631,1264,1895
2020-04-20,11,3400,4909,2334,9654,9348,1799,54,20978,1109,7391,1204,9704,620,1209,1829
2020-04-20,12,3447,4862,2297,9263,9318,1702,53,20456,1152,7596,1299,10047,561,1367,1928
2020-04-20,13,3478,4858,2283,9097,9252,1621,53,20144,1139,7580,1317,10036,475,1787,2262
2020-04-20,14,3539,4826,2266,8984,9258,1541,53,19958,1108,7428,1296,9832,421,2340,2761
2020-04-20,15,3594,4789,2244,8944,9238,1535,53,19892,1080,7096,1239,9415,446,2761,3207
2020-04-20,16,3673,4800,2234,9122,9310,1618,54,20223,1023,6565,1153,8741,538,2957,3495
2020-04-20,17,3759,4824,2240,9495,9497,1757,55,20923,949,5784,1011,7744,637,3015,3652
2020-04-20,18,3814,4806,2258,10053,9755,1963,55,21945,767,4118,728,5613,683,2999,3682
2020-04-20,19,3790,4802,2264,10708,10091,2151,55,23123,378,1565,304,2247,690,2935,3625
2020-04-20,20,3892,4936,2244,11268,10654,2341,57,24438,61,113,28,202,699,2849,3548
2020-04-20,21,3931,4863,2271,11562,10896,2339,57,24974,0,1,0,1,696,2782,3478
2020-04-20,22,3749,4592,2157,11072,10505,2217,53,23967,0,0,0,0,679,2787,3466
2020-04-20,23,3480,4332,1969,10293,9841,2033,49,22333,0,0,0,0,666,2859,3525
2020-04-20,24,3267,4165,1814,9574,9193,1865,45,20795,0,0,0,0,670,2945,3615
2020-04-21,1,3098,4112,1730,9092,8507,1802,44,19567,0,0,0,0,641,3005,3646
2020-04-21,2,3004,4080,1691,8770,8162,1717,44,18815,0,0,0,0,623,3014,3637
2020-04-21,3,2952,4078,1672,8510,8025,1665,43,18366,0,0,0,0,616,3041,3657
2020-04-21,4,2943,4151,1689,8478,7961,1638,44,18243,0,0,0,0,602,3088,3690
2020-04-21,5,2995,4348,1772,8659,8152,1663,47,18645,0,0,0,0,603,3099,3702
2020-04-21,6,3116,4660,1996,9210,8642,1769,52,19794,0,0,0,0,626,3062,3688
2020-04-21,7,3218,4888,2302,9982,9224,1921,56,21302,112,557,49,718,618,2992,3610
2020-04-21,8,3295,4948,2459,10292,9417,1978,58,21864,646,2814,403,3863,552,2892,3444
2020-04-21,9,3338,4943,2403,10083,9381,1972,58,21615,1274,5532,972,7778,454,2792,3246
2020-04-21,10,3378,4927,2350,9552,9231,1898,56,20857,1542,7012,1379,9933,354,2694,3048
2020-04-21,11,3434,4900,2322,9003,9056,1757,55,19992,1602,7563,1582,10747,274,2561,2835
2020-04-21,12,3480,4885,2292,8639,8976,1620,55,19411,1621,7726,1681,11028,210,2438,2648
2020-04-21,13,3523,4895,2279,8415,8974,1524,55,19089,1623,7720,1702,11045,166,2387,2553
2020-04-21,14,3593,4873,2259,8326,9038,1443,56,18984,1619,7648,1708,10975,169,2396,2565
2020-04-21,15,3674,4896,2237,8351,9158,1448,56,19135,1607,7446,1709,10762,229,2474,2703
2020-04-21,16,3769,4927,2228,8537,9299,1526,58,19541,1572,7041,1630,10243,336,2601,2937
2020-04-21,17,3848,4959,2241,9065,9466,1687,59,20398,1510,6336,1462,9308,469,2748,3217
2020-04-21,18,3924,4966,2256,9885,9825,1937,60,21829,1250,4611,1099,6960,600,2879,3479
2020-04-21,19,3914,4901,2257,10673,10223,2148,60,23222,631,1792,481,2904,701,2954,3655
2020-04-21,20,3999,5001,2232,11309,10770,2338,61,24595,106,149,53,308,772,2973,3745
2020-04-21,21,4033,4920,2267,11593,11043,2338,60,25154,0,0,0,0,830,2953,3783
2020-04-21,22,3863,4653,2156,11113,10615,2230,56,24136,0,0,0,0,866,2879,3745
2020-04-21,23,3591,4376,1969,10319,9940,2053,51,22484,0,0,0,0,875,2754,3629
2020-04-21,24,3340,4184,1815,9605,9241,1894,48,20908,0,0,0,0,868,2591,3459
2020-04-22,1,3090,4041,1738,9002,8582,1778,45,19527,0,0,0,0,846,2503,3349
2020-04-22,2,2993,4005,1693,8660,8222,1701,44,18748,0,0,0,0,792,2379,3171
2020-04-22,3,2937,4001,1673,8463,7990,1654,43,18272,0,0,0,0,734,2325,3059
2020-04-22,4,2924,4074,1690,8386,7918,1627,44,18098,0,0,0,0,640,2271,2911
2020-04-22,5,2968,4269,1770,8583,8135,1656,47,18542,0,0,0,0,534,2147,2681
2020-04-22,6,3074,4570,1989,9164,8686,1771,52,19795,0,0,0,0,472,1876,2348
2020-04-22,7,3177,4785,2299,9950,9237,1895,57,21260,31,516,24,571,417,1450,1867
2020-04-22,8,3272,4865,2430,10154,9445,1918,58,21695,614,3767,448,4829,305,1019,1324
2020-04-22,9,3365,4860,2396,9822,9407,1794,58,21200,1338,6669,1145,9152,203,731,934
2020-04-22,10,3451,4843,2354,9360,9307,1631,56,20472,1518,7642,1546,10706,145,599,744
2020-04-22,11,3533,4822,2313,9053,9254,1519,55,20001,1571,8117,1737,11425,115,633,748
2020-04-22,12,3617,4796,2284,8838,9421,1474,56,19909,1613,8191,1797,11601,123,797,920
2020-04-22,13,3706,4798,2269,8786,9596,1450,58,20010,1618,8206,1765,11589,163,1035,1198
2020-04-22,14,3807,4770,2241,8820,9944,1468,60,20413,1603,8206,1791,11600,219,1366,1585
2020-04-22,15,3911,4774,2209,8968,10329,1537,62,21017,1594,8125,1802,11521,307,1791,2098
2020-04-22,16,4040,4801,2187,9282,10750,1665,63,21882,1565,7846,1809,11220,434,2201,2635
2020-04-22,17,4138,4828,2176,10079,11048,1819,65,23132,1485,7290,1644,10419,588,2492,3080
2020-04-22,18,4178,4847,2210,10698,11253,2058,65,24193,1333,5673,1221,8227,726,2692,3418
2020-04-22,19,4157,4781,2226,11299,11380,2224,66,25086,572,2035,491,3098,784,2813,3597
2020-04-22,20,4210,4901,2220,11736,11655,2379,64,25953,31,103,28,162,806,2847,3653
2020-04-22,21,4198,4842,2275,12026,11804,2420,63,26431,0,0,0,0,818,2838,3656
2020-04-22,22,4003,4585,2179,11497,11293,2313,57,25280,0,0,0,0,790,2802,3592
2020-04-22,23,3718,4311,1997,10624,10468,2131,52,23393,0,0,0,0,734,2740,3474
2020-04-22,24,3454,4118,1842,9846,9650,1952,48,21615,0,0,0,0,671,2662,3333
2020-04-23,1,3213,3995,1746,9218,9136,1860,44,20378,0,0,0,0,502,2546,3048
2020-04-23,2,3084,3954,1702,8818,8717,1777,43,19475,0,0,0,0,468,2509,2977
2020-04-23,3,2992,3951,1678,8552,8427,1720,43,18861,0,0,0,0,444,2483,2927
2020-04-23,4,2971,4018,1690,8483,8298,1687,43,18631,0,0,0,0,420,2466,2886
2020-04-23,5,2994,4206,1772,8635,8534,1714,46,19048,0,0,0,0,394,2441,2835
2020-04-23,6,3117,4507,1987,9172,8987,1817,51,20147,0,0,0,0,376,2404,2780
2020-04-23,7,3235,4722,2290,10013,9519,1957,56,21665,46,531,25,602,344,2319,2663
2020-04-23,8,3355,4812,2433,10234,9815,1984,57,22209,682,3771,439,4892,273,2163,2436
2020-04-23,9,3491,4824,2399,9988,9944,1890,56,21999,1347,6547,1086,8980,183,2027,2210
2020-04-23,10,3598,4818,2360,9553,10076,1772,56,21575,1511,7533,1463,10507,112,1975,2087
2020-04-23,11,3722,4806,2326,9352,10302,1682,57,21513,1573,8037,1632,11242,73,1994,2067
2020-04-23,12,3826,4776,2294,9283,10635,1678,59,21774,1591,8162,1726,11479,68,2027,2095
2020-04-23,13,3941,4778,2282,9212,11029,1687,61,22109,1605,8125,1765,11495,84,2040,2124
2020-04-23,14,4059,4749,2261,9381,11554,1745,64,22864,1617,8068,1763,11448,105,2051,2156
2020-04-23,15,4165,4720,2235,9615,12063,1810,66,23674,1607,8067,1767,11441,129,2120,2249
2020-04-23,16,4270,4711,2211,10031,12541,1941,68,24701,1600,7825,1762,11187,175,2259,2434
2020-04-23,17,4358,4699,2216,10599,12732,2117,69,25638,1535,7253,1601,10389,246,2407,2653
2020-04-23,18,4339,4690,2231,11250,12773,2317,70,26532,1378,5716,1214,8308,308,2524,2832
2020-04-23,19,4291,4718,2233,11658,12676,2427,68,26950,614,2095,507,3216,353,2611,2964
2020-04-23,20,4315,4854,2208,11913,12695,2515,67,27309,39,106,33,178,386,2636,3022
2020-04-23,21,4294,4801,2267,12099,12711,2531,64,27525,0,0,0,0,405,2614,3019
2020-04-23,22,4096,4572,2167,11495,12145,2407,58,26226,0,0,0,0,397,2565,2962
2020-04-23,23,3826,4320,1994,10589,11234,2198,52,24194,0,0,0,0,366,2493,2859
2020-04-23,24,3561,4146,1843,9789,10318,2014,48,22288,0,0,0,0,340,2410,2750
2020-04-24,1,3295,4077,1740,9244,9912,1935,46,21257,0,0,0,0,282,2413,2695
2020-04-24,2,3163,4037,1686,8861,9397,1845,44,20268,0,0,0,0,318,2303,2621
2020-04-24,3,3066,4036,1666,8628,9034,1778,44,19607,0,0,0,0,363,2177,2540
2020-04-24,4,3029,4096,1674,8584,8863,1747,44,19360,0,0,0,0,396,1988,2384
2020-04-24,5,3045,4268,1750,8826,8979,1770,46,19742,0,0,0,0,414,1693,2107
2020-04-24,6,3150,4540,1959,9325,9433,1873,50,20803,0,0,0,0,399,1341,1740
2020-04-24,7,3248,4745,2222,10144,9815,1996,54,22128,66,576,49,691,344,1032,1376
2020-04-24,8,3381,4843,2379,10149,10260,2039,55,22621,785,3878,604,5267,257,747,1004
2020-04-24,9,3497,4849,2375,9812,10480,1968,55,22435,1447,6686,1307,9440,162,472,634
2020-04-24,10,3621,4826,2345,9501,10786,1881,56,22343,1578,7636,1640,10854,89,301,390
2020-04-24,11,3707,4793,2306,9347,11242,1851,58,22616,1609,8096,1798,11503,54,259,313
2020-04-24,12,3772,4733,2272,9327,11816,1861,59,23182,1649,8129,1828,11606,47,261,308
2020-04-24,13,3882,4707,2246,9304,12516,1917,61,23918,1660,8144,1824,11628,42,293,335
2020-04-24,14,4002,4669,2216,9509,13289,1992,63,24973,1655,8185,1822,11662,40,415,455
2020-04-24,15,4105,4623,2182,9884,14020,2118,65,26207,1625,8101,1823,11549,55,668,723
2020-04-24,16,4208,4596,2162,10351,14653,2248,67,27439,1607,7888,1801,11296,95,1049,1144
2020-04-24,17,4280,4575,2167,10969,14890,2414,69,28462,1563,7282,1643,10488,162,1476,1638
2020-04-24,18,4234,4552,2196,11558,14765,2576,70,29088,1340,5746,1246,8332,252,1835,2087
2020-04-24,19,4211,4561,2171,11861,14490,2650,68,29188,604,2145,505,3254,329,2065,2394
2020-04-24,20,4228,4690,2120,12061,14175,2722,66,29142,40,118,29,187,452,2154,2606
2020-04-24,21,4195,4692,2145,12151,13989,2714,63,29035,0,0,0,0,484,2156,2640
2020-04-24,22,4019,4522,2069,11579,13285,2589,58,27631,0,0,0,0,498,2117,2615
2020-04-24,23,3750,4307,1927,10839,12263,2370,52,25644,0,0,0,0,503,2019,2522
2020-04-24,24,3507,4128,1798,10067,11214,2158,48,23608,0,0,0,0,513,1846,2359
2020-04-25,1,3242,4051,1694,9578,10349,2032,46,22127,0,0,0,0,509,1839,2348
2020-04-25,2,3100,4006,1643,9071,9725,1914,44,20876,0,0,0,0,498,1725,2223
2020-04-25,3,2999,3993,1616,8722,9270,1837,44,19995,0,0,0,0,515,1629,2144
2020-04-25,4,2940,4011,1616,8520,9001,1785,44,19472,0,0,0,0,528,1489,2017
2020-04-25,5,2919,4078,1652,8501,8948,1776,45,19392,0,0,0,0,520,1270,1790
2020-04-25,6,2939,4153,1741,8736,8965,1794,48,19664,0,0,0,0,485,1003,1488
2020-04-25,7,2910,4221,1826,9004,8922,1793,51,19889,137,768,86,991,410,754,1164
2020-04-25,8,3014,4351,1937,8910,9088,1808,53,19977,685,3385,536,4606,319,508,827
2020-04-25,9,3174,4422,2035,8967,9503,1782,54,20426,1240,6007,1126,8373,240,253,493
2020-04-25,10,3343,4428,2074,8830,9921,1724,55,20650,1445,7180,1470,10095,178,93,271
2020-04-25,11,3507,4403,2073,8675,10414,1663,57,20929,1509,7680,1645,10834,137,57,194
2020-04-25,12,3682,4369,2048,8664,11061,1659,60,21564,1546,7889,1734,11169,122,58,180
2020-04-25,13,3849,4330,2011,8770,11770,1680,63,22403,1546,7904,1740,11190,132,59,191
2020-04-25,14,4025,4300,1964,8994,12510,1733,67,23424,1521,7886,1732,11139,172,76,248
2020-04-25,15,4181,4293,1941,9355,13213,1824,70,24583,1478,7734,1707,10919,245,174,419
2020-04-25,16,4332,4353,1930,9897,13806,2034,74,25933,1408,7305,1593,10306,347,454,801
2020-04-25,17,4455,4448,1944,10524,14335,2204,76,27266,1306,6537,1398,9241,463,897,1360
2020-04-25,18,4475,4506,1973,11145,14471,2396,77,28218,1036,4808,1042,6886,587,1350,1937
2020-04-25,19,4432,4478,1973,11685,14450,2534,75,28865,503,1988,469,2960,693,1698,2391
2020-04-25,20,4412,4601,1938,11874,14116,2588,72,28770,82,215,60,357,783,1911,2694
2020-04-25,21,4370,4601,1995,12021,13813,2586,68,28608,0,0,0,0,850,2030,2880
2020-04-25,22,4160,4446,1935,11518,13143,2485,62,27328,0,0,0,0,876,2126,3002
2020-04-25,23,3937,4236,1827,10724,12146,2310,56,25357,0,0,0,0,898,2230,3128
2020-04-25,24,3690,4054,1712,9948,11125,2135,51,23381,0,0,0,0,901,2328,3229
2020-04-26,1,3407,3989,1636,9453,10178,1958,48,21761,0,0,0,0,932,2074,3006
2020-04-26,2,3275,3933,1595,8973,9598,1851,46,20590,0,0,0,0,923,2129,3052
2020-04-26,3,3154,3901,1581,8631,9137,1776,45,19713,0,0,0,0,890,2228,3118
2020-04-26,4,3096,3902,1592,8428,8816,1724,45,19138,0,0,0,0,859,2325,3184
2020-04-26,5,3067,3929,1634,8379,8604,1710,46,18864,0,0,0,0,830,2372,3202
2020-04-26,6,3078,3941,1711,8408,8541,1726,48,18847,0,1,0,1,805,2388,3193
2020-04-26,7,3026,3971,1795,8355,8246,1713,49,18486,130,715,84,929,753,2357,3110
2020-04-26,8,3122,4114,1906,8350,8217,1693,52,18431,650,3074,488,4212,644,2242,2886
2020-04-26,9,3297,4201,2004,8258,8510,1654,54,18595,1201,5376,1027,7604,528,2065,2593
2020-04-26,10,3473,4249,2022,8117,8778,1591,56,18661,1434,6536,1376,9346,445,1910,2355
2020-04-26,11,3655,4270,2000,7959,9237,1534,58,18907,1510,7189,1548,10247,385,1839,2224
2020-04-26,12,3856,4324,1978,7963,9853,1556,61,19551,1555,7468,1625,10648,353,1891,2244
2020-04-26,13,4020,4331,1951,7974,10534,1591,63,20282,1564,7441,1633,10638,368,2110,2478
2020-04-26,14,4187,4387,1903,8091,11406,1658,66,21340,1556,7313,1614,10483,435,2439,2874
2020-04-26,15,4335,4451,1879,8431,12065,1767,68,22451,1545,7002,1569,10116,556,2760,3316
2020-04-26,16,4475,4571,1881,8900,12610,1892,70,23593,1513,6356,1463,9332,689,2992,3681
2020-04-26,17,4554,4696,1923,9517,13122,2075,73,24906,1472,5397,1287,8156,808,3121,3929
2020-04-26,18,4540,4697,2010,10317,13627,2387,73,26525,1269,3744,957,5970,905,3171,4076
2020-04-26,19,4489,4682,2035,11079,13768,2538,73,27580,682,1452,441,2575,953,3154,4107
2020-04-26,20,4454,4768,2032,11440,13649,2582,69,27863,130,136,60,326,980,3108,4088
2020-04-26,21,4421,4706,2049,11681,13275,2594,65,27739,0,1,0,1,1008,3082,4090
2020-04-26,22,4210,4458,1966,11183,12405,2472,59,26243,0,0,0,0,1032,3095,4127
2020-04-26,23,3978,4200,1796,10348,11458,2266,53,24251,0,0,0,0,1054,3109,4163
2020-04-26,24,3700,4036,1651,9543,10477,2076,49,22270,0,0,0,0,1064,3094,4158
2020-04-27,1,3454,3977,1620,8993,9636,1862,48,20659,0,0,0,0,1027,2953,3980
2020-04-27,2,3308,3944,1588,8656,9176,1773,47,19772,0,0,0,0,1012,2946,3958
2020-04-27,3,3206,3933,1574,8435,8915,1706,46,19222,0,0,0,0,1006,2884,3890
2020-04-27,4,3153,3994,1592,8397,8769,1674,46,19006,0,0,0,0,983,2740,3723
2020-04-27,5,3187,4177,1678,8603,9030,1698,48,19499,0,0,0,0,930,2589,3519
2020-04-27,6,3284,4464,1885,9149,9565,1780,52,20665,0,7,0,7,873,2548,3421
2020-04-27,7,3380,4705,2154,9906,10080,1892,55,22052,162,802,102,1066,796,2584,3380
2020-04-27,8,3533,4831,2306,10342,10435,1917,58,22874,765,3488,588,4841,672,2620,3292
2020-04-27,9,3682,4911,2312,10091,10796,1894,61,22961,1351,6086,1194,8631,535,2637,3172
2020-04-27,10,3837,4953,2324,9709,11000,1795,64,22687,1558,7255,1520,10333,402,2641,3043
2020-04-27,11,3988,4973,2327,9378,11319,1712,67,22595,1607,7777,1677,11061,284,2606,2890
2020-04-27,12,4141,5001,2318,9228,11742,1725,69,22882,1627,7982,1763,11372,206,2596,2802
2020-04-27,13,4307,5064,2325,9201,12223,1758,72,23371,1627,8025,1570,11222,165,2651,2816
2020-04-27,14,4491,5101,2316,9383,12838,1822,74,24235,1618,8015,1567,11200,157,2748,2905
2020-04-27,15,4667,5128,2302,9660,13431,1911,76,25196,1600,7867,1546,11013,207,2885,3092
2020-04-27,16,4810,5172,2279,10175,14053,2090,77,26514,1557,7473,1454,10484,331,3039,3370
2020-04-27,17,4888,5121,2261,10873,14308,2280,78,27659,1474,6758,1492,9724,481,3164,3645
2020-04-27,18,4849,5059,2300,11570,14450,2487,79,28706,1234,5071,1136,7441,613,3236,3849
2020-04-27,19,4774,4998,2306,12187,14205,2718,76,29304,665,2189,528,3382,716,3262,3978
2020-04-27,20,4748,5038,2277,12395,14005,2802,74,29394,129,254,73,456,786,3234,4020
2020-04-27,21,4679,4926,2289,12615,13863,2636,71,29303,0,5,0,5,806,3191,3997
2020-04-27,22,4416,4615,2190,11948,13054,2498,65,27683,0,1,0,1,780,3138,3918
2020-04-27,23,4107,4344,2000,10941,11880,2273,58,25272,0,0,0,0,742,3071,3813
2020-04-27,24,3799,4157,1837,10137,10774,2075,53,23159,0,0,0,0,696,2979,3675
2020-04-28,1,3526,4044,1712,9633,9594,1857,50,21255,0,0,0,0,596,2818,3414
2020-04-28,2,3357,3992,1658,9251,9122,1784,47,20325,0,0,0,0,514,2701,3215
2020-04-28,3,3238,3973,1634,9016,8780,1706,45,19667,0,0,0,0,434,2578,3012
2020-04-28,4,3181,4024,1647,8916,8613,1663,46,19356,0,0,0,0,376,2408,2784
2020-04-28,5,3191,4204,1728,9068,8783,1664,48,19681,0,0,0,0,344,2178,2522
2020-04-28,6,3254,4489,1943,9540,9263,1798,52,20770,0,7,0,7,327,1911,2238
2020-04-28,7,3395,4717,2238,10147,9684,1952,55,21956,162,838,104,1104,301,1569,1870
2020-04-28,8,3558,4812,2387,10536,10030,1975,57,22716,773,3547,591,4911,243,1088,1331
2020-04-28,9,3752,4855,2357,10468,10374,1868,59,22889,1378,6144,1211,8733,161,568,729
2020-04-28,10,3946,4878,2331,10145,10588,1752,61,22666,1587,7268,1554,10409,93,205,298
2020-04-28,11,4169,4888,2312,9876,10911,1676,64,22647,1629,7746,1703,11078,61,78,139
2020-04-28,12,4407,4883,2287,9816,11357,1705,66,23065,1641,7970,1779,11390,49,90,139
2020-04-28,13,4645,4903,2285,9888,11931,1717,69,23726,1642,8013,1787,11442,42,113,155
2020-04-28,14,4875,4918,2275,10217,12616,1761,73,24787,1639,7998,1779,11416,50,115,165
2020-04-28,15,5108,4938,2268,10578,13296,1884,75,25953,1634,7860,1762,11256,88,104,192
2020-04-28,16,5307,4983,2261,11115,13904,2028,77,27245,1603,7492,1676,10771,156,95,251
2020-04-28,17,5398,4999,2277,11746,14204,2165,79,28315,1545,6815,1509,9869,247,121,368
2020-04-28,18,5355,5009,2332,12443,14568,2305,80,29518,1304,5151,1150,7605,355,254,609
2020-04-28,19,5294,4958,2326,12963,14294,2491,79,29948,694,2241,532,3467,452,626,1078
2020-04-28,20,5238,5019,2318,13171,13912,2608,76,29888,134,272,72,478,548,1158,1706
2020-04-28,21,5098,4907,2307,13282,13795,2584,72,29853,0,5,0,5,650,1501,2151
2020-04-28,22,4788,4625,2175,12554,13050,2430,65,28221,0,1,0,1,703,1526,2229
2020-04-28,23,4426,4349,1961,11485,11933,2206,59,25803,0,0,0,0,710,1400,2110
2020-04-28,24,4066,4164,1795,10557,10843,2039,53,23613,0,0,0,0,713,1255,1968
2020-04-29,1,3765,4111,1729,9479,9882,1887,48,21417,0,0,0,0,791,605,1396
2020-04-29,2,3571,4064,1672,9164,9288,1790,46,20407,0,0,0,0,791,482,1273
2020-04-29,3,3428,4051,1633,8976,8925,1745,45,19811,0,0,0,0,810,405,1215
2020-04-29,4,3346,4101,1629,8867,8707,1712,45,19451,0,0,0,0,818,327,1145
2020-04-29,5,3358,4280,1688,9004,8781,1720,48,19673,0,0,0,0,823,238,1061
2020-04-29,6,3427,4556,1869,9334,9221,1794,51,20519,0,4,0,4,844,168,1012
2020-04-29,7,3537,4779,2131,9760,9617,1879,57,21432,140,829,99,1068,837,126,963
2020-04-29,8,3727,4882,2273,9957,9893,1909,58,21935,628,3454,508,4590,813,87,900
2020-04-29,9,3937,4932,2289,9841,10193,1834,60,22049,1102,5896,1010,8008,813,59,872
2020-04-29,10,4161,4965,2299,9591,10412,1690,61,21875,1287,6968,1318,9573,817,50,867
2020-04-29,11,4423,4992,2286,9330,10737,1619,63,21870,1365,7454,1482,10301,810,63,873
2020-04-29,12,4677,5026,2285,9248,11119,1579,66,22133,1430,7636,1574,10640,802,96,898
2020-04-29,13,4921,5114,2306,9267,11637,1612,70,22706,1437,7602,1586,10625,810,156,966
2020-04-29,14,5181,5185,2322,9357,12279,1650,74,23481,1407,7483,1561,10451,852,272,1124
2020-04-29,15,5421,5272,2343,9585,12810,1683,78,24276,1349,7218,1507,10074,915,448,1363
2020-04-29,16,5619,5363,2366,10075,13308,1802,80,25384,1251,6655,1369,9275,972,651,1623
2020-04-29,17,5668,5428,2365,10634,13555,1982,82,26373,1102,5783,1155,8040,1009,849,1858
2020-04-29,18,5617,5432,2356,11486,13946,2255,81,27889,829,4136,821,5786,1029,1073,2102
2020-04-29,19,5527,5341,2321,12116,13841,2443,79,28597,391,1691,371,2453,1030,1339,2369
2020-04-29,20,5437,5323,2286,12420,13367,2547,74,28526,66,195,51,312,1015,1591,2606
2020-04-29,21,5300,5188,2277,12596,13229,2509,69,28522,0,4,0,4,1001,1775,2776
2020-04-29,22,4991,4846,2152,12028,12590,2375,63,27175,0,1,0,1,993,1901,2894
2020-04-29,23,4620,4499,1968,11221,11620,2196,56,25213,0,0,0,0,995,2017,3012
2020-04-29,24,4260,4251,1802,10461,10624,2005,51,23261,0,0,0,0,989,2126,3115
2020-04-30,1,3958,4211,1696,9872,10182,1889,50,22118,0,0,0,0,950,2554,3504
2020-04-30,2,3750,4142,1634,9440,9624,1804,48,21040,0,0,0,0,937,2652,3589
2020-04-30,3,3605,4110,1594,9134,9302,1743,47,20350,0,0,0,0,925,2715,3640
2020-04-30,4,3519,4151,1590,9026,9106,1710,47,20013,0,0,0,0,911,2747,3658
2020-04-30,5,3530,4311,1648,9148,9139,1729,50,20189,0,0,0,0,908,2716,3624
2020-04-30,6,3585,4562,1831,9585,9449,1801,53,21012,0,1,0,1,911,2652,3563
2020-04-30,7,3680,4763,2097,10175,9767,1891,56,22012,179,542,107,828,891,2606,3497
2020-04-30,8,3836,4923,2239,10407,10157,1941,58,22684,810,2419,592,3821,844,2556,3400
2020-04-30,9,4028,5033,2267,10172,10300,1938,61,22592,1394,4487,1203,7084,789,2509,3298
2020-04-30,10,4216,5105,2288,9711,10455,1887,62,22238,1588,5705,1547,8840,719,2510,3229
2020-04-30,11,4431,5173,2281,9481,10707,1815,64,22186,1635,6306,1696,9637,636,2574,3210
2020-04-30,12,4654,5229,2264,9356,11102,1766,66,22410,1651,6584,1775,10010,571,2667,3238
2020-04-30,13,4864,5312,2258,9334,11507,1770,69,22799,1653,6630,1788,10071,545,2757,3302
2020-04-30,14,5063,5397,2238,9504,12178,1753,72,23625,1650,6569,1777,9996,573,2837,3410
2020-04-30,15,5227,5462,2212,9659,12616,1768,74,24237,1639,6445,1756,9840,641,2920,3561
2020-04-30,16,5350,5515,2173,10180,13142,1846,76,25366,1598,6141,1670,9409,720,3009,3729
2020-04-30,17,5368,5544,2163,10799,13533,1990,77,26521,1534,5624,1514,8672,785,3102,3887
2020-04-30,18,5281,5412,2183,11426,13573,2239,75,27436,1316,4354,1174,6844,829,3158,3987
2020-04-30,19,5178,5292,2184,12077,13409,2427,72,28109,725,1967,560,3252,863,3158,4021
2020-04-30,20,5119,5295,2171,12339,13130,2532,69,28195,147,269,82,498,894,3124,4018
2020-04-30,21,5016,5205,2208,12595,13113,2494,65,28392,0,0,0,0,913,3109,4022
2020-04-30,22,4762,4892,2137,12015,12500,2358,60,27056,0,0,0,0,906,3102,4008
2020-04-30,23,4463,4546,1980,11081,11552,2182,54,24994,0,0,0,0,874,3093,3967
2020-04-30,24,4143,4305,1835,10264,10552,2006,49,22996,0,0,0,0,821,3073,3894
2020-05-01,1,3799,4125,1750,9917,9893,1865,50,21852,0,0,0,0,1050,3027,4077
2020-05-01,2,3637,4060,1699,9521,9373,1779,48,20848,0,0,0,0,1054,2965,4019
2020-05-01,3,3522,4032,1678,9243,8999,1722,47,20138,0,0,0,0,1053,2901,3954
2020-05-01,4,3452,4063,1692,9130,8809,1692,46,19801,0,0,0,0,1036,2836,3872
2020-05-01,5,3466,4204,1770,9199,8932,1708,47,20007,0,0,0,0,1000,2778,3778
2020-05-01,6,3536,4420,1965,9578,9184,1764,49,20706,0,2,0,2,934,2726,3660
2020-05-01,7,3599,4626,2228,9921,9355,1809,51,21266,183,881,119,1183,774,2685,3459
2020-05-01,8,3771,4772,2387,10312,9744,1854,53,22085,802,3520,607,4929,524,2660,3184
2020-05-01,9,3917,4862,2383,10085,9797,1805,56,21862,1361,5902,1191,8454,373,2674,3047
2020-05-01,10,4075,4902,2346,9643,9769,1680,60,21270,1557,6972,1524,10053,273,2706,2979
2020-05-01,11,4215,4914,2298,9290,9906,1651,63,21028,1617,7491,1687,10795,188,2744,2932
2020-05-01,12,4363,4900,2267,9107,10179,1611,64,21080,1639,7711,1773,11123,134,2823,2957
2020-05-01,13,4527,4902,2240,9005,10374,1618,67,21184,1642,8018,1788,11448,119,2966,3085
2020-05-01,14,4683,4908,2214,9123,10800,1657,70,21770,1636,7998,1783,11417,140,3120,3260
2020-05-01,15,4796,4922,2197,9290,11247,1681,71,22411,1625,7864,1764,11253,218,3252,3470
2020-05-01,16,4872,4951,2185,9750,11771,1768,73,23486,1590,7489,1678,10757,410,3335,3745
2020-05-01,17,4929,4985,2203,10373,12303,1954,75,24829,1531,6827,1519,9877,664,3368,4032
2020-05-01,18,4853,4859,2212,10874,12687,2247,73,26004,1317,5220,1179,7716,879,3377,4256
2020-05-01,19,4723,4766,2191,11491,12824,2391,71,26902,732,2319,567,3618,992,3371,4363
2020-05-01,20,4637,4807,2140,11729,12672,2422,68,27015,151,309,84,544,1047,3348,4395
2020-05-01,21,4607,4791,2137,12021,12632,2398,66,27241,0,4,0,4,1075,3325,4400
2020-05-01,22,4388,4574,2108,11595,11994,2325,61,26099,0,0,0,0,1072,3305,4377
2020-05-01,23,4148,4346,1954,10749,11182,2198,56,24309,0,0,0,0,1063,3286,4349
2020-05-01,24,3872,4156,1811,10063,10232,2033,51,22503,0,0,0,0,1045,3264,4309
2020-05-02,1,3664,4054,1736,9656,9226,1862,46,20907,0,0,0,0,1021,3169,4190
2020-05-02,2,3494,3990,1678,9298,8771,1768,44,19998,0,0,0,0,977,3145,4122
2020-05-02,3,3378,3970,1647,9055,8518,1706,43,19440,0,0,0,0,950,3111,4061
2020-05-02,4,3305,3979,1642,8896,8340,1662,43,19059,0,0,0,0,912,3074,3986
2020-05-02,5,3277,4033,1665,8874,8351,1653,44,19039,0,0,0,0,854,3039,3893
2020-05-02,6,3282,4083,1726,8991,8534,1681,46,19368,0,4,0,4,791,2995,3786
2020-05-02,7,3236,4160,1779,8963,8606,1697,47,19430,180,913,125,1218,729,2912,3641
2020-05-02,8,3340,4305,1897,9087,8610,1668,49,19532,792,3595,636,5023,694,2792,3486
2020-05-02,9,3514,4409,2004,9028,8372,1545,51,19114,1356,5984,1236,8576,696,2659,3355
2020-05-02,10,3689,4453,2069,8867,8381,1439,53,18858,1550,7066,1558,10174,700,2544,3244
2020-05-02,11,3850,4480,2085,8611,8306,1380,55,18472,1598,7593,1703,10894,689,2499,3188
2020-05-02,12,3995,4488,2081,8432,8323,1334,59,18267,1616,7829,1780,11225,667,2534,3201
2020-05-02,13,4131,4489,2056,8334,8408,1337,63,18261,1619,7872,1792,11283,653,2648,3301
2020-05-02,14,4277,4518,2019,8406,8616,1328,66,18536,1607,7850,1785,11242,658,2827,3485
2020-05-02,15,4423,4585,2004,8544,8877,1372,69,18982,1578,7707,1760,11045,692,3050,3742
2020-05-02,16,4539,4684,1996,8930,9238,1522,71,19881,1534,7332,1669,10535,760,3244,4004
2020-05-02,17,4633,4785,2012,9426,9600,1718,75,20940,1471,6659,1495,9625,831,3346,4177
2020-05-02,18,4598,4832,2031,10023,10033,2017,74,22267,1251,5061,1142,7454,858,3371,4229
2020-05-02,19,4483,4736,2035,10724,10339,2186,72,23439,690,2261,551,3502,803,3345,4148
2020-05-02,20,4423,4774,2006,11080,10567,2324,69,24157,142,313,84,539,720,3310,4030
2020-05-02,21,4442,4749,2049,11450,10734,2311,66,24679,0,0,0,0,661,3289,3950
2020-05-02,22,4262,4542,2059,11080,10336,2231,61,23825,0,0,0,0,594,3276,3870
2020-05-02,23,4048,4297,1932,10391,9841,2121,56,22527,0,0,0,0,517,3257,3774
2020-05-02,24,3821,4096,1807,9810,9242,1965,50,21184,0,0,0,0,467,3212,3679
2020-05-03,1,3593,3953,1697,9630,9004,1812,45,20608,0,0,0,0,405,3135,3540
2020-05-03,2,3431,3886,1650,9272,8561,1718,43,19711,0,0,0,0,403,3102,3505
2020-05-03,3,3327,3857,1638,9012,8273,1658,42,19102,0,0,0,0,398,3062,3460
2020-05-03,4,3229,3859,1650,8907,8069,1620,42,18756,0,0,0,0,388,3004,3392
2020-05-03,5,3206,3876,1688,8857,7998,1599,43,18614,0,0,0,0,384,2940,3324
2020-05-03,6,3209,3866,1745,8899,8058,1600,45,18719,0,7,0,7,373,2872,3245
2020-05-03,7,3122,3901,1812,8816,7870,1542,46,18391,185,882,110,1177,349,2775,3124
2020-05-03,8,3224,4042,1932,8692,7818,1505,49,18182,807,3444,574,4825,311,2642,2953
2020-05-03,9,3393,4123,2061,8378,7780,1446,50,17773,1378,5751,1153,8282,262,2530,2792
2020-05-03,10,3575,4175,2098,8078,7760,1351,53,17360,1577,6821,1503,9901,216,2501,2717
2020-05-03,11,3722,4198,2060,7771,7799,1271,55,17015,1625,7341,1670,10636,174,2539,2713
2020-05-03,12,3855,4253,2016,7600,7938,1192,58,16905,1644,7569,1762,10975,146,2627,2773
2020-05-03,13,3974,4256,1987,7565,8131,1204,61,17077,1652,7611,1786,11049,149,2763,2912
2020-05-03,14,4085,4293,1945,7594,8455,1222,64,17453,1650,7603,1784,11037,186,2918,3104
2020-05-03,15,4187,4342,1924,7840,8893,1284,66,18201,1642,7463,1765,10870,255,3079,3334
2020-05-03,16,4308,4457,1921,8219,9389,1411,69,19205,1614,7101,1677,10392,356,3211,3567
2020-05-03,17,4400,4538,1958,8808,9859,1620,71,20478,1562,6459,1518,9539,488,3282,3770
2020-05-03,18,4382,4525,2027,9743,10400,1959,71,22290,1357,4952,1179,7488,627,3298,3925
2020-05-03,19,4311,4511,2062,10589,10614,2165,69,23554,768,2255,573,3596,737,3281,4018
2020-05-03,20,4296,4576,2059,11011,10740,2314,66,24247,163,325,89,577,800,3255,4055
2020-05-03,21,4358,4590,2096,11338,11000,2306,64,24824,0,4,0,4,818,3230,4048
2020-05-03,22,4186,4388,2089,10937,10611,2200,59,23924,0,0,0,0,802,3195,3997
2020-05-03,23,3930,4152,1930,10214,9955,2053,53,22391,0,0,0,0,771,3148,3919
2020-05-03,24,3660,3994,1793,9515,9289,1888,48,20857,0,0,0,0,728,3085,3813
2020-05-04,1,3503,3937,1714,9447,9116,1779,45,20505,0,0,0,0,667,3065,3732
2020-05-04,2,3361,3913,1686,9109,8624,1695,43,19589,0,0,0,0,636,3003,3639
2020-05-04,3,3262,3922,1689,8897,8355,1648,42,19060,0,0,0,0,586,2938,3524
2020-05-04,4,3220,4001,1728,8906,8210,1626,42,18902,0,0,0,0,533,2864,3397
2020-05-04,5,3241,4189,1833,9242,8283,1651,45,19339,0,0,0,0,502,2690,3192
2020-05-04,6,3342,4465,2051,9642,8655,1738,49,20201,0,3,0,3,487,2456,2943
2020-05-04,7,3453,4703,2343,10113,8997,1809,52,21089,216,983,139,1338,431,2223,2654
2020-05-04,8,3604,4804,2498,10189,9204,1821,55,21388,888,3778,670,5336,332,1862,2194
2020-05-04,9,3744,4842,2466,10056,9362,1743,56,21336,1440,6215,1265,8920,226,1297,1523
2020-05-04,10,3876,4855,2407,9564,9426,1630,57,20796,1602,7271,1583,10456,134,733,867
2020-05-04,11,3999,4848,2350,9213,9637,1546,59,20575,1643,7759,1728,11130,83,383,466
2020-05-04,12,4097,4836,2316,8994,9958,1519,61,20652,1659,7972,1797,11428,66,245,311
2020-05-04,13,4215,4835,2301,8883,10385,1540,64,20992,1664,8009,1804,11477,69,253,322
2020-05-04,14,4350,4807,2276,9030,10863,1564,67,21643,1661,7983,1797,11441,89,389,478
2020-05-04,15,4486,4770,2257,9224,11390,1627,69,22429,1646,7832,1777,11255,131,682,813
2020-05-04,16,4594,4789,2248,9613,11880,1739,71,23423,1599,7479,1692,10770,197,1115,1312
2020-05-04,17,4706,4879,2267,10290,12422,1924,72,24827,1524,6863,1530,9917,283,1614,1897
2020-05-04,18,4700,4825,2320,11017,12840,2236,73,26284,1323,5326,1206,7855,378,2051,2429
2020-05-04,19,4631,4807,2327,11734,12961,2364,71,27246,767,2459,606,3832,495,2317,2812
2020-05-04,20,4597,4875,2288,12153,12774,2462,68,27574,169,376,97,642,636,2427,3063
2020-05-04,21,4586,4849,2277,12348,12704,2458,66,27693,0,4,0,4,734,2448,3182
2020-05-04,22,4352,4582,2214,11889,12070,2328,60,26464,0,1,0,1,757,2399,3156
2020-05-04,23,4039,4308,2025,11137,11220,2138,54,24666,0,0,0,0,746,2271,3017
2020-05-04,24,3737,4140,1874,10365,10272,1956,49,22759,0,0,0,0,730,2098,2828
2020-05-05,1,3490,4123,1802,9717,9294,1856,45,21030,0,0,0,0,763,1476,2239
2020-05-05,2,3359,4080,1755,9387,8834,1765,43,20147,0,0,0,0,744,1443,2187
2020-05-05,3,3260,4078,1735,9114,8585,1694,43,19554,0,0,0,0,736,1487,2223
2020-05-05,4,3206,4145,1748,9011,8455,1661,43,19288,0,0,0,0,727,1471,2198
2020-05-05,5,3232,4327,1823,9080,8609,1672,45,19524,0,0,0,0,704,1343,2047
2020-05-05,6,3322,4599,2013,9432,9130,1747,49,20475,0,2,0,2,675,1131,1806
2020-05-05,7,3445,4828,2278,9875,9633,1783,53,21462,221,1025,147,1393,633,882,1515
2020-05-05,8,3600,4902,2415,10307,10081,1809,55,22371,898,3892,687,5477,550,621,1171
2020-05-05,9,3737,4910,2389,10043,10301,1738,55,22257,1443,6325,1276,9044,451,362,813
2020-05-05,10,3878,4913,2364,9552,10584,1702,56,22014,1600,7352,1583,10535,364,169,533
2020-05-05,11,4010,4925,2358,9193,10918,1670,59,21960,1640,7817,1724,11181,303,90,393
2020-05-05,12,4157,4934,2351,8980,11361,1683,62,22205,1658,8021,1793,11472,271,84,355
2020-05-05,13,4308,4987,2356,8832,11928,1758,65,22704,1664,8058,1803,11525,287,117,404
2020-05-05,14,4470,5022,2351,8984,12635,1848,69,23657,1659,8045,1793,11497,353,223,576
2020-05-05,15,4618,5078,2348,9173,13253,1940,72,24558,1643,7907,1772,11322,457,496,953
2020-05-05,16,4766,5139,2352,9603,13846,2127,74,25771,1600,7564,1670,10834,628,981,1609
2020-05-05,17,4860,5201,2368,10271,14172,2222,77,26861,1517,6949,1472,9938,841,1553,2394
2020-05-05,18,4884,5216,2394,11103,14192,2401,78,27892,1273,5389,1127,7789,977,2065,3042
2020-05-05,19,4804,5119,2392,11813,13892,2527,76,28425,704,2521,561,3786,1012,2438,3450
2020-05-05,20,4754,5126,2353,12147,13700,2558,72,28593,149,400,92,641,1041,2658,3699
2020-05-05,21,4735,5040,2324,12361,13712,2545,68,28804,0,3,0,3,1086,2780,3866
2020-05-05,22,4475,4703,2241,11838,12960,2372,62,27349,0,2,0,2,1111,2835,3946
2020-05-05,23,4138,4410,2050,10997,11862,2185,55,25217,0,0,0,0,1121,2835,3956
2020-05-05,24,3834,4213,1873,10214,10813,2004,50,23198,0,0,0,0,1099,2800,3899
2020-05-06,1,3603,4065,1774,9857,9962,1974,45,21956,0,0,0,0,1065,2799,3864
2020-05-06,2,3453,4009,1715,9465,9369,1859,43,20853,0,0,0,0,1009,2742,3751
2020-05-06,3,3345,3991,1680,9227,8965,1794,42,20146,0,0,0,0,974,2682,3656
2020-05-06,4,3287,4046,1683,9120,8716,1747,43,19745,0,0,0,0,913,2622,3535
2020-05-06,5,3305,4212,1747,9223,8805,1753,45,19945,0,0,0,0,782,2564,3346
2020-05-06,6,3393,4464,1928,9620,9101,1824,49,20711,0,2,0,2,582,2509,3091
2020-05-06,7,3531,4691,2179,10327,9389,1883,52,21770,132,888,101,1121,360,2468,2828
2020-05-06,8,3694,4774,2335,10772,9743,1895,55,22582,883,3815,656,5354,206,2412,2618
2020-05-06,9,3836,4820,2354,10422,9990,1846,56,22433,1363,5891,1238,8492,188,2319,2507
2020-05-06,10,3987,4848,2353,9974,10404,1813,58,22368,1491,6688,1528,9707,323,2228,2551
2020-05-06,11,4155,4875,2354,9644,10940,1839,61,22603,1549,7010,1690,10249,515,2161,2676
2020-05-06,12,4327,4904,2361,9475,11481,1884,65,23023,1572,7115,1751,10438,629,2129,2758
2020-05-06,13,4524,4964,2366,9485,12211,1980,69,23863,1562,7034,1675,10271,652,2165,2817
2020-05-06,14,4704,5002,2346,9636,13022,2081,72,24929,1569,7044,1660,10273,643,2263,2906
2020-05-06,15,4861,5049,2325,9911,13787,2217,75,26109,1567,6969,1662,10198,624,2404,3028
2020-05-06,16,5009,5099,2300,10286,14527,2429,78,27438,1553,6743,1618,9914,596,2567,3163
2020-05-06,17,5135,5168,2301,10903,14886,2543,80,28530,1500,6127,1447,9074,563,2739,3302
2020-05-06,18,5094,5060,2333,11569,14995,2730,81,29493,1369,4964,1171,7504,511,2880,3391
2020-05-06,19,4992,4981,2346,12281,14811,2775,78,30062,757,2250,555,3562,462,2964,3426
2020-05-06,20,4914,4984,2321,12604,14308,2788,73,29890,86,302,69,457,444,2973,3417
2020-05-06,21,4886,4890,2334,12763,14118,2753,69,29820,0,20,7,27,411,2924,3335
2020-05-06,22,4627,4620,2297,12296,13337,2584,63,28396,0,0,0,0,370,2834,3204
2020-05-06,23,4309,4341,2126,11459,12253,2372,56,26257,0,0,0,0,360,2715,3075
2020-05-06,24,3985,4147,1960,10445,11165,2161,50,23938,0,0,0,0,380,2565,2945
2020-05-07,1,3740,4032,1807,10163,10522,2032,47,22882,0,0,0,0,272,2515,2787
2020-05-07,2,3577,3978,1756,9816,9815,1921,45,21715,0,0,0,0,284,2300,2584
2020-05-07,3,3461,3975,1740,9580,9270,1849,44,20860,0,0,0,0,281,2022,2303
2020-05-07,4,3395,4036,1763,9435,8987,1807,43,20390,0,0,0,0,263,1630,1893
2020-05-07,5,3415,4215,1854,9514,9021,1820,45,20517,0,0,0,0,249,1195,1444
2020-05-07,6,3504,4471,2075,9972,9254,1894,48,21286,0,2,0,2,235,825,1060
2020-05-07,7,3582,4699,2339,10548,9470,1948,52,22136,166,922,115,1203,215,515,730
2020-05-07,8,3761,4785,2490,10921,9803,1970,54,22866,1037,3813,733,5583,189,282,471
2020-05-07,9,3911,4803,2457,10879,10157,1942,57,23152,1533,5853,1344,8730,172,160,332
2020-05-07,10,4068,4812,2411,10581,10619,1880,60,23257,1623,6637,1611,9871,184,124,308
2020-05-07,11,4216,4798,2362,10327,11160,1876,64,23544,1655,7043,1761,10459,202,144,346
2020-05-07,12,4369,4767,2330,10411,11824,1904,67,24323,1664,7200,1809,10673,181,172,353
2020-05-07,13,4517,4756,2317,10670,12728,1981,71,25567,1658,7214,1815,10687,136,176,312
2020-05-07,14,4679,4721,2298,11058,13694,2069,75,27013,1655,7294,1808,10757,96,185,281
2020-05-07,15,4809,4685,2289,11551,14726,2171,77,28642,1646,7187,1790,10623,66,259,325
2020-05-07,16,4921,4692,2283,12283,15599,2306,80,30386,1630,6862,1757,10249,60,433,493
2020-05-07,17,5006,4724,2304,13180,16307,2472,82,32158,1590,6280,1611,9481,100,688,788
2020-05-07,18,5010,4732,2336,13903,16668,2739,83,33511,1441,5096,1342,7879,190,1011,1201
2020-05-07,19,4897,4737,2342,14354,16321,2790,79,33662,802,2430,653,3885,304,1357,1661
2020-05-07,20,4834,4821,2311,14293,15242,2787,75,32514,97,314,92,503,418,1658,2076
2020-05-07,21,4801,4826,2293,14222,14502,2715,71,31628,0,18,10,28,482,1898,2380
2020-05-07,22,4539,4601,2214,13521,13732,2565,64,30001,0,0,0,0,485,2006,2491
2020-05-07,23,4208,4348,2037,12402,12723,2361,57,27661,0,0,0,0,482,1974,2456
2020-05-07,24,3889,4167,1876,11358,11503,2156,52,25186,0,0,0,0,490,1844,2334
2020-05-08,1,3655,4086,1807,10729,10417,1996,47,23307,0,0,0,0,462,1230,1692
2020-05-08,2,3468,4041,1761,10270,9737,1888,45,22057,0,0,0,0,441,1025,1466
2020-05-08,3,3345,4043,1738,9961,9279,1801,44,21203,0,0,0,0,385,884,1269
2020-05-08,4,3274,4105,1745,9798,9046,1766,43,20772,0,0,0,0,332,744,1076
2020-05-08,5,3280,4266,1815,9838,9032,1769,45,20802,0,0,0,0,281,615,896
2020-05-08,6,3323,4489,1984,10151,9280,1822,48,21418,0,11,0,11,218,520,738
2020-05-08,7,3438,4696,2214,10565,9465,1871,51,22069,233,1009,152,1394,155,422,577
2020-05-08,8,3609,4787,2345,10874,9869,1884,53,22799,910,3722,689,5321,96,295,391
2020-05-08,9,3769,4790,2341,10851,10232,1857,55,23113,1431,6046,1265,8742,52,174,226
2020-05-08,10,3931,4773,2343,10565,10650,1815,57,23207,1578,7127,1568,10273,26,100,126
2020-05-08,11,4086,4747,2340,10558,11207,1802,61,23747,1619,7658,1707,10984,14,76,90
2020-05-08,12,4265,4719,2326,10476,11820,1818,64,24297,1639,7909,1777,11325,10,81,91
2020-05-08,13,4474,4708,2323,10791,12673,1853,69,25505,1644,7965,1789,11398,9,108,117
2020-05-08,14,4694,4691,2321,11325,13529,1928,74,26974,1638,7942,1780,11360,9,187,196
2020-05-08,15,4885,4697,2321,11921,14530,1999,78,28646,1615,7775,1746,11136,14,384,398
2020-05-08,16,5067,4725,2331,12634,15234,2154,82,30221,1572,7388,1641,10601,30,711,741
2020-05-08,17,5176,4764,2362,13487,15650,2352,85,31692,1491,6756,1452,9699,65,1056,1121
2020-05-08,18,5209,4766,2404,14173,16017,2631,84,33023,1245,5237,1103,7585,137,1298,1435
2020-05-08,19,5084,4685,2357,14533,15826,2744,82,33302,689,2474,545,3708,231,1428,1659
2020-05-08,20,4958,4703,2288,14525,14932,2716,76,32367,146,401,103,650,329,1455,1784
2020-05-08,21,4884,4688,2260,14408,14281,2624,71,31502,0,6,0,6,427,1511,1938
2020-05-08,22,4615,4523,2186,13747,13357,2508,63,29794,0,2,0,2,497,1599,2096
2020-05-08,23,4290,4289,2012,12732,12264,2346,57,27516,0,0,0,0,539,1655,2194
2020-05-08,24,4000,4092,1853,11693,11155,2137,51,25154,0,0,0,0,559,1654,2213
2020-05-09,1,3666,4029,1789,10734,10342,1938,48,23181,0,0,0,0,679,1323,2002
2020-05-09,2,3466,3977,1720,10204,9793,1830,45,21991,0,0,0,0,703,1208,1911
2020-05-09,3,3322,3957,1676,9800,9332,1761,45,21056,0,0,0,0,717,1076,1793
2020-05-09,4,3252,3972,1659,9549,9044,1722,44,20476,0,0,0,0,716,935,1651
2020-05-09,5,3219,4026,1677,9482,8959,1715,44,20321,0,0,0,0,710,786,1496
2020-05-09,6,3180,4051,1719,9531,9079,1732,46,20514,0,13,0,13,705,655,1360
2020-05-09,7,3185,4119,1782,9417,8954,1755,47,20307,211,903,133,1247,686,531,1217
2020-05-09,8,3330,4260,1883,9545,9039,1739,50,20497,847,3334,634,4815,639,370,1009
2020-05-09,9,3546,4341,2020,9472,9347,1650,53,20640,1368,5488,1209,8065,574,201,775
2020-05-09,10,3780,4360,2124,9412,9622,1572,56,20780,1530,6579,1533,9642,503,109,612
2020-05-09,11,4038,4379,2139,9388,10006,1470,60,21042,1574,7170,1679,10423,436,103,539
2020-05-09,12,4320,4371,2141,9483,10608,1418,65,21692,1599,7450,1752,10801,396,168,564
2020-05-09,13,4587,4348,2147,9635,11323,1433,70,22579,1604,7436,1764,10804,402,303,705
2020-05-09,14,4853,4353,2168,9990,12076,1469,75,23729,1597,7312,1755,10664,444,498,942
2020-05-09,15,5096,4398,2206,10512,12687,1611,79,25008,1579,7100,1730,10409,522,721,1243
2020-05-09,16,5315,4492,2251,11138,13163,1682,83,26186,1542,6664,1641,9847,601,925,1526
2020-05-09,17,5470,4648,2323,11903,13523,1968,87,27600,1482,5945,1484,8911,665,1087,1752
2020-05-09,18,5451,4638,2378,12656,13825,2245,85,28936,1294,4544,1172,7010,736,1179,1915
2020-05-09,19,5341,4605,2344,13251,13780,2430,82,29669,763,2166,605,3534,797,1212,2009
2020-05-09,20,5168,4644,2281,13304,13230,2499,76,29236,174,364,117,655,863,1235,2098
2020-05-09,21,5066,4652,2215,13228,12933,2504,71,28866,0,2,0,2,938,1285,2223
2020-05-09,22,4799,4462,2149,12742,12303,2405,64,27645,0,0,0,0,980,1313,2293
2020-05-09,23,4473,4244,1982,11824,11483,2256,57,25745,0,0,0,0,993,1245,2238
2020-05-09,24,4188,4054,1816,10924,10577,2069,52,23743,0,0,0,0,986,1109,2095
2020-05-10,1,3936,4041,1701,10538,9764,1896,49,22376,0,0,0,0,1022,897,1919
2020-05-10,2,3736,3982,1631,10044,9186,1798,46,21202,0,0,0,0,1015,805,1820
2020-05-10,3,3576,3952,1581,9627,8765,1733,45,20295,0,0,0,0,1021,713,1734
2020-05-10,4,3495,3953,1560,9380,8483,1685,45,19713,0,0,0,0,1024,623,1647
2020-05-10,5,3456,3971,1563,9239,8287,1674,45,19364,0,0,0,0,1015,561,1576
2020-05-10,6,3408,3940,1576,9248,8206,1692,45,19308,0,8,1,9,992,545,1537
2020-05-10,7,3325,3980,1605,9130,7982,1680,47,18957,220,1010,157,1387,950,531,1481
2020-05-10,8,3473,4127,1708,9083,7860,1671,50,18790,864,3732,705,5301,893,451,1344
2020-05-10,9,3675,4215,1882,9070,8003,1635,54,18881,1377,6009,1280,8666,847,328,1175
2020-05-10,10,3916,4283,1971,8949,8152,1549,57,18826,1540,6982,1586,10108,798,296,1094
2020-05-10,11,4182,4319,1993,8759,8387,1387,60,18713,1587,7412,1726,10725,745,424,1169
2020-05-10,12,4444,4383,2018,8714,8767,1302,64,18970,1626,7548,1786,10960,735,673,1408
2020-05-10,13,4665,4404,2060,8881,9422,1277,68,19768,1627,7484,1792,10903,775,974,1749
2020-05-10,14,4858,4476,2087,9115,10099,1292,72,20699,1613,7373,1781,10767,803,1248,2051
2020-05-10,15,5024,4575,2124,9447,10829,1385,76,21857,1596,7205,1748,10549,790,1450,2240
2020-05-10,16,5164,4713,2174,10036,11479,1547,79,23268,1558,6833,1641,10032,793,1561,2354
2020-05-10,17,5282,4859,2223,10630,12110,1704,80,24657,1502,6206,1467,9175,859,1621,2480
2020-05-10,18,5240,4954,2315,11555,12461,1986,80,26211,1310,4782,1149,7241,944,1695,2639
2020-05-10,19,5112,4862,2297,12248,12461,2173,77,27087,771,2259,593,3623,983,1795,2778
2020-05-10,20,4990,4860,2264,12484,12246,2289,72,27224,180,374,117,671,976,1907,2883
2020-05-10,21,4956,4846,2224,12633,12241,2297,68,27368,0,0,0,0,955,2016,2971
2020-05-10,22,4721,4577,2157,12134,11489,2194,62,26010,0,0,0,0,913,2087,3000
2020-05-10,23,4390,4289,1965,11285,10659,2045,55,24174,0,0,0,0,847,2110,2957
2020-05-10,24,4076,4109,1777,10417,9851,1891,50,22340,0,0,0,0,797,2124,2921
2020-05-11,1,3828,4104,1638,9683,9108,1784,48,20741,0,0,0,0,810,1913,2723
2020-05-11,2,3641,4058,1574,9315,8656,1705,45,19839,0,0,0,0,744,2015,2759
2020-05-11,3,3514,4037,1541,9090,8391,1659,43,19301,0,0,0,0,759,2072,2831
2020-05-11,4,3450,4084,1540,9034,8260,1630,43,19085,0,0,0,0,756,2048,2804
2020-05-11,5,3446,4241,1597,9224,8349,1644,44,19379,0,0,0,0,643,1945,2588
2020-05-11,6,3508,4462,1744,9725,8801,1710,47,20405,0,15,1,16,449,1787,2236
2020-05-11,7,3599,4698,1973,10332,9135,1783,50,21423,195,1087,127,1409,268,1607,1875
2020-05-11,8,3776,4868,2150,10757,9349,1807,53,22083,798,3876,605,5279,145,1442,1587
2020-05-11,9,3924,4990,2250,10610,9437,1771,57,21993,1342,6216,1174,8732,95,1389,1484
2020-05-11,10,4063,5077,2296,10176,9409,1684,60,21448,1554,7290,1528,10372,111,1483,1594
2020-05-11,11,4204,5141,2321,9890,9414,1565,62,21049,1614,7796,1710,11120,185,1700,1885
2020-05-11,12,4339,5203,2340,9781,9458,1509,64,20932,1639,8024,1796,11459,311,1999,2310
2020-05-11,13,4473,5288,2364,9745,9588,1456,67,20979,1644,8038,1806,11488,491,2283,2774
2020-05-11,14,4580,5359,2361,9979,9918,1430,69,21519,1639,7982,1797,11418,667,2474,3141
2020-05-11,15,4660,5433,2352,10351,10243,1469,71,22257,1624,7820,1774,11218,758,2616,3374
2020-05-11,16,4704,5533,2331,10797,10539,1581,73,23110,1584,7459,1690,10733,792,2784,3576
2020-05-11,17,4729,5524,2313,11210,10862,1810,72,24073,1514,6871,1535,9920,829,2909,3738
2020-05-11,18,4657,5449,2339,11687,11182,2059,71,25118,1305,5397,1218,7920,850,2941,3791
2020-05-11,19,4567,5317,2335,12323,11505,2234,68,26248,766,2609,637,4012,835,2891,3726
2020-05-11,20,4511,5286,2292,12534,11849,2322,66,26889,179,440,129,748,802,2823,3625
2020-05-11,21,4556,5245,2262,12702,11996,2353,64,27234,0,4,0,4,751,2844,3595
2020-05-11,22,4357,4912,2223,12231,11540,2234,60,26183,0,0,0,0,667,2874,3541
2020-05-11,23,4070,4571,2050,11278,10796,2052,54,24298,0,0,0,0,566,2839,3405
2020-05-11,24,3779,4317,1868,10516,9989,1891,49,22563,0,0,0,0,457,2796,3253
2020-05-12,1,3570,4144,1736,9644,8540,1801,45,20149,0,0,0,0,296,2754,3050
2020-05-12,2,3409,4075,1668,9257,8197,1702,43,19316,0,0,0,0,233,2729,2962
2020-05-12,3,3308,4040,1633,8991,7930,1640,42,18720,0,0,0,0,206,2680,2886
2020-05-12,4,3259,4072,1631,8899,7837,1603,42,18497,0,0,0,0,199,2589,2788
2020-05-12,5,3275,4224,1690,9030,7984,1607,44,18782,0,0,0,0,215,2465,2680
2020-05-12,6,3355,4437,1852,9484,8471,1682,47,19801,0,13,0,13,234,2333,2567
2020-05-12,7,3437,4657,2102,10005,8943,1788,50,20904,134,1100,69,1303,232,2187,2419
2020-05-12,8,3609,4806,2243,10355,9147,1790,53,21463,564,3950,378,4892,256,2027,2283
2020-05-12,9,3710,4904,2279,10289,9232,1694,55,21389,978,6301,822,8101,348,1926,2274
2020-05-12,10,3816,4973,2314,10027,9122,1558,57,20882,1133,7316,1156,9605,489,1937,2426
2020-05-12,11,3919,5018,2328,9685,9031,1404,58,20298,1163,7795,1354,10312,611,2079,2690
2020-05-12,12,4009,5048,2334,9489,8976,1313,59,19956,1194,7997,1450,10641,695,2298,2993
2020-05-12,13,4085,5086,2343,9287,8967,1296,60,19730,1197,7972,1466,10635,765,2491,3256
2020-05-12,14,4163,5109,2325,9132,9023,1304,61,19639,1182,7864,1484,10530,816,2661,3477
2020-05-12,15,4238,5145,2292,9029,8964,1358,62,19532,1173,7670,1497,10340,844,2841,3685
2020-05-12,16,4306,5230,2266,9231,9107,1462,64,19982,1139,7316,1450,9905,858,2980,3838
2020-05-12,17,4382,5219,2270,9759,9254,1634,62,20827,1082,6705,1348,9135,846,3036,3882
2020-05-12,18,4334,5185,2307,10406,9621,1887,62,22095,926,5186,1085,7197,803,3030,3833
2020-05-12,19,4259,5122,2326,11116,10047,2103,59,23444,533,2458,559,3550,741,2937,3678
2020-05-12,20,4246,5116,2300,11563,10481,2265,59,24487,122,405,109,636,682,2758,3440
2020-05-12,21,4303,5079,2294,11820,10805,2275,60,25079,0,3,0,3,643,2628,3271
2020-05-12,22,4131,4774,2256,11386,10445,2157,56,24162,0,0,0,0,621,2610,3231
2020-05-12,23,3829,4483,2083,10564,9833,2013,51,22582,0,0,0,0,598,2690,3288
2020-05-12,24,3553,4269,1911,9836,9306,1851,47,21160,0,0,0,0,562,2807,3369
2020-05-13,1,3429,4082,1757,9851,8837,1801,44,20650,0,0,0,0,491,2864,3355
2020-05-13,2,3273,4006,1696,9524,8505,1711,43,19901,0,0,0,0,424,2936,3360
2020-05-13,3,3176,3976,1669,9275,8302,1645,42,19382,0,0,0,0,389,2999,3388
2020-05-13,4,3137,4014,1677,9222,8243,1617,43,19242,0,0,0,0,356,3020,3376
2020-05-13,5,3159,4169,1747,9408,8389,1631,45,19591,0,0,0,0,310,2991,3301
2020-05-13,6,3246,4398,1926,9779,8776,1703,48,20425,0,17,0,17,272,2920,3192
2020-05-13,7,3336,4632,2178,10113,9154,1783,51,21220,232,1067,127,1426,256,2840,3096
2020-05-13,8,3495,4753,2319,10449,9404,1821,54,21845,895,3847,594,5336,241,2793,3034
2020-05-13,9,3596,4819,2334,10429,9432,1796,54,21829,1408,6213,1138,8759,210,2803,3013
2020-05-13,10,3695,4864,2327,10151,9325,1724,54,21372,1556,7279,1461,10296,195,2823,3018
2020-05-13,11,3786,4895,2318,9812,9199,1623,55,20808,1590,7771,1630,10991,208,2777,2985
2020-05-13,12,3871,4894,2313,9607,9110,1536,56,20426,1594,8007,1737,11338,241,2726,2967
2020-05-13,13,3961,4896,2313,9370,9127,1465,58,20138,1585,8056,1774,11415,293,2814,3107
2020-05-13,14,4070,4875,2295,9385,9251,1425,59,20239,1535,8052,1776,11363,366,2998,3364
2020-05-13,15,4180,4856,2269,9444,9487,1457,61,20567,1435,7900,1757,11092,452,3170,3622
2020-05-13,16,4299,4893,2246,9613,9681,1570,63,21045,1349,7517,1669,10535,529,3282,3811
2020-05-13,17,4413,4960,2249,10067,9904,1727,65,21881,1279,6921,1500,9700,586,3325,3911
2020-05-13,18,4441,4991,2281,10686,10334,1971,65,23173,1103,5446,1176,7725,607,3320,3927
2020-05-13,19,4394,4937,2297,11266,10637,2157,63,24240,648,2659,611,3918,587,3282,3869
2020-05-13,20,4377,4969,2268,11637,10906,2260,61,24982,151,464,124,739,545,3219,3764
2020-05-13,21,4429,4974,2268,11998,11236,2291,61,25705,0,3,0,3,515,3163,3678
2020-05-13,22,4250,4740,2231,11666,10843,2185,57,24869,0,0,0,0,499,3138,3637
2020-05-13,23,3932,4455,2064,10836,10193,2021,52,23220,0,0,0,0,470,3114,3584
2020-05-13,24,3654,4238,1899,10135,9495,1859,47,21653,0,0,0,0,423,3065,3488
2020-05-14,1,3444,4130,1774,10027,9317,1809,43,21314,0,0,0,0,357,3070,3427
2020-05-14,2,3284,4061,1716,9645,8890,1712,42,20406,0,0,0,0,315,3029,3344
2020-05-14,3,3180,4048,1689,9391,8611,1669,41,19830,0,0,0,0,305,2982,3287
2020-05-14,4,3145,4094,1693,9293,8445,1631,42,19531,0,0,0,0,315,2934,3249
2020-05-14,5,3162,4254,1760,9438,8497,1638,44,19734,0,0,0,0,325,2889,3214
2020-05-14,6,3258,4470,1937,9832,8872,1699,47,20568,1,17,0,18,320,2841,3161
2020-05-14,7,3349,4703,2176,10233,9208,1761,51,21371,217,924,129,1270,296,2783,3079
2020-05-14,8,3500,4820,2320,10441,9443,1780,53,21835,839,3442,577,4858,270,2756,3026
2020-05-14,9,3623,4887,2345,10623,9627,1734,53,22156,1346,5768,1083,8197,268,2812,3080
2020-05-14,10,3735,4935,2343,10437,9465,1640,54,21715,1521,6986,1391,9898,284,2903,3187
2020-05-14,11,3842,4977,2329,10184,9410,1522,55,21290,1564,7594,1572,10730,305,2962,3267
2020-05-14,12,3937,4991,2314,10072,9452,1470,57,21169,1571,7852,1684,11107,334,3004,3338
2020-05-14,13,4035,5014,2313,9906,9578,1434,59,21096,1564,7865,1711,11140,365,3060,3425
2020-05-14,14,4142,5026,2294,9875,9764,1450,61,21269,1505,7812,1686,11003,382,3132,3514
2020-05-14,15,4254,5050,2260,9875,9976,1471,63,21503,1387,7612,1598,10597,402,3190,3592
2020-05-14,16,4375,5087,2231,10022,10280,1618,65,22104,1289,7177,1464,9930,423,3229,3652
2020-05-14,17,4504,5164,2232,10357,10632,1816,68,22991,1200,6531,1292,9023,429,3265,3694
2020-05-14,18,4526,5109,2259,10948,10860,2140,68,24133,998,5115,1006,7119,438,3275,3713
2020-05-14,19,4462,5070,2276,11610,11092,2334,66,25219,575,2507,526,3608,454,3268,3722
2020-05-14,20,4438,5079,2250,11998,11261,2411,63,25851,137,439,98,674,472,3259,3731
2020-05-14,21,4482,5045,2252,12266,11594,2364,61,26403,0,3,0,3,507,3251,3758
2020-05-14,22,4291,4819,2236,11901,11235,2275,57,25586,0,0,0,0,544,3237,3781
2020-05-14,23,3989,4537,2077,11109,10571,2118,51,23967,0,0,0,0,564,3197,3761
2020-05-14,24,3708,4317,1917,10392,9873,1943,47,22374,0,0,0,0,574,3130,3704
2020-05-15,1,3506,4129,1783,10021,9415,1811,45,21408,0,0,0,0,660,3043,3703
2020-05-15,2,3352,4058,1722,9595,8969,1718,43,20441,0,0,0,0,619,3003,3622
2020-05-15,3,3240,4035,1699,9349,8672,1658,42,19843,0,0,0,0,584,2987,3571
2020-05-15,4,3198,4078,1709,9238,8517,1623,43,19541,0,0,0,0,550,2979,3529
2020-05-15,5,3207,4219,1777,9349,8600,1642,44,19754,0,0,0,0,506,2961,3467
2020-05-15,6,3281,4406,1939,9673,8891,1717,47,20446,0,15,3,18,451,2916,3367
2020-05-15,7,3358,4625,2156,9999,9135,1783,50,21084,239,1094,148,1481,385,2842,3227
2020-05-15,8,3537,4760,2297,10243,9369,1793,51,21574,906,3896,646,5448,306,2725,3031
2020-05-15,9,3688,4838,2330,10175,9406,1749,51,21500,1422,6242,1180,8844,216,2607,2823
2020-05-15,10,3824,4881,2323,9748,9434,1671,51,21022,1581,7281,1480,10342,130,2429,2559
2020-05-15,11,3953,4917,2307,9342,9476,1554,54,20543,1626,7756,1636,11018,82,2231,2313
2020-05-15,12,4096,4916,2290,9138,9475,1494,56,20281,1646,7970,1731,11347,65,2043,2108
2020-05-15,13,4226,4919,2272,9025,9708,1477,60,20387,1652,8012,1755,11419,63,1957,2020
2020-05-15,14,4380,4906,2249,9080,10075,1489,63,20826,1647,8001,1751,11399,80,2045,2125
2020-05-15,15,4535,4882,2216,9235,10502,1540,66,21462,1632,7863,1736,11231,124,2274,2398
2020-05-15,16,4684,4905,2204,9586,10933,1632,69,22339,1592,7482,1654,10728,203,2540,2743
2020-05-15,17,4817,4939,2218,10206,11301,1819,72,23516,1516,6850,1497,9863,321,2754,3075
2020-05-15,18,4857,4962,2248,11030,11651,2049,73,24921,1289,5423,1189,7901,465,2914,3379
2020-05-15,19,4757,4866,2232,11700,11923,2215,71,26028,757,2690,629,4076,609,3023,3632
2020-05-15,20,4645,4845,2179,12073,11840,2378,68,26476,185,476,119,780,725,3044,3769
2020-05-15,21,4614,4892,2142,12364,11970,2387,64,26902,3,6,0,9,788,3023,3811
2020-05-15,22,4408,4737,2112,12038,11530,2301,59,26044,0,0,0,0,797,2965,3762
2020-05-15,23,4150,4493,1984,11350,10860,2166,53,24546,0,0,0,0,803,2861,3664
2020-05-15,24,3881,4270,1832,10641,10085,1953,48,22845,0,0,0,0,825,2734,3559
2020-05-16,1,3674,4077,1719,9893,9501,1893,45,21464,0,0,0,0,828,2648,3476
2020-05-16,2,3482,4009,1657,9495,9119,1796,43,20579,0,0,0,0,868,2519,3387
2020-05-16,3,3345,3985,1624,9190,8826,1706,43,19885,0,0,0,0,919,2381,3300
2020-05-16,4,3279,3995,1616,9022,8645,1663,43,19503,0,0,0,0,951,2238,3189
2020-05-16,5,3243,4039,1635,9003,8611,1659,44,19446,0,0,0,0,956,2090,3046
2020-05-16,6,3231,4042,1674,9061,8734,1681,45,19655,0,9,0,9,935,1882,2817
2020-05-16,7,3190,4107,1704,8868,8591,1701,47,19337,179,1236,132,1547,885,1504,2389
2020-05-16,8,3344,4280,1806,8997,8603,1667,48,19439,877,4449,672,5998,836,1006,1842
2020-05-16,9,3542,4397,1940,8995,8769,1583,50,19515,1277,6444,1196,8917,826,576,1402
2020-05-16,10,3752,4456,2033,8841,8853,1507,52,19372,1394,7249,1471,10114,807,296,1103
2020-05-16,11,3959,4496,2061,8579,8952,1399,56,19105,1434,7583,1610,10627,760,169,929
2020-05-16,12,4178,4504,2050,8480,9376,1308,60,19342,1482,7551,1675,10708,739,140,879
2020-05-16,13,4374,4488,2027,8374,9786,1301,65,19646,1523,7438,1646,10607,748,150,898
2020-05-16,14,4583,4503,2001,8417,10252,1342,69,20200,1550,7419,1648,10617,764,210,974
2020-05-16,15,4791,4545,1984,8581,10818,1432,74,21024,1525,7269,1619,10413,797,432,1229
2020-05-16,16,4983,4645,1979,8976,11452,1554,77,22178,1492,6906,1589,9987,853,898,1751
2020-05-16,17,5129,4757,1991,9576,12066,1766,81,23607,1440,6298,1435,9173,915,1480,2395
2020-05-16,18,5105,4817,2010,10380,12497,2033,81,25109,1270,5196,1148,7614,956,1910,2866
2020-05-16,19,4981,4775,2006,11144,12639,2203,79,26185,743,2593,566,3902,948,2127,3075
2020-05-16,20,4828,4776,1964,11562,12518,2274,74,26547,119,305,88,512,873,2221,3094
2020-05-16,21,4769,4820,1965,11778,12465,2341,69,26774,0,2,2,4,733,2236,2969
2020-05-16,22,4560,4637,1965,11473,12007,2263,63,25927,0,0,0,0,574,2216,2790
2020-05-16,23,4345,4391,1856,10917,11254,2117,56,24465,0,0,0,0,436,2199,2635
2020-05-16,24,4072,4189,1718,10433,10434,1971,51,23015,0,0,0,0,314,2202,2516
2020-05-17,1,3925,4209,1606,10042,9616,1918,47,21761,0,0,0,0,247,2050,2297
2020-05-17,2,3724,4141,1544,9606,9124,1824,45,20733,0,0,0,0,178,1985,2163
2020-05-17,3,3586,4090,1513,9286,8730,1755,44,19949,0,0,0,0,151,1868,2019
2020-05-17,4,3490,4074,1508,9144,8486,1705,44,19514,0,0,0,0,151,1705,1856
2020-05-17,5,3441,4075,1528,9115,8332,1692,44,19315,0,0,0,0,158,1516,1674
2020-05-17,6,3383,4014,1542,9166,8292,1704,44,19340,0,11,0,11,165,1328,1493
2020-05-17,7,3302,4047,1571,9039,7998,1674,45,18888,181,1237,126,1544,169,1121,1290
2020-05-17,8,3427,4246,1666,9167,8066,1678,49,19081,862,4462,651,5975,181,901,1082
2020-05-17,9,3627,4402,1820,9337,7996,1600,52,19103,1238,6444,1172,8854,224,707,931
2020-05-17,10,3857,4496,1930,9466,8151,1492,55,19282,1305,7232,1414,9951,299,569,868
2020-05-17,11,4071,4550,1970,9464,8423,1376,59,19439,1345,7680,1549,10574,375,550,925
2020-05-17,12,4294,4692,1987,9448,8744,1285,62,19656,1324,7773,1592,10689,457,640,1097
2020-05-17,13,4488,4801,1990,9459,9018,1248,66,19910,1235,7724,1491,10450,535,797,1332
2020-05-17,14,4649,4969,1964,9485,9344,1250,69,20267,1210,7609,1449,10268,596,989,1585
2020-05-17,15,4799,5136,1937,9533,9817,1306,72,20846,1149,7348,1406,9903,677,1193,1870
2020-05-17,16,4959,5319,1934,9686,10290,1532,74,21702,1071,6929,1281,9281,753,1391,2144
2020-05-17,17,5050,5508,1967,10127,10877,1712,77,22912,1005,6295,1068,8368,779,1573,2352
2020-05-17,18,4981,5591,2027,10705,11404,1987,76,24294,882,4987,847,6716,766,1734,2500
2020-05-17,19,4860,5533,2051,11160,11574,2186,73,25128,516,2411,412,3339,701,1836,2537
2020-05-17,20,4739,5418,2040,11413,11594,2306,69,25505,84,291,57,432,599,1880,2479
2020-05-17,21,4762,5364,2040,11684,11707,2368,65,25974,0,2,0,2,527,1930,2457
2020-05-17,22,4586,5061,2016,11443,11298,2301,60,25251,0,0,0,0,490,1972,2462
2020-05-17,23,4329,4716,1879,10681,10569,2134,54,23580,0,0,0,0,449,1953,2402
2020-05-17,24,4035,4456,1730,10002,9802,1971,49,21961,0,0,0,0,404,1883,2287
2020-05-18,1,3699,4350,1625,9671,8976,1814,46,20632,0,0,0,0,631,1518,2149
2020-05-18,2,3522,4269,1579,9291,8628,1732,43,19823,0,0,0,0,693,1424,2117
2020-05-18,3,3405,4224,1564,9036,8383,1681,41,19266,0,0,0,0,742,1337,2079
2020-05-18,4,3338,4274,1584,8968,8306,1659,41,19097,0,0,0,0,744,1274,2018
2020-05-18,5,3342,4431,1667,9109,8537,1680,43,19494,0,0,0,0,696,1244,1940
2020-05-18,6,3396,4636,1843,9608,9015,1750,45,20547,0,13,0,13,591,1228,1819
2020-05-18,7,3469,4898,2096,10308,9415,1806,48,21710,156,976,75,1207,464,1151,1615
2020-05-18,8,3646,5130,2254,10746,9913,1870,51,22705,720,3341,395,4456,379,1110,1489
2020-05-18,9,3789,5326,2300,10762,10087,1885,55,22906,1052,5014,781,6847,344,1105,1449
2020-05-18,10,3943,5492,2306,10562,10297,1832,58,22865,1177,5903,1070,8150,347,1152,1499
2020-05-18,11,4068,5658,2308,10308,10335,1744,59,22562,1163,6620,1215,8998,386,1231,1617
2020-05-18,12,4177,5818,2302,10127,10417,1670,61,22393,1144,6890,1262,9296,463,1331,1794
2020-05-18,13,4281,5961,2305,9826,10405,1659,62,22073,1236,6909,1383,9528,546,1442,1988
2020-05-18,14,4386,6065,2287,9660,10378,1649,63,21878,1233,6900,1400,9533,603,1553,2156
2020-05-18,15,4496,6123,2249,9784,10476,1694,64,22148,1206,6932,1396,9534,639,1649,2288
2020-05-18,16,4580,6154,2222,9937,10686,1811,66,22632,1178,6609,1378,9165,690,1722,2412
2020-05-18,17,4652,6215,2225,10200,10798,1976,66,23172,1126,6006,1266,8398,746,1759,2505
2020-05-18,18,4602,6073,2269,10855,11119,2172,65,24347,998,4856,1028,6882,764,1764,2528
2020-05-18,19,4521,5934,2290,11586,11298,2303,61,25384,615,2338,518,3471,706,1844,2550
2020-05-18,20,4444,5817,2263,12036,11485,2377,59,26092,101,275,76,452,600,1902,2502
2020-05-18,21,4461,5741,2246,12282,11814,2410,59,26694,0,2,0,2,512,2054,2566
2020-05-18,22,4274,5372,2212,12013,11400,2310,56,25904,0,0,0,0,455,2275,2730
2020-05-18,23,3958,4956,2054,11211,10651,2136,51,24166,0,0,0,0,420,2551,2971
2020-05-18,24,3666,4630,1887,10451,9846,1957,47,22420,0,0,0,0,401,2775,3176
2020-05-19,1,3430,4279,1773,9725,9060,1845,45,20792,0,0,0,0,305,2754,3059
2020-05-19,2,3257,4169,1710,9395,8655,1758,43,19969,0,0,0,0,279,2724,3003
2020-05-19,3,3160,4117,1684,9181,8451,1694,43,19488,0,0,0,0,254,2673,2927
2020-05-19,4,3118,4140,1689,9153,8357,1666,43,19337,0,0,0,0,238,2643,2881
2020-05-19,5,3135,4281,1757,9305,8565,1678,45,19711,0,0,0,0,216,2618,2834
2020-05-19,6,3210,4462,1933,9743,9064,1753,47,20727,0,15,0,15,180,2578,2758
2020-05-19,7,3295,4678,2149,10204,9565,1795,51,21734,184,1232,103,1519,133,2538,2671
2020-05-19,8,3427,4874,2303,10631,9883,1797,53,22483,831,4347,524,5702,94,2560,2654
2020-05-19,9,3496,5026,2333,10433,9774,1760,55,22143,1237,6376,979,8592,69,2688,2757
2020-05-19,10,3567,5134,2339,9949,9633,1754,56,21509,1341,7213,1227,9781,60,2824,2884
2020-05-19,11,3614,5213,2334,9529,9508,1687,55,20896,1363,7660,1367,10390,68,2920,2988
2020-05-19,12,3643,5274,2331,9192,9540,1577,54,20480,1374,7749,1403,10526,89,2988,3077
2020-05-19,13,3672,5348,2335,8994,9554,1469,54,20189,1421,7653,1436,10510,122,3028,3150
2020-05-19,14,3717,5370,2318,9022,9596,1420,54,20210,1412,7706,1448,10566,162,3061,3223
2020-05-19,15,3777,5368,2280,9059,9632,1433,54,20295,1397,7657,1450,10504,212,3089,3301
2020-05-19,16,3834,5344,2253,9302,9736,1567,55,20777,1376,7248,1365,9989,282,3110,3392
2020-05-19,17,3920,5321,2258,9849,9923,1776,56,21721,1320,6626,1235,9181,364,3115,3479
2020-05-19,18,3907,5270,2296,10591,10286,2035,58,23088,1170,5472,1017,7659,439,3112,3551
2020-05-19,19,3877,5148,2315,11332,10525,2195,58,24228,753,2739,527,4019,518,3081,3599
2020-05-19,20,3890,5121,2289,11746,10853,2304,57,25077,127,335,86,548,598,3036,3634
2020-05-19,21,3976,5140,2268,12090,11342,2359,57,25965,0,2,0,2,645,3006,3651
2020-05-19,22,3851,4852,2237,11771,11018,2270,54,25230,0,0,0,0,651,2998,3649
2020-05-19,23,3628,4546,2077,10895,10322,2104,50,23487,0,0,0,0,645,3014,3659
2020-05-19,24,3413,4323,1916,10070,9568,1932,46,21733,0,0,0,0,640,3045,3685
2020-05-20,1,3242,4116,1756,9534,8832,1728,43,20255,0,0,0,0,688,2979,3667
2020-05-20,2,3131,4026,1694,9202,8562,1652,42,19576,0,0,0,0,675,2959,3634
2020-05-20,3,3074,3985,1663,8978,8327,1603,42,19068,0,0,0,0,625,2865,3490
2020-05-20,4,3061,4010,1670,8927,8219,1575,43,18883,0,0,0,0,530,2744,3274
2020-05-20,5,3100,4153,1739,9092,8406,1592,46,19254,0,0,0,0,435,2603,3038
2020-05-20,6,3175,4337,1910,9472,8883,1658,50,20181,1,21,0,22,353,2391,2744
2020-05-20,7,3285,4551,2130,9879,9292,1718,55,21061,260,1302,181,1743,270,2096,2366
2020-05-20,8,3402,4710,2271,10104,9532,1699,54,21508,944,4359,749,6052,193,1731,1924
2020-05-20,9,3442,4814,2301,9924,9493,1697,55,21286,1442,6614,1303,9359,136,1353,1489
2020-05-20,10,3475,4884,2312,9448,9338,1583,54,20540,1583,7487,1582,10652,97,1021,1118
2020-05-20,11,3518,4921,2320,9057,9324,1483,53,20035,1622,7933,1716,11271,67,772,839
2020-05-20,12,3538,4907,2322,8771,9422,1408,53,19771,1640,8131,1785,11556,47,637,684
2020-05-20,13,3577,4888,2326,8620,9520,1383,54,19696,1644,8151,1797,11592,36,635,671
2020-05-20,14,3651,4850,2315,8651,9723,1393,55,19939,1641,8133,1790,11564,34,769,803
2020-05-20,15,3735,4817,2300,8728,9935,1458,56,20295,1631,7997,1764,11392,38,1030,1068
2020-05-20,16,3857,4828,2288,9012,10118,1587,57,20891,1600,7642,1680,10922,49,1401,1450
2020-05-20,17,3976,4878,2282,9547,10337,1740,58,21800,1550,7057,1533,10140,81,1804,1885
2020-05-20,18,4047,4901,2311,10361,10712,1975,60,23224,1383,5710,1236,8329,159,2133,2292
2020-05-20,19,4001,4898,2307,11251,11011,2198,60,24637,867,2992,683,4542,273,2341,2614
2020-05-20,20,3996,4932,2269,11604,11252,2312,58,25343,228,606,141,975,382,2456,2838
2020-05-20,21,4090,4973,2251,11902,11653,2387,58,26118,5,2,0,7,459,2518,2977
2020-05-20,22,3957,4770,2214,11667,11295,2282,54,25415,0,0,0,0,486,2507,2993
2020-05-20,23,3664,4493,2056,10852,10557,2093,49,23668,0,0,0,0,476,2410,2886
2020-05-20,24,3424,4281,1893,10073,9760,1914,45,21910,0,0,0,0,473,2265,2738
2020-05-21,1,3198,4149,1758,9679,9052,1790,43,20683,0,0,0,0,501,2050,2551
2020-05-21,2,3083,4073,1698,9334,8733,1708,42,19935,0,0,0,0,503,1896,2399
2020-05-21,3,3016,4052,1669,9087,8481,1645,42,19373,0,0,0,0,505,1768,2273
2020-05-21,4,2997,4103,1677,9014,8389,1614,42,19177,0,0,0,0,490,1630,2120
2020-05-21,5,3033,4251,1745,9166,8567,1625,45,19522,0,0,0,0,453,1439,1892
2020-05-21,6,3079,4455,1910,9522,9034,1690,48,20413,3,16,1,20,404,1189,1593
2020-05-21,7,3185,4684,2150,9955,9356,1736,52,21218,273,1336,194,1803,331,875,1206
2020-05-21,8,3328,4814,2295,10284,9511,1727,54,21693,965,4407,774,6146,238,514,752
2020-05-21,9,3441,4887,2323,10024,9596,1639,53,21431,1437,6638,1317,9392,153,220,373
2020-05-21,10,3534,4939,2334,9599,9516,1534,52,20820,1561,7509,1585,10655,103,94,197
2020-05-21,11,3610,4978,2327,9293,9589,1440,53,20494,1604,7947,1717,11268,100,92,192
2020-05-21,12,3687,4991,2314,9110,9755,1405,55,20444,1621,8139,1782,11542,133,98,231
2020-05-21,13,3774,5013,2312,9051,10071,1420,58,20719,1624,8161,1791,11576,190,83,273
2020-05-21,14,3880,5010,2293,9175,10494,1438,60,21286,1621,8142,1770,11533,264,69,333
2020-05-21,15,3999,5017,2254,9313,10933,1489,61,21915,1607,7998,1720,11325,352,120,472
2020-05-21,16,4143,5075,2224,9804,11500,1648,63,23134,1575,7617,1625,10817,459,331,790
2020-05-21,17,4282,5141,2223,10397,11918,1822,65,24321,1534,6990,1477,10001,586,764,1350
2020-05-21,18,4309,5150,2253,11175,12292,2088,67,25739,1378,5579,1194,8151,730,1309,2039
2020-05-21,19,4276,5131,2271,11812,12458,2262,66,26714,869,2890,670,4429,859,1799,2658
2020-05-21,20,4206,5078,2244,12083,12337,2333,63,26933,230,594,141,965,944,2154,3098
2020-05-21,21,4250,5065,2247,12275,12476,2366,61,27297,3,5,1,9,984,2365,3349
2020-05-21,22,4091,4837,2243,11940,11971,2263,56,26357,0,2,0,2,992,2483,3475
2020-05-21,23,3795,4554,2095,11088,11167,2099,50,24536,0,0,0,0,996,2557,3553
2020-05-21,24,3527,4329,1938,10284,10296,1932,45,22685,0,0,0,0,1001,2607,3608
2020-05-22,1,3384,4139,1815,9910,9478,1817,42,21364,0,0,0,0,1004,2627,3631
2020-05-22,2,3232,4065,1753,9444,8986,1718,40,20305,0,0,0,0,958,2681,3639
2020-05-22,3,3123,4029,1730,9179,8633,1655,40,19623,0,0,0,0,952,2687,3639
2020-05-22,4,3084,4059,1742,9095,8491,1622,40,19365,0,0,0,0,943,2663,3606
2020-05-22,5,3113,4184,1813,9229,8600,1637,42,19626,0,0,0,0,920,2615,3535
2020-05-22,6,3180,4342,1982,9591,8971,1689,45,20412,2,30,2,34,864,2530,3394
2020-05-22,7,3270,4553,2182,10051,9346,1742,48,21304,259,1324,188,1771,766,2397,3163
2020-05-22,8,3484,4713,2332,10394,9643,1749,50,21953,945,4316,760,6021,646,2227,2873
2020-05-22,9,3616,4821,2377,10151,9697,1700,49,21714,1447,6511,1310,9268,520,2126,2646
2020-05-22,10,3740,4883,2376,9687,9819,1614,50,21289,1588,7421,1589,10598,393,2180,2573
2020-05-22,11,3864,4932,2348,9374,9936,1496,53,20977,1621,7862,1725,11208,303,2358,2661
2020-05-22,12,3990,4948,2309,9107,10006,1420,55,20706,1634,8050,1792,11476,251,2564,2815
2020-05-22,13,4087,4984,2284,8929,10201,1441,58,20750,1641,8069,1804,11514,202,2728,2930
2020-05-22,14,4172,4998,2253,8951,10557,1431,61,21120,1640,8033,1796,11469,163,2863,3026
2020-05-22,15,4256,5003,2203,9116,10818,1462,64,21578,1628,7854,1770,11252,151,2990,3141
2020-05-22,16,4352,4996,2170,9367,11134,1557,67,22243,1595,7444,1687,10726,164,3099,3263
2020-05-22,17,4494,4979,2169,10000,11531,1720,68,23437,1549,6839,1531,9919,198,3171,3369
2020-05-22,18,4456,4888,2191,10709,11880,2063,67,24837,1352,5492,1224,8068,246,3181,3427
2020-05-22,19,4353,4819,2190,11517,12018,2182,65,25900,842,2876,676,4394,288,3124,3412
2020-05-22,20,4266,4814,2149,11911,12009,2287,61,26385,224,595,155,974,308,3008,3316
2020-05-22,21,4302,4891,2132,12069,12094,2365,59,26704,7,1,0,8,312,2883,3195
2020-05-22,22,4162,4766,2152,11924,11674,2289,54,26059,0,1,0,1,314,2786,3100
2020-05-22,23,3911,4537,2050,11361,11051,2146,49,24725,0,0,0,0,324,2811,3135
2020-05-22,24,3666,4313,1910,10599,10268,1977,45,23007,0,0,0,0,343,2944,3287
2020-05-23,1,3523,4095,1762,9889,9387,1889,44,21325,0,0,0,0,317,3022,3339
2020-05-23,2,3362,4019,1702,9457,8894,1785,41,20294,0,0,0,0,327,3082,3409
2020-05-23,3,3251,3993,1678,9154,8521,1710,41,19543,0,0,0,0,333,3061,3394
2020-05-23,4,3198,3999,1682,8988,8323,1666,41,19135,0,0,0,0,328,2875,3203
2020-05-23,5,3179,4032,1715,8970,8314,1670,41,19113,0,0,0,0,322,2519,2841
2020-05-23,6,3145,4016,1761,9037,8355,1673,42,19224,4,21,1,26,315,2096,2411
2020-05-23,7,3101,4087,1800,8939,8258,1686,43,19044,309,1301,208,1818,295,1633,1928
2020-05-23,8,3194,4259,1914,9007,8263,1708,46,19142,1049,4294,810,6153,265,1135,1400
2020-05-23,9,3314,4380,2058,8954,8267,1664,47,19049,1514,6512,1353,9379,265,670,935
2020-05-23,10,3445,4443,2105,8872,8319,1536,48,18893,1622,7408,1615,10645,292,331,623
2020-05-23,11,3505,4467,2091,8689,8321,1410,51,18591,1659,7869,1747,11275,292,170,462
2020-05-23,12,3558,4452,2069,8577,8476,1312,53,18538,1675,8073,1812,11560,262,130,392
2020-05-23,13,3600,4407,2036,8577,8801,1283,56,18838,1679,8095,1822,11596,217,145,362
2020-05-23,14,3666,4363,1990,8687,9034,1299,57,19198,1677,8067,1816,11560,166,207,373
2020-05-23,15,3743,4348,1957,9021,9375,1360,59,19933,1667,7922,1794,11383,141,365,506
2020-05-23,16,3821,4395,1954,9626,9952,1506,60,21262,1645,7560,1713,10918,170,676,846
2020-05-23,17,3903,4499,1983,10439,10563,1640,63,22822,1601,6993,1555,10149,238,1145,1383
2020-05-23,18,3977,4557,2019,11358,11145,1904,65,24589,1439,5666,1265,8370,356,1640,1996
2020-05-23,19,3954,4566,2033,12132,11348,2100,62,25760,922,3005,723,4650,496,2011,2507
2020-05-23,20,3902,4611,1994,12392,11392,2206,59,26165,250,634,171,1055,587,2240,2827
2020-05-23,21,3957,4708,1957,12526,11583,2282,58,26566,6,4,2,12,613,2319,2932
2020-05-23,22,3861,4594,1963,12344,11133,2219,55,25867,0,3,0,3,590,2240,2830
2020-05-23,23,3682,4390,1865,11703,10334,2093,50,24298,0,0,0,0,587,2073,2660
2020-05-23,24,3462,4195,1743,10927,9664,1930,46,22685,0,0,0,0,584,1914,2498
2020-05-24,1,3301,4009,1650,10079,8963,1833,43,21035,0,0,0,0,628,1824,2452
2020-05-24,2,3150,3945,1598,9596,8514,1749,41,20018,0,0,0,0,624,1717,2341
2020-05-24,3,3066,3915,1576,9264,8217,1671,40,19311,0,0,0,0,599,1651,2250
2020-05-24,4,3027,3915,1579,9075,8057,1633,40,18923,0,0,0,0,529,1588,2117
2020-05-24,5,3023,3925,1603,9023,7981,1616,42,18779,0,0,0,0,432,1469,1901
2020-05-24,6,2972,3849,1622,9006,7986,1634,43,18787,0,24,0,24,348,1271,1619
2020-05-24,7,2930,3888,1630,8781,7804,1610,45,18358,301,1369,206,1876,271,984,1255
2020-05-24,8,3057,4051,1722,8742,7769,1587,47,18264,1029,4435,794,6258,190,630,820
2020-05-24,9,3206,4122,1866,8696,7840,1508,48,18210,1498,6629,1327,9454,121,306,427
2020-05-24,10,3354,4146,1954,8505,7976,1408,49,18057,1615,7482,1597,10694,86,125,211
2020-05-24,11,3475,4143,1988,8405,8158,1290,51,18023,1653,7916,1733,11302,79,79,158
2020-05-24,12,3592,4182,1979,8521,8501,1230,54,18425,1666,8103,1799,11568,75,73,148
2020-05-24,13,3705,4162,1960,8775,8997,1195,57,19143,1669,8126,1808,11603,65,67,132
2020-05-24,14,3841,4171,1935,9251,9579,1221,60,20229,1664,8117,1801,11582,54,75,129
2020-05-24,15,3974,4188,1922,10080,10261,1305,63,21827,1654,7986,1775,11415,48,143,191
2020-05-24,16,4163,4275,1938,10879,10984,1513,65,23560,1624,7634,1690,10948,68,346,414
2020-05-24,17,4306,4390,1992,11827,11514,1710,67,25237,1578,7063,1537,10178,138,713,851
2020-05-24,18,4371,4438,2069,12929,11977,1963,70,27056,1412,5735,1246,8393,251,1153,1404
2020-05-24,19,4337,4464,2108,13652,12078,2144,69,28059,894,3070,706,4670,367,1529,1896
2020-05-24,20,4253,4509,2102,13942,11952,2275,65,28351,240,661,153,1054,453,1801,2254
2020-05-24,21,4254,4589,2082,13917,12093,2363,63,28552,2,5,0,7,492,1968,2460
2020-05-24,22,4141,4427,2027,13438,11585,2283,57,27481,0,1,0,1,485,1994,2479
2020-05-24,23,3897,4191,1860,12512,10785,2113,51,25579,0,0,0,0,452,1884,2336
2020-05-24,24,3664,4027,1699,11446,9990,1949,47,23548,0,0,0,0,424,1664,2088
2020-05-25,1,3378,3904,1603,10961,9309,1840,43,22286,0,0,0,0,467,1308,1775
2020-05-25,2,3217,3856,1535,10424,8790,1768,41,21154,0,0,0,0,449,1099,1548
2020-05-25,3,3120,3843,1496,10027,8432,1694,40,20320,0,0,0,0,402,885,1287
2020-05-25,4,3068,3848,1481,9809,8220,1660,40,19859,0,0,0,0,316,646,962
2020-05-25,5,3069,3876,1494,9751,8207,1663,42,19794,0,0,0,0,233,380,613
2020-05-25,6,3040,3853,1506,9901,8207,1687,43,19965,1,34,1,36,170,193,363
2020-05-25,7,3028,3896,1509,9999,8092,1680,45,19942,293,1381,203,1877,120,146,266
2020-05-25,8,3174,4044,1607,10012,8169,1660,47,20010,1005,4445,781,6231,81,173,254
2020-05-25,9,3352,4150,1795,10095,8253,1611,50,20128,1479,6648,1311,9438,54,250,304
2020-05-25,10,3544,4211,1925,10246,8593,1549,53,20560,1602,7512,1579,10693,38,341,379
2020-05-25,11,3722,4266,1983,10583,9151,1446,56,21356,1639,7946,1711,11296,28,382,410
2020-05-25,12,3894,4290,2012,11060,9785,1420,60,22445,1652,8145,1781,11578,21,353,374
2020-05-25,13,4034,4290,2032,11599,10427,1470,65,23681,1654,8174,1793,11621,16,275,291
2020-05-25,14,4200,4291,2055,12340,11287,1565,69,25382,1650,8155,1785,11590,11,186,197
2020-05-25,15,4373,4333,2087,13245,12085,1645,73,27167,1641,8023,1760,11424,11,121,132
2020-05-25,16,4542,4433,2138,14208,12886,1809,76,29099,1612,7672,1672,10956,28,106,134
2020-05-25,17,4712,4590,2187,15254,13320,2036,78,30809,1568,7116,1520,10204,85,151,236
2020-05-25,18,4796,4669,2231,16254,13625,2282,80,32360,1410,5827,1231,8468,185,266,451
2020-05-25,19,4734,4689,2253,16837,13566,2514,77,33111,906,3170,696,4772,295,437,732
2020-05-25,20,4641,4657,2199,16890,13313,2573,73,32966,249,710,152,1111,374,611,985
2020-05-25,21,4626,4721,2149,16457,13352,2547,69,32550,4,9,1,14,412,746,1158
2020-05-25,22,4437,4491,2121,15719,12776,2400,63,31078,0,1,0,1,418,847,1265
2020-05-25,23,4076,4189,1934,14284,11698,2234,56,28405,0,0,0,0,400,967,1367
2020-05-25,24,3788,4007,1748,12887,10739,2016,50,25829,0,0,0,0,377,1165,1542
2020-05-26,1,3581,4014,1702,11511,10095,1919,49,23695,0,0,0,0,354,1550,1904
2020-05-26,2,3383,3961,1638,10881,9585,1783,47,22417,0,0,0,0,341,1663,2004
2020-05-26,3,3255,3930,1593,10425,9189,1739,45,21530,0,0,0,0,321,1625,1946
2020-05-26,4,3188,3967,1578,10207,9009,1693,45,21076,0,0,0,0,281,1437,1718
2020-05-26,5,3183,4111,1621,10266,9126,1700,47,21265,0,0,0,0,222,1163,1385
2020-05-26,6,3188,4299,1748,10620,9485,1759,48,22044,1,32,0,33,165,889,1054
2020-05-26,7,3339,4522,1945,11332,9980,1821,52,23315,292,1374,201,1867,110,627,737
2020-05-26,8,3603,4653,2118,12042,10566,1785,56,24572,999,4401,772,6172,62,359,421
2020-05-26,9,3813,4736,2207,12165,11002,1773,59,25118,1470,6578,1298,9346,33,153,186
2020-05-26,10,4055,4785,2252,12326,11472,1742,62,25722,1596,7437,1567,10600,21,62,83
2020-05-26,11,4318,4825,2271,12740,12075,1704,67,26707,1633,7867,1699,11199,15,51,66
2020-05-26,12,4573,4871,2289,13373,12777,1721,72,28065,1646,8068,1767,11481,12,58,70
2020-05-26,13,4809,4949,2337,14049,13588,1806,77,29643,1648,8103,1777,11528,14,62,76
2020-05-26,14,5071,5004,2362,14949,14473,1878,82,31505,1644,8088,1768,11500,25,70,95
2020-05-26,15,5323,5070,2386,15777,15327,1973,86,33283,1636,7955,1745,11336,48,104,152
2020-05-26,16,5551,5149,2410,16630,16106,2140,88,35085,1605,7609,1661,10875,93,210,303
2020-05-26,17,5679,5228,2463,17560,16453,2291,91,36515,1556,7026,1509,10091,170,463,633
2020-05-26,18,5684,5276,2455,18156,16446,2579,91,37391,1396,5710,1219,8325,266,856,1122
2020-05-26,19,5605,5164,2437,18500,16293,2684,88,37694,898,3109,689,4696,345,1285,1630
2020-05-26,20,5430,5083,2375,18329,15852,2680,82,37074,249,706,166,1121,392,1595,1987
2020-05-26,21,5325,5081,2298,17751,15371,2687,76,36018,5,12,2,19,419,1780,2199
2020-05-26,22,5034,4776,2211,16817,14513,2539,69,34061,0,1,0,1,441,1963,2404
2020-05-26,23,4648,4408,2019,15165,13150,2321,61,30828,0,0,0,0,464,2179,2643
2020-05-26,24,4262,4153,1839,13628,11876,2111,56,27797,0,0,0,0,484,2328,2812
2020-05-27,1,4080,4178,1805,12038,10770,1968,56,24968,0,0,0,0,597,2439,3036
2020-05-27,2,3850,4103,1737,11324,10196,1863,53,23571,0,0,0,0,642,2438,3080
2020-05-27,3,3678,4059,1684,10834,9824,1801,51,22644,0,0,0,0,613,2412,3025
2020-05-27,4,3581,4089,1665,10554,9661,1762,51,22164,0,0,0,0,539,2313,2852
2020-05-27,5,3556,4226,1703,10567,9732,1781,52,22271,0,0,0,0,459,2117,2576
2020-05-27,6,3548,4388,1823,10928,10148,1864,53,23135,1,33,0,34,377,1840,2217
2020-05-27,7,3679,4603,2020,11509,10678,1933,57,24322,296,1380,204,1880,288,1487,1775
2020-05-27,8,3970,4795,2190,12031,11197,1955,62,25373,1006,4413,779,6198,196,1126,1322
2020-05-27,9,4230,4934,2291,12220,11429,1911,65,25744,1476,6585,1307,9368,117,818,935
2020-05-27,10,4533,5023,2346,12450,11953,1822,70,26414,1601,7431,1577,10609,72,574,646
2020-05-27,11,4863,5105,2379,12811,12450,1799,77,27255,1638,7851,1710,11199,53,428,481
2020-05-27,12,5208,5192,2418,13558,13103,1834,84,28697,1651,8054,1780,11485,51,395,446
2020-05-27,13,5543,5309,2474,14283,13981,1882,91,30354,1651,8086,1791,11528,68,484,552
2020-05-27,14,5901,5394,2519,15234,14875,1950,97,32275,1643,8053,1781,11477,117,703,820
2020-05-27,15,6220,5454,2556,16122,15794,2045,101,34184,1631,7903,1757,11291,207,1041,1248
2020-05-27,16,6481,5532,2587,16854,16370,2182,104,35634,1603,7546,1671,10820,318,1418,1736
2020-05-27,17,6588,5586,2627,17529,16702,2339,106,36805,1557,6957,1518,10032,419,1722,2141
2020-05-27,18,6535,5613,2646,18029,16623,2557,105,37444,1403,5634,1226,8263,508,1925,2433
2020-05-27,19,6424,5492,2640,18137,16453,2654,101,37482,911,3052,694,4657,578,2042,2620
2020-05-27,20,6182,5360,2558,17728,15872,2716,94,36549,256,684,168,1108,631,2057,2688
2020-05-27,21,6018,5344,2471,17186,15307,2680,87,35399,7,9,1,17,698,2042,2740
2020-05-27,22,5669,5007,2368,16293,14466,2541,78,33523,0,1,0,1,753,2079,2832
2020-05-27,23,5223,4616,2153,14777,13176,2324,70,30492,0,0,0,0,768,2155,2923
2020-05-27,24,4806,4332,1959,13325,11861,2105,63,27494,0,0,0,0,758,2227,2985
2020-05-28,1,4603,4416,1930,11960,11246,1999,61,25396,0,0,0,0,731,2273,3004
2020-05-28,2,4336,4315,1850,11151,10576,1908,58,23822,0,0,0,0,690,2227,2917
2020-05-28,3,4137,4256,1795,10667,10128,1843,56,22823,0,0,0,0,655,2109,2764
2020-05-28,4,4009,4270,1771,10464,9904,1806,54,22359,0,0,0,0,640,1957,2597
2020-05-28,5,3974,4393,1805,10483,9997,1814,55,22479,0,0,0,0,629,1780,2409
2020-05-28,6,3953,4532,1916,10876,10452,1891,57,23413,3,35,0,38,609,1541,2150
2020-05-28,7,4053,4753,2098,11455,11033,1951,59,24638,307,1381,210,1898,559,1204,1763
2020-05-28,8,4330,4989,2281,11959,11656,1979,65,25800,1027,4394,792,6213,456,829,1285
2020-05-28,9,4617,5192,2388,12084,11920,1937,71,26136,1490,6528,1321,9339,335,483,818
2020-05-28,10,4955,5336,2463,12381,12347,1833,78,26764,1608,7339,1587,10534,256,218,474
2020-05-28,11,5308,5470,2529,12752,12904,1798,86,27668,1645,7739,1718,11102,219,97,316
2020-05-28,12,5657,5600,2593,13306,13468,1787,93,28787,1659,7918,1787,11364,207,70,277
2020-05-28,13,5988,5747,2673,13871,14227,1819,100,30149,1659,7892,1801,11352,225,93,318
2020-05-28,14,6332,5861,2740,14802,15085,1865,106,31984,1653,7769,1793,11215,282,188,470
2020-05-28,15,6642,5958,2790,15760,15859,1941,110,33795,1643,7564,1761,10968,366,367,733
2020-05-28,16,6877,6039,2825,16682,16668,2066,112,35654,1610,7183,1669,10462,455,578,1033
2020-05-28,17,6951,6088,2886,17684,16949,2213,114,37088,1549,6610,1512,9671,526,777,1303
2020-05-28,18,6870,6110,2878,18303,16864,2463,112,37870,1386,5396,1219,8001,596,978,1574
2020-05-28,19,6738,5953,2855,18820,16597,2591,107,38250,895,2945,694,4534,670,1152,1822
2020-05-28,20,6481,5806,2778,18567,15986,2642,100,37433,248,656,168,1072,758,1297,2055
2020-05-28,21,6324,5744,2671,17913,15467,2609,93,36210,3,6,1,10,857,1422,2279
2020-05-28,22,5961,5416,2555,16978,14583,2493,84,34266,0,0,0,0,927,1473,2400
2020-05-28,23,5502,4998,2327,15497,13349,2306,75,31357,0,0,0,0,963,1420,2383
2020-05-28,24,5065,4670,2107,14075,12075,2102,68,28452,0,0,0,0,979,1309,2288
2020-05-29,1,4732,4697,2016,11864,10734,1983,59,24798,0,0,0,0,887,1027,1914
2020-05-29,2,4441,4559,1921,11111,10162,1886,56,23371,0,0,0,0,833,843,1676
2020-05-29,3,4226,4479,1855,10626,9778,1819,53,22433,0,0,0,0,811,615,1426
2020-05-29,4,4082,4484,1826,10326,9579,1785,53,21898,0,0,0,0,848,371,1219
2020-05-29,5,4030,4589,1851,10327,9673,1799,53,22006,0,0,0,0,917,188,1105
2020-05-29,6,3993,4697,1934,10597,10014,1866,55,22684,5,45,0,50,955,110,1065
2020-05-29,7,4058,4936,2088,11027,10412,1932,57,23585,209,1283,130,1622,924,79,1003
2020-05-29,8,4331,5232,2283,11464,10942,1990,62,24619,718,4028,541,5287,853,60,913
2020-05-29,9,4605,5511,2418,11665,11133,1988,66,25000,1120,6028,1019,8167,778,64,842
2020-05-29,10,4930,5743,2525,11645,11389,1850,70,25105,1310,6875,1347,9532,697,88,785
2020-05-29,11,5258,5953,2610,11819,11654,1725,76,25425,1435,7369,1552,10356,602,141,743
2020-05-29,12,5590,6137,2692,12118,11915,1660,82,25924,1524,7667,1691,10882,540,218,758
2020-05-29,13,5906,6330,2775,12359,12365,1646,88,26607,1542,7743,1721,11006,521,331,852
2020-05-29,14,6234,6487,2851,12770,12768,1663,93,27445,1538,7702,1694,10934,546,499,1045
2020-05-29,15,6527,6597,2907,13230,13212,1715,97,28405,1529,7545,1673,10747,652,738,1390
2020-05-29,16,6731,6666,2946,13779,13569,1810,100,29408,1488,7153,1594,10235,801,1055,1856
2020-05-29,17,6767,6729,2999,14247,13757,1957,100,30214,1424,6462,1425,9311,934,1369,2303
2020-05-29,18,6720,6623,2972,14746,13775,2220,99,30992,1247,5025,1111,7383,1023,1551,2574
2020-05-29,19,6586,6447,2945,15201,13606,2398,95,31451,786,2568,603,3957,1055,1577,2632
2020-05-29,20,6300,6227,2828,15105,13191,2454,87,30990,220,536,141,897,1058,1531,2589
2020-05-29,21,6125,6129,2700,14795,13172,2430,82,30630,8,5,1,14,1058,1476,2534
2020-05-29,22,5805,5816,2599,14232,12731,2351,75,29539,0,1,0,1,1054,1431,2485
2020-05-29,23,5412,5406,2398,13263,11980,2221,67,27682,0,0,0,0,1007,1402,2409
2020-05-29,24,5007,5041,2159,12365,11116,2057,60,25752,0,0,0,0,882,1382,2264
2020-05-30,1,4624,4907,1936,11200,10012,1928,53,23352,0,0,0,0,888,1358,2246
2020-05-30,2,4369,4735,1806,10646,9453,1825,49,22135,0,0,0,0,719,1342,2061
2020-05-30,3,4180,4613,1731,10269,9141,1754,47,21382,0,0,0,0,463,1341,1804
2020-05-30,4,4038,4554,1697,10025,8906,1710,47,20859,0,0,0,0,292,1354,1646
2020-05-30,5,3946,4557,1700,9980,8869,1694,46,20759,0,0,0,0,198,1359,1557
2020-05-30,6,3860,4490,1716,10069,8946,1709,46,20949,1,37,1,39,152,1357,1509
2020-05-30,7,3812,4576,1758,10067,8783,1677,45,20757,223,1406,161,1790,128,1355,1483
2020-05-30,8,4016,4918,1886,10224,8891,1673,48,20996,836,4412,650,5898,111,1330,1441
2020-05-30,9,4269,5266,2044,10401,8958,1650,53,21221,1176,6120,1117,8413,101,1303,1404
2020-05-30,10,4557,5558,2151,10286,9028,1516,58,21046,1286,6985,1354,9625,108,1298,1406
2020-05-30,11,4795,5806,2236,10132,9096,1415,63,20864,1330,7185,1509,10024,145,1309,1454
2020-05-30,12,4959,6005,2307,9965,9153,1359,67,20703,1337,7438,1624,10399,188,1355,1543
2020-05-30,13,5081,6174,2351,9891,9291,1349,71,20761,1326,7497,1680,10503,236,1454,1690
2020-05-30,14,5190,6305,2364,9985,9453,1340,73,21013,1311,7536,1634,10481,321,1601,1922
2020-05-30,15,5323,6413,2349,10211,9669,1393,75,21506,1329,7412,1582,10323,407,1768,2175
2020-05-30,16,5385,6542,2302,10589,10116,1517,76,22459,1308,7103,1486,9897,455,1932,2387
2020-05-30,17,5346,6569,2214,11167,10628,1692,80,23727,1260,6422,1284,8966,492,2073,2565
2020-05-30,18,5237,6495,2156,11751,11046,1940,77,24974,1211,5164,1022,7397,523,2145,2668
2020-05-30,19,5077,6288,2080,12332,11295,2163,75,26027,827,2671,583,4081,521,2153,2674
2020-05-30,20,4932,6090,2046,12557,11309,2300,70,26398,149,374,106,629,498,2186,2684
2020-05-30,21,4928,6018,2021,12668,11551,2311,67,26759,1,7,0,8,457,2264,2721
2020-05-30,22,4782,5744,2027,12480,11204,2253,64,26161,0,0,0,0,371,2346,2717
2020-05-30,23,4565,5382,2001,11761,10511,2142,59,24633,0,0,0,0,282,2424,2706
2020-05-30,24,4321,5057,1863,10860,9885,1992,53,22949,0,0,0,0,258,2473,2731
2020-05-31,1,4087,4757,1726,10535,9458,1888,47,22124,0,0,0,0,235,2361,2596
2020-05-31,2,3879,4566,1640,10051,9115,1801,44,21208,0,0,0,0,220,2278,2498
2020-05-31,3,3715,4441,1572,9718,8784,1734,42,20482,0,0,0,0,241,2115,2356
2020-05-31,4,3590,4359,1539,9534,8571,1675,42,20018,0,0,0,0,268,1840,2108
2020-05-31,5,3520,4300,1533,9432,8471,1661,42,19803,0,0,0,0,282,1525,1807
2020-05-31,6,3414,4148,1532,9463,8393,1678,42,19781,3,40,1,44,280,1226,1506
2020-05-31,7,3353,4201,1552,9274,8221,1648,43,19391,241,1377,145,1763,247,901,1148
2020-05-31,8,3496,4454,1646,9195,8180,1647,46,19261,832,3976,593,5401,187,573,760
2020-05-31,9,3733,4778,1831,9273,8251,1620,50,19386,1101,5711,979,7791,131,338,469
2020-05-31,10,4010,5068,1966,9164,8410,1553,55,19376,1093,6363,1110,8566,96,216,312
2020-05-31,11,4273,5310,2042,8989,8549,1423,59,19207,1077,6548,1222,8847,80,170,250
2020-05-31,12,4515,5562,2071,8865,8742,1342,62,19197,1107,6639,1305,9051,78,178,256
2020-05-31,13,4753,5685,2073,8872,9028,1319,66,19471,1065,6796,1352,9213,81,236,317
2020-05-31,14,5019,5795,2047,9001,9434,1333,69,20027,1069,6748,1390,9207,104,363,467
2020-05-31,15,5253,5883,2022,9273,9896,1403,72,20833,1049,6759,1375,9183,164,618,782
2020-05-31,16,5470,5979,2024,9768,10496,1518,74,22047,1030,6357,1317,8704,250,999,1249
2020-05-31,17,5532,6104,2061,10410,11160,1716,78,23553,1006,5840,1156,8002,357,1427,1784
2020-05-31,18,5535,6004,2135,11210,11585,1950,79,25015,939,4854,935,6728,485,1841,2326
2020-05-31,19,5426,5873,2160,11942,11821,2116,77,26146,643,2532,521,3696,581,2196,2777
2020-05-31,20,5246,5753,2140,12275,11763,2221,73,26523,116,377,87,580,605,2410,3015
2020-05-31,21,5189,5735,2096,12405,11948,2285,69,26897,1,7,0,8,598,2438,3036
2020-05-31,22,4962,5472,2070,12204,11626,2216,63,26300,0,0,0,0,587,2298,2885
2020-05-31,23,4615,5113,1940,11466,10957,2071,57,24743,0,0,0,0,584,2068,2652
2020-05-31,24,4286,4822,1779,10562,10151,1919,52,22878,0,0,0,0,600,1852,2452
